"","DepTimeBlk","FlightDate","deptvolume","DayOfWeek","arrvolume","volume"
"1","0001-0559",2019-01-01,31,2,77,108
"2","0001-0559",2019-01-02,33,3,92,125
"3","0001-0559",2019-01-03,29,4,75,104
"4","0001-0559",2019-01-04,29,5,76,105
"5","0001-0559",2019-01-05,21,6,67,88
"6","0001-0559",2019-01-06,29,7,86,115
"7","0001-0559",2019-01-07,26,1,55,81
"8","0001-0559",2019-01-08,24,2,43,67
"9","0001-0559",2019-01-09,22,3,47,69
"10","0001-0559",2019-01-10,24,4,55,79
"11","0001-0559",2019-01-11,26,5,57,83
"12","0001-0559",2019-01-12,16,6,37,53
"13","0001-0559",2019-01-13,16,7,55,71
"14","0001-0559",2019-01-14,26,1,53,79
"15","0001-0559",2019-01-15,24,2,44,68
"16","0001-0559",2019-01-16,22,3,44,66
"17","0001-0559",2019-01-17,24,4,55,79
"18","0001-0559",2019-01-18,26,5,57,83
"19","0001-0559",2019-01-19,14,6,37,51
"20","0001-0559",2019-01-20,12,7,46,58
"21","0001-0559",2019-01-21,25,1,52,77
"22","0001-0559",2019-01-22,24,2,42,66
"23","0001-0559",2019-01-23,22,3,44,66
"24","0001-0559",2019-01-24,24,4,55,79
"25","0001-0559",2019-01-25,26,5,57,83
"26","0001-0559",2019-01-26,16,6,37,53
"27","0001-0559",2019-01-27,17,7,55,72
"28","0001-0559",2019-01-28,26,1,52,78
"29","0001-0559",2019-01-29,24,2,41,65
"30","0001-0559",2019-01-30,22,3,43,65
"31","0001-0559",2019-01-31,24,4,55,79
"32","0600-0659",2019-01-01,93,2,34,127
"33","0600-0659",2019-01-02,112,3,34,146
"34","0600-0659",2019-01-03,117,4,31,148
"35","0600-0659",2019-01-04,117,5,31,148
"36","0600-0659",2019-01-05,97,6,25,122
"37","0600-0659",2019-01-06,105,7,27,132
"38","0600-0659",2019-01-07,110,1,27,137
"39","0600-0659",2019-01-08,99,2,21,120
"40","0600-0659",2019-01-09,96,3,24,120
"41","0600-0659",2019-01-10,108,4,26,134
"42","0600-0659",2019-01-11,110,5,27,137
"43","0600-0659",2019-01-12,85,6,19,104
"44","0600-0659",2019-01-13,88,7,24,112
"45","0600-0659",2019-01-14,109,1,28,137
"46","0600-0659",2019-01-15,98,2,21,119
"47","0600-0659",2019-01-16,94,3,24,118
"48","0600-0659",2019-01-17,107,4,27,134
"49","0600-0659",2019-01-18,109,5,28,137
"50","0600-0659",2019-01-19,81,6,18,99
"51","0600-0659",2019-01-20,80,7,22,102
"52","0600-0659",2019-01-21,106,1,28,134
"53","0600-0659",2019-01-22,98,2,21,119
"54","0600-0659",2019-01-23,94,3,24,118
"55","0600-0659",2019-01-24,108,4,27,135
"56","0600-0659",2019-01-25,109,5,28,137
"57","0600-0659",2019-01-26,82,6,19,101
"58","0600-0659",2019-01-27,88,7,24,112
"59","0600-0659",2019-01-28,109,1,28,137
"60","0600-0659",2019-01-29,98,2,21,119
"61","0600-0659",2019-01-30,94,3,24,118
"62","0600-0659",2019-01-31,108,4,27,135
"63","0700-0759",2019-01-01,99,2,53,152
"64","0700-0759",2019-01-02,105,3,64,169
"65","0700-0759",2019-01-03,105,4,64,169
"66","0700-0759",2019-01-04,103,5,64,167
"67","0700-0759",2019-01-05,88,6,54,142
"68","0700-0759",2019-01-06,98,7,63,161
"69","0700-0759",2019-01-07,102,1,60,162
"70","0700-0759",2019-01-08,95,2,58,153
"71","0700-0759",2019-01-09,91,3,56,147
"72","0700-0759",2019-01-10,105,4,61,166
"73","0700-0759",2019-01-11,106,5,62,168
"74","0700-0759",2019-01-12,87,6,49,136
"75","0700-0759",2019-01-13,94,7,52,146
"76","0700-0759",2019-01-14,105,1,60,165
"77","0700-0759",2019-01-15,95,2,57,152
"78","0700-0759",2019-01-16,91,3,54,145
"79","0700-0759",2019-01-17,105,4,59,164
"80","0700-0759",2019-01-18,107,5,60,167
"81","0700-0759",2019-01-19,85,6,44,129
"82","0700-0759",2019-01-20,86,7,44,130
"83","0700-0759",2019-01-21,100,1,58,158
"84","0700-0759",2019-01-22,96,2,57,153
"85","0700-0759",2019-01-23,92,3,54,146
"86","0700-0759",2019-01-24,104,4,59,163
"87","0700-0759",2019-01-25,107,5,60,167
"88","0700-0759",2019-01-26,87,6,45,132
"89","0700-0759",2019-01-27,96,7,53,149
"90","0700-0759",2019-01-28,106,1,60,166
"91","0700-0759",2019-01-29,96,2,57,153
"92","0700-0759",2019-01-30,92,3,54,146
"93","0700-0759",2019-01-31,103,4,59,162
"94","0800-0859",2019-01-01,107,2,60,167
"95","0800-0859",2019-01-02,111,3,65,176
"96","0800-0859",2019-01-03,109,4,67,176
"97","0800-0859",2019-01-04,107,5,66,173
"98","0800-0859",2019-01-05,106,6,60,166
"99","0800-0859",2019-01-06,105,7,63,168
"100","0800-0859",2019-01-07,107,1,72,179
"101","0800-0859",2019-01-08,99,2,66,165
"102","0800-0859",2019-01-09,103,3,63,166
"103","0800-0859",2019-01-10,110,4,74,184
"104","0800-0859",2019-01-11,108,5,75,183
"105","0800-0859",2019-01-12,107,6,58,165
"106","0800-0859",2019-01-13,107,7,58,165
"107","0800-0859",2019-01-14,106,1,76,182
"108","0800-0859",2019-01-15,98,2,66,164
"109","0800-0859",2019-01-16,102,3,63,165
"110","0800-0859",2019-01-17,108,4,75,183
"111","0800-0859",2019-01-18,106,5,77,183
"112","0800-0859",2019-01-19,107,6,58,165
"113","0800-0859",2019-01-20,102,7,54,156
"114","0800-0859",2019-01-21,104,1,74,178
"115","0800-0859",2019-01-22,98,2,67,165
"116","0800-0859",2019-01-23,101,3,64,165
"117","0800-0859",2019-01-24,108,4,75,183
"118","0800-0859",2019-01-25,106,5,77,183
"119","0800-0859",2019-01-26,107,6,60,167
"120","0800-0859",2019-01-27,108,7,60,168
"121","0800-0859",2019-01-28,106,1,77,183
"122","0800-0859",2019-01-29,98,2,67,165
"123","0800-0859",2019-01-30,101,3,64,165
"124","0800-0859",2019-01-31,109,4,74,183
"125","0900-0959",2019-01-01,85,2,60,145
"126","0900-0959",2019-01-02,86,3,66,152
"127","0900-0959",2019-01-03,88,4,65,153
"128","0900-0959",2019-01-04,86,5,65,151
"129","0900-0959",2019-01-05,78,6,56,134
"130","0900-0959",2019-01-06,83,7,57,140
"131","0900-0959",2019-01-07,87,1,65,152
"132","0900-0959",2019-01-08,83,2,58,141
"133","0900-0959",2019-01-09,82,3,56,138
"134","0900-0959",2019-01-10,86,4,64,150
"135","0900-0959",2019-01-11,84,5,66,150
"136","0900-0959",2019-01-12,71,6,56,127
"137","0900-0959",2019-01-13,77,7,56,133
"138","0900-0959",2019-01-14,85,1,62,147
"139","0900-0959",2019-01-15,81,2,57,138
"140","0900-0959",2019-01-16,81,3,55,136
"141","0900-0959",2019-01-17,87,4,61,148
"142","0900-0959",2019-01-18,85,5,62,147
"143","0900-0959",2019-01-19,67,6,55,122
"144","0900-0959",2019-01-20,71,7,53,124
"145","0900-0959",2019-01-21,84,1,58,142
"146","0900-0959",2019-01-22,81,2,56,137
"147","0900-0959",2019-01-23,81,3,54,135
"148","0900-0959",2019-01-24,88,4,61,149
"149","0900-0959",2019-01-25,86,5,62,148
"150","0900-0959",2019-01-26,71,6,55,126
"151","0900-0959",2019-01-27,77,7,54,131
"152","0900-0959",2019-01-28,86,1,61,147
"153","0900-0959",2019-01-29,81,2,56,137
"154","0900-0959",2019-01-30,81,3,54,135
"155","0900-0959",2019-01-31,87,4,62,149
"156","1000-1059",2019-01-01,77,2,70,147
"157","1000-1059",2019-01-02,76,3,75,151
"158","1000-1059",2019-01-03,74,4,72,146
"159","1000-1059",2019-01-04,75,5,71,146
"160","1000-1059",2019-01-05,61,6,61,122
"161","1000-1059",2019-01-06,65,7,65,130
"162","1000-1059",2019-01-07,72,1,64,136
"163","1000-1059",2019-01-08,70,2,60,130
"164","1000-1059",2019-01-09,70,3,61,131
"165","1000-1059",2019-01-10,72,4,65,137
"166","1000-1059",2019-01-11,70,5,65,135
"167","1000-1059",2019-01-12,60,6,60,120
"168","1000-1059",2019-01-13,72,7,61,133
"169","1000-1059",2019-01-14,72,1,65,137
"170","1000-1059",2019-01-15,68,2,59,127
"171","1000-1059",2019-01-16,68,3,60,128
"172","1000-1059",2019-01-17,73,4,66,139
"173","1000-1059",2019-01-18,72,5,66,138
"174","1000-1059",2019-01-19,61,6,57,118
"175","1000-1059",2019-01-20,71,7,59,130
"176","1000-1059",2019-01-21,71,1,64,135
"177","1000-1059",2019-01-22,69,2,60,129
"178","1000-1059",2019-01-23,69,3,61,130
"179","1000-1059",2019-01-24,73,4,66,139
"180","1000-1059",2019-01-25,72,5,66,138
"181","1000-1059",2019-01-26,61,6,59,120
"182","1000-1059",2019-01-27,73,7,64,137
"183","1000-1059",2019-01-28,73,1,66,139
"184","1000-1059",2019-01-29,69,2,60,129
"185","1000-1059",2019-01-30,69,3,61,130
"186","1000-1059",2019-01-31,73,4,66,139
"187","1100-1159",2019-01-01,91,2,76,167
"188","1100-1159",2019-01-02,90,3,71,161
"189","1100-1159",2019-01-03,89,4,78,167
"190","1100-1159",2019-01-04,86,5,76,162
"191","1100-1159",2019-01-05,79,6,68,147
"192","1100-1159",2019-01-06,80,7,77,157
"193","1100-1159",2019-01-07,79,1,76,155
"194","1100-1159",2019-01-08,73,2,67,140
"195","1100-1159",2019-01-09,76,3,67,143
"196","1100-1159",2019-01-10,76,4,74,150
"197","1100-1159",2019-01-11,77,5,73,150
"198","1100-1159",2019-01-12,65,6,63,128
"199","1100-1159",2019-01-13,71,7,70,141
"200","1100-1159",2019-01-14,77,1,73,150
"201","1100-1159",2019-01-15,72,2,66,138
"202","1100-1159",2019-01-16,75,3,68,143
"203","1100-1159",2019-01-17,77,4,73,150
"204","1100-1159",2019-01-18,77,5,72,149
"205","1100-1159",2019-01-19,65,6,62,127
"206","1100-1159",2019-01-20,71,7,61,132
"207","1100-1159",2019-01-21,77,1,72,149
"208","1100-1159",2019-01-22,73,2,66,139
"209","1100-1159",2019-01-23,76,3,67,143
"210","1100-1159",2019-01-24,78,4,74,152
"211","1100-1159",2019-01-25,78,5,72,150
"212","1100-1159",2019-01-26,64,6,64,128
"213","1100-1159",2019-01-27,73,7,71,144
"214","1100-1159",2019-01-28,77,1,73,150
"215","1100-1159",2019-01-29,73,2,66,139
"216","1100-1159",2019-01-30,76,3,67,143
"217","1100-1159",2019-01-31,78,4,74,152
"218","1200-1259",2019-01-01,74,2,77,151
"219","1200-1259",2019-01-02,77,3,81,158
"220","1200-1259",2019-01-03,69,4,79,148
"221","1200-1259",2019-01-04,68,5,80,148
"222","1200-1259",2019-01-05,66,6,71,137
"223","1200-1259",2019-01-06,74,7,81,155
"224","1200-1259",2019-01-07,70,1,77,147
"225","1200-1259",2019-01-08,71,2,75,146
"226","1200-1259",2019-01-09,72,3,78,150
"227","1200-1259",2019-01-10,74,4,77,151
"228","1200-1259",2019-01-11,74,5,77,151
"229","1200-1259",2019-01-12,61,6,69,130
"230","1200-1259",2019-01-13,75,7,70,145
"231","1200-1259",2019-01-14,72,1,77,149
"232","1200-1259",2019-01-15,70,2,73,143
"233","1200-1259",2019-01-16,73,3,76,149
"234","1200-1259",2019-01-17,73,4,79,152
"235","1200-1259",2019-01-18,72,5,79,151
"236","1200-1259",2019-01-19,61,6,69,130
"237","1200-1259",2019-01-20,67,7,69,136
"238","1200-1259",2019-01-21,71,1,78,149
"239","1200-1259",2019-01-22,70,2,74,144
"240","1200-1259",2019-01-23,72,3,77,149
"241","1200-1259",2019-01-24,73,4,80,153
"242","1200-1259",2019-01-25,72,5,80,152
"243","1200-1259",2019-01-26,62,6,69,131
"244","1200-1259",2019-01-27,74,7,71,145
"245","1200-1259",2019-01-28,72,1,79,151
"246","1200-1259",2019-01-29,70,2,74,144
"247","1200-1259",2019-01-30,72,3,77,149
"248","1200-1259",2019-01-31,73,4,79,152
"249","1300-1359",2019-01-01,82,2,75,157
"250","1300-1359",2019-01-02,72,3,75,147
"251","1300-1359",2019-01-03,81,4,73,154
"252","1300-1359",2019-01-04,82,5,72,154
"253","1300-1359",2019-01-05,68,6,62,130
"254","1300-1359",2019-01-06,73,7,59,132
"255","1300-1359",2019-01-07,73,1,69,142
"256","1300-1359",2019-01-08,72,2,66,138
"257","1300-1359",2019-01-09,72,3,67,139
"258","1300-1359",2019-01-10,74,4,69,143
"259","1300-1359",2019-01-11,73,5,70,143
"260","1300-1359",2019-01-12,65,6,57,122
"261","1300-1359",2019-01-13,65,7,69,134
"262","1300-1359",2019-01-14,73,1,69,142
"263","1300-1359",2019-01-15,71,2,65,136
"264","1300-1359",2019-01-16,70,3,66,136
"265","1300-1359",2019-01-17,75,4,69,144
"266","1300-1359",2019-01-18,74,5,68,142
"267","1300-1359",2019-01-19,64,6,60,124
"268","1300-1359",2019-01-20,63,7,68,131
"269","1300-1359",2019-01-21,74,1,67,141
"270","1300-1359",2019-01-22,72,2,65,137
"271","1300-1359",2019-01-23,72,3,66,138
"272","1300-1359",2019-01-24,76,4,69,145
"273","1300-1359",2019-01-25,75,5,69,144
"274","1300-1359",2019-01-26,65,6,59,124
"275","1300-1359",2019-01-27,66,7,69,135
"276","1300-1359",2019-01-28,75,1,68,143
"277","1300-1359",2019-01-29,73,2,65,138
"278","1300-1359",2019-01-30,72,3,66,138
"279","1300-1359",2019-01-31,75,4,69,144
"280","1400-1459",2019-01-01,75,2,90,165
"281","1400-1459",2019-01-02,83,3,90,173
"282","1400-1459",2019-01-03,75,4,85,160
"283","1400-1459",2019-01-04,74,5,85,159
"284","1400-1459",2019-01-05,61,6,82,143
"285","1400-1459",2019-01-06,68,7,82,150
"286","1400-1459",2019-01-07,79,1,83,162
"287","1400-1459",2019-01-08,76,2,79,155
"288","1400-1459",2019-01-09,77,3,79,156
"289","1400-1459",2019-01-10,80,4,83,163
"290","1400-1459",2019-01-11,81,5,82,163
"291","1400-1459",2019-01-12,63,6,73,136
"292","1400-1459",2019-01-13,72,7,81,153
"293","1400-1459",2019-01-14,78,1,82,160
"294","1400-1459",2019-01-15,75,2,79,154
"295","1400-1459",2019-01-16,77,3,79,156
"296","1400-1459",2019-01-17,79,4,82,161
"297","1400-1459",2019-01-18,79,5,81,160
"298","1400-1459",2019-01-19,60,6,69,129
"299","1400-1459",2019-01-20,69,7,73,142
"300","1400-1459",2019-01-21,78,1,81,159
"301","1400-1459",2019-01-22,75,2,79,154
"302","1400-1459",2019-01-23,77,3,79,156
"303","1400-1459",2019-01-24,79,4,83,162
"304","1400-1459",2019-01-25,79,5,82,161
"305","1400-1459",2019-01-26,60,6,71,131
"306","1400-1459",2019-01-27,72,7,80,152
"307","1400-1459",2019-01-28,78,1,83,161
"308","1400-1459",2019-01-29,74,2,79,153
"309","1400-1459",2019-01-30,77,3,79,156
"310","1400-1459",2019-01-31,78,4,82,160
"311","1500-1559",2019-01-01,94,2,75,169
"312","1500-1559",2019-01-02,90,3,77,167
"313","1500-1559",2019-01-03,90,4,75,165
"314","1500-1559",2019-01-04,92,5,72,164
"315","1500-1559",2019-01-05,87,6,64,151
"316","1500-1559",2019-01-06,86,7,70,156
"317","1500-1559",2019-01-07,83,1,73,156
"318","1500-1559",2019-01-08,81,2,74,155
"319","1500-1559",2019-01-09,82,3,73,155
"320","1500-1559",2019-01-10,84,4,77,161
"321","1500-1559",2019-01-11,84,5,74,158
"322","1500-1559",2019-01-12,75,6,63,138
"323","1500-1559",2019-01-13,82,7,67,149
"324","1500-1559",2019-01-14,83,1,74,157
"325","1500-1559",2019-01-15,79,2,72,151
"326","1500-1559",2019-01-16,81,3,72,153
"327","1500-1559",2019-01-17,83,4,75,158
"328","1500-1559",2019-01-18,84,5,74,158
"329","1500-1559",2019-01-19,76,6,62,138
"330","1500-1559",2019-01-20,76,7,65,141
"331","1500-1559",2019-01-21,83,1,73,156
"332","1500-1559",2019-01-22,79,2,72,151
"333","1500-1559",2019-01-23,81,3,72,153
"334","1500-1559",2019-01-24,83,4,74,157
"335","1500-1559",2019-01-25,84,5,74,158
"336","1500-1559",2019-01-26,77,6,61,138
"337","1500-1559",2019-01-27,81,7,66,147
"338","1500-1559",2019-01-28,83,1,74,157
"339","1500-1559",2019-01-29,79,2,72,151
"340","1500-1559",2019-01-30,81,3,72,153
"341","1500-1559",2019-01-31,84,4,74,158
"342","1600-1659",2019-01-01,77,2,80,157
"343","1600-1659",2019-01-02,86,3,83,169
"344","1600-1659",2019-01-03,85,4,81,166
"345","1600-1659",2019-01-04,85,5,81,166
"346","1600-1659",2019-01-05,77,6,77,154
"347","1600-1659",2019-01-06,83,7,82,165
"348","1600-1659",2019-01-07,81,1,77,158
"349","1600-1659",2019-01-08,75,2,77,152
"350","1600-1659",2019-01-09,76,3,79,155
"351","1600-1659",2019-01-10,81,4,82,163
"352","1600-1659",2019-01-11,82,5,80,162
"353","1600-1659",2019-01-12,63,6,68,131
"354","1600-1659",2019-01-13,79,7,81,160
"355","1600-1659",2019-01-14,83,1,79,162
"356","1600-1659",2019-01-15,75,2,77,152
"357","1600-1659",2019-01-16,74,3,78,152
"358","1600-1659",2019-01-17,83,4,81,164
"359","1600-1659",2019-01-18,83,5,80,163
"360","1600-1659",2019-01-19,63,6,67,130
"361","1600-1659",2019-01-20,79,7,78,157
"362","1600-1659",2019-01-21,83,1,78,161
"363","1600-1659",2019-01-22,73,2,77,150
"364","1600-1659",2019-01-23,74,3,79,153
"365","1600-1659",2019-01-24,81,4,81,162
"366","1600-1659",2019-01-25,83,5,80,163
"367","1600-1659",2019-01-26,63,6,69,132
"368","1600-1659",2019-01-27,78,7,80,158
"369","1600-1659",2019-01-28,83,1,79,162
"370","1600-1659",2019-01-29,72,2,77,149
"371","1600-1659",2019-01-30,74,3,79,153
"372","1600-1659",2019-01-31,81,4,80,161
"373","1700-1759",2019-01-01,84,2,86,170
"374","1700-1759",2019-01-02,86,3,93,179
"375","1700-1759",2019-01-03,79,4,87,166
"376","1700-1759",2019-01-04,79,5,86,165
"377","1700-1759",2019-01-05,72,6,73,145
"378","1700-1759",2019-01-06,87,7,73,160
"379","1700-1759",2019-01-07,85,1,88,173
"380","1700-1759",2019-01-08,77,2,81,158
"381","1700-1759",2019-01-09,80,3,81,161
"382","1700-1759",2019-01-10,82,4,81,163
"383","1700-1759",2019-01-11,82,5,84,166
"384","1700-1759",2019-01-12,69,6,64,133
"385","1700-1759",2019-01-13,80,7,74,154
"386","1700-1759",2019-01-14,81,1,86,167
"387","1700-1759",2019-01-15,76,2,79,155
"388","1700-1759",2019-01-16,79,3,80,159
"389","1700-1759",2019-01-17,81,4,83,164
"390","1700-1759",2019-01-18,80,5,84,164
"391","1700-1759",2019-01-19,67,6,63,130
"392","1700-1759",2019-01-20,69,7,66,135
"393","1700-1759",2019-01-21,81,1,85,166
"394","1700-1759",2019-01-22,76,2,79,155
"395","1700-1759",2019-01-23,79,3,80,159
"396","1700-1759",2019-01-24,81,4,83,164
"397","1700-1759",2019-01-25,80,5,84,164
"398","1700-1759",2019-01-26,68,6,63,131
"399","1700-1759",2019-01-27,80,7,74,154
"400","1700-1759",2019-01-28,81,1,86,167
"401","1700-1759",2019-01-29,75,2,79,154
"402","1700-1759",2019-01-30,79,3,80,159
"403","1700-1759",2019-01-31,81,4,84,165
"404","1800-1859",2019-01-01,71,2,85,156
"405","1800-1859",2019-01-02,78,3,84,162
"406","1800-1859",2019-01-03,84,4,87,171
"407","1800-1859",2019-01-04,83,5,85,168
"408","1800-1859",2019-01-05,73,6,73,146
"409","1800-1859",2019-01-06,71,7,88,159
"410","1800-1859",2019-01-07,74,1,87,161
"411","1800-1859",2019-01-08,65,2,80,145
"412","1800-1859",2019-01-09,65,3,80,145
"413","1800-1859",2019-01-10,76,4,85,161
"414","1800-1859",2019-01-11,77,5,85,162
"415","1800-1859",2019-01-12,59,6,65,124
"416","1800-1859",2019-01-13,81,7,79,160
"417","1800-1859",2019-01-14,74,1,85,159
"418","1800-1859",2019-01-15,64,2,81,145
"419","1800-1859",2019-01-16,66,3,80,146
"420","1800-1859",2019-01-17,75,4,85,160
"421","1800-1859",2019-01-18,75,5,84,159
"422","1800-1859",2019-01-19,58,6,63,121
"423","1800-1859",2019-01-20,76,7,77,153
"424","1800-1859",2019-01-21,75,1,84,159
"425","1800-1859",2019-01-22,64,2,79,143
"426","1800-1859",2019-01-23,65,3,79,144
"427","1800-1859",2019-01-24,75,4,84,159
"428","1800-1859",2019-01-25,75,5,84,159
"429","1800-1859",2019-01-26,58,6,63,121
"430","1800-1859",2019-01-27,81,7,78,159
"431","1800-1859",2019-01-28,74,1,84,158
"432","1800-1859",2019-01-29,64,2,78,142
"433","1800-1859",2019-01-30,65,3,79,144
"434","1800-1859",2019-01-31,75,4,84,159
"435","1900-1959",2019-01-01,76,2,63,139
"436","1900-1959",2019-01-02,78,3,70,148
"437","1900-1959",2019-01-03,76,4,65,141
"438","1900-1959",2019-01-04,78,5,68,146
"439","1900-1959",2019-01-05,60,6,65,125
"440","1900-1959",2019-01-06,83,7,65,148
"441","1900-1959",2019-01-07,80,1,71,151
"442","1900-1959",2019-01-08,69,2,68,137
"443","1900-1959",2019-01-09,73,3,70,143
"444","1900-1959",2019-01-10,79,4,72,151
"445","1900-1959",2019-01-11,81,5,74,155
"446","1900-1959",2019-01-12,57,6,66,123
"447","1900-1959",2019-01-13,72,7,73,145
"448","1900-1959",2019-01-14,81,1,70,151
"449","1900-1959",2019-01-15,68,2,68,136
"450","1900-1959",2019-01-16,73,3,69,142
"451","1900-1959",2019-01-17,79,4,72,151
"452","1900-1959",2019-01-18,81,5,74,155
"453","1900-1959",2019-01-19,53,6,64,117
"454","1900-1959",2019-01-20,64,7,66,130
"455","1900-1959",2019-01-21,78,1,70,148
"456","1900-1959",2019-01-22,68,2,69,137
"457","1900-1959",2019-01-23,73,3,70,143
"458","1900-1959",2019-01-24,79,4,73,152
"459","1900-1959",2019-01-25,82,5,74,156
"460","1900-1959",2019-01-26,56,6,66,122
"461","1900-1959",2019-01-27,72,7,75,147
"462","1900-1959",2019-01-28,78,1,71,149
"463","1900-1959",2019-01-29,67,2,68,135
"464","1900-1959",2019-01-30,72,3,70,142
"465","1900-1959",2019-01-31,79,4,73,152
"466","2000-2059",2019-01-01,56,2,94,150
"467","2000-2059",2019-01-02,64,3,93,157
"468","2000-2059",2019-01-03,55,4,97,152
"469","2000-2059",2019-01-04,55,5,99,154
"470","2000-2059",2019-01-05,50,6,82,132
"471","2000-2059",2019-01-06,49,7,90,139
"472","2000-2059",2019-01-07,54,1,89,143
"473","2000-2059",2019-01-08,44,2,84,128
"474","2000-2059",2019-01-09,49,3,83,132
"475","2000-2059",2019-01-10,52,4,88,140
"476","2000-2059",2019-01-11,53,5,89,142
"477","2000-2059",2019-01-12,36,6,73,109
"478","2000-2059",2019-01-13,50,7,85,135
"479","2000-2059",2019-01-14,52,1,89,141
"480","2000-2059",2019-01-15,46,2,81,127
"481","2000-2059",2019-01-16,47,3,83,130
"482","2000-2059",2019-01-17,51,4,88,139
"483","2000-2059",2019-01-18,51,5,87,138
"484","2000-2059",2019-01-19,35,6,71,106
"485","2000-2059",2019-01-20,46,7,76,122
"486","2000-2059",2019-01-21,50,1,88,138
"487","2000-2059",2019-01-22,46,2,81,127
"488","2000-2059",2019-01-23,47,3,82,129
"489","2000-2059",2019-01-24,52,4,88,140
"490","2000-2059",2019-01-25,51,5,88,139
"491","2000-2059",2019-01-26,36,6,72,108
"492","2000-2059",2019-01-27,51,7,85,136
"493","2000-2059",2019-01-28,51,1,88,139
"494","2000-2059",2019-01-29,44,2,81,125
"495","2000-2059",2019-01-30,45,3,82,127
"496","2000-2059",2019-01-31,52,4,88,140
"497","2100-2159",2019-01-01,57,2,94,151
"498","2100-2159",2019-01-02,62,3,98,160
"499","2100-2159",2019-01-03,60,4,93,153
"500","2100-2159",2019-01-04,60,5,92,152
"501","2100-2159",2019-01-05,48,6,87,135
"502","2100-2159",2019-01-06,67,7,90,157
"503","2100-2159",2019-01-07,58,1,93,151
"504","2100-2159",2019-01-08,50,2,79,129
"505","2100-2159",2019-01-09,51,3,83,134
"506","2100-2159",2019-01-10,58,4,95,153
"507","2100-2159",2019-01-11,60,5,95,155
"508","2100-2159",2019-01-12,36,6,79,115
"509","2100-2159",2019-01-13,54,7,92,146
"510","2100-2159",2019-01-14,59,1,93,152
"511","2100-2159",2019-01-15,50,2,80,130
"512","2100-2159",2019-01-16,51,3,83,134
"513","2100-2159",2019-01-17,59,4,97,156
"514","2100-2159",2019-01-18,59,5,97,156
"515","2100-2159",2019-01-19,34,6,78,112
"516","2100-2159",2019-01-20,46,7,89,135
"517","2100-2159",2019-01-21,59,1,94,153
"518","2100-2159",2019-01-22,50,2,82,132
"519","2100-2159",2019-01-23,51,3,84,135
"520","2100-2159",2019-01-24,59,4,96,155
"521","2100-2159",2019-01-25,60,5,97,157
"522","2100-2159",2019-01-26,36,6,80,116
"523","2100-2159",2019-01-27,54,7,93,147
"524","2100-2159",2019-01-28,58,1,94,152
"525","2100-2159",2019-01-29,49,2,80,129
"526","2100-2159",2019-01-30,50,3,83,133
"527","2100-2159",2019-01-31,59,4,96,155
"528","2200-2259",2019-01-01,42,2,78,120
"529","2200-2259",2019-01-02,54,3,80,134
"530","2200-2259",2019-01-03,40,4,76,116
"531","2200-2259",2019-01-04,40,5,76,116
"532","2200-2259",2019-01-05,32,6,59,91
"533","2200-2259",2019-01-06,46,7,81,127
"534","2200-2259",2019-01-07,36,1,75,111
"535","2200-2259",2019-01-08,28,2,65,93
"536","2200-2259",2019-01-09,31,3,71,102
"537","2200-2259",2019-01-10,37,4,75,112
"538","2200-2259",2019-01-11,36,5,76,112
"539","2200-2259",2019-01-12,22,6,47,69
"540","2200-2259",2019-01-13,37,7,74,111
"541","2200-2259",2019-01-14,35,1,76,111
"542","2200-2259",2019-01-15,29,2,66,95
"543","2200-2259",2019-01-16,30,3,71,101
"544","2200-2259",2019-01-17,38,4,75,113
"545","2200-2259",2019-01-18,36,5,74,110
"546","2200-2259",2019-01-19,21,6,46,67
"547","2200-2259",2019-01-20,31,7,62,93
"548","2200-2259",2019-01-21,35,1,75,110
"549","2200-2259",2019-01-22,28,2,66,94
"550","2200-2259",2019-01-23,30,3,71,101
"551","2200-2259",2019-01-24,37,4,76,113
"552","2200-2259",2019-01-25,36,5,75,111
"553","2200-2259",2019-01-26,22,6,47,69
"554","2200-2259",2019-01-27,36,7,75,111
"555","2200-2259",2019-01-28,35,1,74,109
"556","2200-2259",2019-01-29,28,2,65,93
"557","2200-2259",2019-01-30,30,3,69,99
"558","2200-2259",2019-01-31,37,4,76,113
"559","2300-2359",2019-01-01,31,2,75,106
"560","2300-2359",2019-01-02,33,3,85,118
"561","2300-2359",2019-01-03,29,4,84,113
"562","2300-2359",2019-01-04,30,5,84,114
"563","2300-2359",2019-01-05,25,6,63,88
"564","2300-2359",2019-01-06,28,7,81,109
"565","2300-2359",2019-01-07,22,1,77,99
"566","2300-2359",2019-01-08,17,2,67,84
"567","2300-2359",2019-01-09,20,3,70,90
"568","2300-2359",2019-01-10,21,4,76,97
"569","2300-2359",2019-01-11,21,5,74,95
"570","2300-2359",2019-01-12,18,6,49,67
"571","2300-2359",2019-01-13,20,7,71,91
"572","2300-2359",2019-01-14,21,1,75,96
"573","2300-2359",2019-01-15,17,2,65,82
"574","2300-2359",2019-01-16,20,3,69,89
"575","2300-2359",2019-01-17,21,4,76,97
"576","2300-2359",2019-01-18,21,5,73,94
"577","2300-2359",2019-01-19,18,6,47,65
"578","2300-2359",2019-01-20,17,7,68,85
"579","2300-2359",2019-01-21,20,1,75,95
"580","2300-2359",2019-01-22,17,2,65,82
"581","2300-2359",2019-01-23,20,3,69,89
"582","2300-2359",2019-01-24,21,4,75,96
"583","2300-2359",2019-01-25,21,5,73,94
"584","2300-2359",2019-01-26,18,6,50,68
"585","2300-2359",2019-01-27,20,7,70,90
"586","2300-2359",2019-01-28,21,1,75,96
"587","2300-2359",2019-01-29,17,2,65,82
"588","2300-2359",2019-01-30,20,3,69,89
"589","2300-2359",2019-01-31,21,4,75,96
"590","0001-0559",2019-02-01,26,5,57,83
"591","0001-0559",2019-02-02,15,6,37,52
"592","0001-0559",2019-02-03,16,7,49,65
"593","0001-0559",2019-02-04,29,1,56,85
"594","0001-0559",2019-02-05,24,2,42,66
"595","0001-0559",2019-02-06,22,3,45,67
"596","0001-0559",2019-02-07,24,4,56,80
"597","0001-0559",2019-02-08,26,5,58,84
"598","0001-0559",2019-02-09,16,6,37,53
"599","0001-0559",2019-02-10,17,7,56,73
"600","0001-0559",2019-02-11,25,1,54,79
"601","0001-0559",2019-02-12,23,2,44,67
"602","0001-0559",2019-02-13,21,3,45,66
"603","0001-0559",2019-02-14,24,4,72,96
"604","0001-0559",2019-02-15,25,5,75,100
"605","0001-0559",2019-02-16,16,6,50,66
"606","0001-0559",2019-02-17,16,7,65,81
"607","0001-0559",2019-02-18,25,1,70,95
"608","0001-0559",2019-02-19,23,2,64,87
"609","0001-0559",2019-02-20,23,3,67,90
"610","0001-0559",2019-02-21,25,4,72,97
"611","0001-0559",2019-02-22,25,5,74,99
"612","0001-0559",2019-02-23,17,6,57,74
"613","0001-0559",2019-02-24,16,7,71,87
"614","0001-0559",2019-02-25,25,1,70,95
"615","0001-0559",2019-02-26,24,2,63,87
"616","0001-0559",2019-02-27,24,3,64,88
"617","0001-0559",2019-02-28,27,4,72,99
"618","0600-0659",2019-02-01,111,5,28,139
"619","0600-0659",2019-02-02,83,6,18,101
"620","0600-0659",2019-02-03,83,7,24,107
"621","0600-0659",2019-02-04,109,1,27,136
"622","0600-0659",2019-02-05,98,2,21,119
"623","0600-0659",2019-02-06,94,3,23,117
"624","0600-0659",2019-02-07,108,4,26,134
"625","0600-0659",2019-02-08,109,5,27,136
"626","0600-0659",2019-02-09,83,6,18,101
"627","0600-0659",2019-02-10,88,7,23,111
"628","0600-0659",2019-02-11,110,1,26,136
"629","0600-0659",2019-02-12,99,2,20,119
"630","0600-0659",2019-02-13,95,3,22,117
"631","0600-0659",2019-02-14,114,4,20,134
"632","0600-0659",2019-02-15,112,5,20,132
"633","0600-0659",2019-02-16,88,6,14,102
"634","0600-0659",2019-02-17,93,7,16,109
"635","0600-0659",2019-02-18,111,1,21,132
"636","0600-0659",2019-02-19,105,2,19,124
"637","0600-0659",2019-02-20,104,3,18,122
"638","0600-0659",2019-02-21,113,4,20,133
"639","0600-0659",2019-02-22,112,5,20,132
"640","0600-0659",2019-02-23,91,6,15,106
"641","0600-0659",2019-02-24,95,7,18,113
"642","0600-0659",2019-02-25,112,1,21,133
"643","0600-0659",2019-02-26,104,2,19,123
"644","0600-0659",2019-02-27,99,3,16,115
"645","0600-0659",2019-02-28,110,4,20,130
"646","0700-0759",2019-02-01,106,5,61,167
"647","0700-0759",2019-02-02,86,6,46,132
"648","0700-0759",2019-02-03,85,7,47,132
"649","0700-0759",2019-02-04,106,1,59,165
"650","0700-0759",2019-02-05,96,2,56,152
"651","0700-0759",2019-02-06,92,3,53,145
"652","0700-0759",2019-02-07,104,4,58,162
"653","0700-0759",2019-02-08,107,5,59,166
"654","0700-0759",2019-02-09,87,6,46,133
"655","0700-0759",2019-02-10,95,7,52,147
"656","0700-0759",2019-02-11,107,1,60,167
"657","0700-0759",2019-02-12,96,2,57,153
"658","0700-0759",2019-02-13,92,3,54,146
"659","0700-0759",2019-02-14,104,4,61,165
"660","0700-0759",2019-02-15,102,5,61,163
"661","0700-0759",2019-02-16,85,6,48,133
"662","0700-0759",2019-02-17,87,7,51,138
"663","0700-0759",2019-02-18,98,1,59,157
"664","0700-0759",2019-02-19,94,2,56,150
"665","0700-0759",2019-02-20,95,3,59,154
"666","0700-0759",2019-02-21,103,4,61,164
"667","0700-0759",2019-02-22,103,5,61,164
"668","0700-0759",2019-02-23,87,6,49,136
"669","0700-0759",2019-02-24,94,7,53,147
"670","0700-0759",2019-02-25,103,1,60,163
"671","0700-0759",2019-02-26,94,2,55,149
"672","0700-0759",2019-02-27,92,3,55,147
"673","0700-0759",2019-02-28,103,4,60,163
"674","0800-0859",2019-02-01,107,5,77,184
"675","0800-0859",2019-02-02,108,6,60,168
"676","0800-0859",2019-02-03,109,7,57,166
"677","0800-0859",2019-02-04,107,1,79,186
"678","0800-0859",2019-02-05,99,2,68,167
"679","0800-0859",2019-02-06,102,3,65,167
"680","0800-0859",2019-02-07,110,4,76,186
"681","0800-0859",2019-02-08,107,5,78,185
"682","0800-0859",2019-02-09,109,6,60,169
"683","0800-0859",2019-02-10,109,7,59,168
"684","0800-0859",2019-02-11,105,1,78,183
"685","0800-0859",2019-02-12,99,2,68,167
"686","0800-0859",2019-02-13,102,3,64,166
"687","0800-0859",2019-02-14,109,4,83,192
"688","0800-0859",2019-02-15,111,5,81,192
"689","0800-0859",2019-02-16,111,6,63,174
"690","0800-0859",2019-02-17,111,7,60,171
"691","0800-0859",2019-02-18,109,1,80,189
"692","0800-0859",2019-02-19,104,2,72,176
"693","0800-0859",2019-02-20,107,3,71,178
"694","0800-0859",2019-02-21,110,4,82,192
"695","0800-0859",2019-02-22,110,5,81,191
"696","0800-0859",2019-02-23,111,6,65,176
"697","0800-0859",2019-02-24,110,7,63,173
"698","0800-0859",2019-02-25,109,1,81,190
"699","0800-0859",2019-02-26,104,2,72,176
"700","0800-0859",2019-02-27,103,3,68,171
"701","0800-0859",2019-02-28,109,4,81,190
"702","0900-0959",2019-02-01,85,5,63,148
"703","0900-0959",2019-02-02,70,6,55,125
"704","0900-0959",2019-02-03,69,7,54,123
"705","0900-0959",2019-02-04,85,1,61,146
"706","0900-0959",2019-02-05,81,2,55,136
"707","0900-0959",2019-02-06,81,3,53,134
"708","0900-0959",2019-02-07,87,4,61,148
"709","0900-0959",2019-02-08,85,5,61,146
"710","0900-0959",2019-02-09,70,6,54,124
"711","0900-0959",2019-02-10,77,7,56,133
"712","0900-0959",2019-02-11,84,1,61,145
"713","0900-0959",2019-02-12,80,2,55,135
"714","0900-0959",2019-02-13,80,3,53,133
"715","0900-0959",2019-02-14,88,4,56,144
"716","0900-0959",2019-02-15,86,5,56,142
"717","0900-0959",2019-02-16,71,6,51,122
"718","0900-0959",2019-02-17,74,7,55,129
"719","0900-0959",2019-02-18,86,1,55,141
"720","0900-0959",2019-02-19,84,2,55,139
"721","0900-0959",2019-02-20,84,3,55,139
"722","0900-0959",2019-02-21,88,4,58,146
"723","0900-0959",2019-02-22,86,5,57,143
"724","0900-0959",2019-02-23,72,6,52,124
"725","0900-0959",2019-02-24,79,7,54,133
"726","0900-0959",2019-02-25,86,1,57,143
"727","0900-0959",2019-02-26,85,2,56,141
"728","0900-0959",2019-02-27,81,3,56,137
"729","0900-0959",2019-02-28,90,4,59,149
"730","1000-1059",2019-02-01,73,5,65,138
"731","1000-1059",2019-02-02,61,6,58,119
"732","1000-1059",2019-02-03,71,7,60,131
"733","1000-1059",2019-02-04,73,1,65,138
"734","1000-1059",2019-02-05,69,2,60,129
"735","1000-1059",2019-02-06,69,3,61,130
"736","1000-1059",2019-02-07,73,4,66,139
"737","1000-1059",2019-02-08,72,5,66,138
"738","1000-1059",2019-02-09,61,6,59,120
"739","1000-1059",2019-02-10,74,7,61,135
"740","1000-1059",2019-02-11,74,1,64,138
"741","1000-1059",2019-02-12,70,2,59,129
"742","1000-1059",2019-02-13,70,3,61,131
"743","1000-1059",2019-02-14,77,4,70,147
"744","1000-1059",2019-02-15,77,5,73,150
"745","1000-1059",2019-02-16,62,6,68,130
"746","1000-1059",2019-02-17,77,7,66,143
"747","1000-1059",2019-02-18,77,1,73,150
"748","1000-1059",2019-02-19,75,2,67,142
"749","1000-1059",2019-02-20,75,3,69,144
"750","1000-1059",2019-02-21,79,4,69,148
"751","1000-1059",2019-02-22,77,5,72,149
"752","1000-1059",2019-02-23,61,6,68,129
"753","1000-1059",2019-02-24,79,7,68,147
"754","1000-1059",2019-02-25,78,1,71,149
"755","1000-1059",2019-02-26,74,2,67,141
"756","1000-1059",2019-02-27,73,3,67,140
"757","1000-1059",2019-02-28,78,4,69,147
"758","1100-1159",2019-02-01,78,5,72,150
"759","1100-1159",2019-02-02,66,6,64,130
"760","1100-1159",2019-02-03,75,7,67,142
"761","1100-1159",2019-02-04,77,1,75,152
"762","1100-1159",2019-02-05,73,2,68,141
"763","1100-1159",2019-02-06,76,3,69,145
"764","1100-1159",2019-02-07,78,4,76,154
"765","1100-1159",2019-02-08,78,5,74,152
"766","1100-1159",2019-02-09,65,6,66,131
"767","1100-1159",2019-02-10,73,7,74,147
"768","1100-1159",2019-02-11,77,1,74,151
"769","1100-1159",2019-02-12,73,2,68,141
"770","1100-1159",2019-02-13,76,3,69,145
"771","1100-1159",2019-02-14,83,4,70,153
"772","1100-1159",2019-02-15,83,5,68,151
"773","1100-1159",2019-02-16,75,6,56,131
"774","1100-1159",2019-02-17,77,7,64,141
"775","1100-1159",2019-02-18,83,1,67,150
"776","1100-1159",2019-02-19,80,2,64,144
"777","1100-1159",2019-02-20,83,3,64,147
"778","1100-1159",2019-02-21,83,4,70,153
"779","1100-1159",2019-02-22,83,5,68,151
"780","1100-1159",2019-02-23,75,6,57,132
"781","1100-1159",2019-02-24,79,7,68,147
"782","1100-1159",2019-02-25,83,1,69,152
"783","1100-1159",2019-02-26,80,2,66,146
"784","1100-1159",2019-02-27,80,3,64,144
"785","1100-1159",2019-02-28,83,4,72,155
"786","1200-1259",2019-02-01,71,5,79,150
"787","1200-1259",2019-02-02,61,6,70,131
"788","1200-1259",2019-02-03,67,7,68,135
"789","1200-1259",2019-02-04,72,1,77,149
"790","1200-1259",2019-02-05,71,2,73,144
"791","1200-1259",2019-02-06,74,3,76,150
"792","1200-1259",2019-02-07,75,4,78,153
"793","1200-1259",2019-02-08,74,5,79,153
"794","1200-1259",2019-02-09,64,6,69,133
"795","1200-1259",2019-02-10,77,7,71,148
"796","1200-1259",2019-02-11,73,1,78,151
"797","1200-1259",2019-02-12,72,2,74,146
"798","1200-1259",2019-02-13,75,3,77,152
"799","1200-1259",2019-02-14,72,4,83,155
"800","1200-1259",2019-02-15,72,5,83,155
"801","1200-1259",2019-02-16,58,6,71,129
"802","1200-1259",2019-02-17,70,7,71,141
"803","1200-1259",2019-02-18,69,1,81,150
"804","1200-1259",2019-02-19,68,2,81,149
"805","1200-1259",2019-02-20,68,3,83,151
"806","1200-1259",2019-02-21,72,4,84,156
"807","1200-1259",2019-02-22,72,5,83,155
"808","1200-1259",2019-02-23,60,6,71,131
"809","1200-1259",2019-02-24,75,7,75,150
"810","1200-1259",2019-02-25,72,1,82,154
"811","1200-1259",2019-02-26,69,2,79,148
"812","1200-1259",2019-02-27,68,3,79,147
"813","1200-1259",2019-02-28,73,4,82,155
"814","1300-1359",2019-02-01,74,5,68,142
"815","1300-1359",2019-02-02,64,6,60,124
"816","1300-1359",2019-02-03,68,7,68,136
"817","1300-1359",2019-02-04,74,1,69,143
"818","1300-1359",2019-02-05,72,2,66,138
"819","1300-1359",2019-02-06,71,3,67,138
"820","1300-1359",2019-02-07,74,4,70,144
"821","1300-1359",2019-02-08,73,5,69,142
"822","1300-1359",2019-02-09,63,6,60,123
"823","1300-1359",2019-02-10,65,7,70,135
"824","1300-1359",2019-02-11,72,1,69,141
"825","1300-1359",2019-02-12,70,2,65,135
"826","1300-1359",2019-02-13,71,3,67,138
"827","1300-1359",2019-02-14,76,4,71,147
"828","1300-1359",2019-02-15,74,5,69,143
"829","1300-1359",2019-02-16,64,6,63,127
"830","1300-1359",2019-02-17,68,7,73,141
"831","1300-1359",2019-02-18,75,1,68,143
"832","1300-1359",2019-02-19,71,2,66,137
"833","1300-1359",2019-02-20,73,3,66,139
"834","1300-1359",2019-02-21,76,4,71,147
"835","1300-1359",2019-02-22,74,5,69,143
"836","1300-1359",2019-02-23,63,6,62,125
"837","1300-1359",2019-02-24,68,7,73,141
"838","1300-1359",2019-02-25,74,1,69,143
"839","1300-1359",2019-02-26,70,2,66,136
"840","1300-1359",2019-02-27,70,3,65,135
"841","1300-1359",2019-02-28,74,4,71,145
"842","1400-1459",2019-02-01,79,5,79,158
"843","1400-1459",2019-02-02,59,6,68,127
"844","1400-1459",2019-02-03,73,7,74,147
"845","1400-1459",2019-02-04,79,1,79,158
"846","1400-1459",2019-02-05,75,2,77,152
"847","1400-1459",2019-02-06,77,3,77,154
"848","1400-1459",2019-02-07,78,4,80,158
"849","1400-1459",2019-02-08,79,5,78,157
"850","1400-1459",2019-02-09,60,6,68,128
"851","1400-1459",2019-02-10,70,7,80,150
"852","1400-1459",2019-02-11,79,1,79,158
"853","1400-1459",2019-02-12,76,2,78,154
"854","1400-1459",2019-02-13,78,3,77,155
"855","1400-1459",2019-02-14,81,4,81,162
"856","1400-1459",2019-02-15,82,5,81,163
"857","1400-1459",2019-02-16,62,6,74,136
"858","1400-1459",2019-02-17,71,7,78,149
"859","1400-1459",2019-02-18,81,1,81,162
"860","1400-1459",2019-02-19,75,2,79,154
"861","1400-1459",2019-02-20,78,3,79,157
"862","1400-1459",2019-02-21,81,4,81,162
"863","1400-1459",2019-02-22,82,5,81,163
"864","1400-1459",2019-02-23,63,6,76,139
"865","1400-1459",2019-02-24,72,7,81,153
"866","1400-1459",2019-02-25,81,1,82,163
"867","1400-1459",2019-02-26,75,2,80,155
"868","1400-1459",2019-02-27,77,3,77,154
"869","1400-1459",2019-02-28,82,4,81,163
"870","1500-1559",2019-02-01,84,5,79,163
"871","1500-1559",2019-02-02,76,6,63,139
"872","1500-1559",2019-02-03,76,7,72,148
"873","1500-1559",2019-02-04,84,1,81,165
"874","1500-1559",2019-02-05,79,2,75,154
"875","1500-1559",2019-02-06,81,3,75,156
"876","1500-1559",2019-02-07,84,4,77,161
"877","1500-1559",2019-02-08,84,5,79,163
"878","1500-1559",2019-02-09,76,6,64,140
"879","1500-1559",2019-02-10,83,7,68,151
"880","1500-1559",2019-02-11,84,1,78,162
"881","1500-1559",2019-02-12,79,2,75,154
"882","1500-1559",2019-02-13,81,3,75,156
"883","1500-1559",2019-02-14,92,4,79,171
"884","1500-1559",2019-02-15,92,5,79,171
"885","1500-1559",2019-02-16,83,6,60,143
"886","1500-1559",2019-02-17,86,7,69,155
"887","1500-1559",2019-02-18,92,1,79,171
"888","1500-1559",2019-02-19,89,2,73,162
"889","1500-1559",2019-02-20,88,3,75,163
"890","1500-1559",2019-02-21,93,4,80,173
"891","1500-1559",2019-02-22,92,5,79,171
"892","1500-1559",2019-02-23,85,6,60,145
"893","1500-1559",2019-02-24,90,7,69,159
"894","1500-1559",2019-02-25,92,1,79,171
"895","1500-1559",2019-02-26,89,2,72,161
"896","1500-1559",2019-02-27,83,3,72,155
"897","1500-1559",2019-02-28,92,4,80,172
"898","1600-1659",2019-02-01,82,5,78,160
"899","1600-1659",2019-02-02,62,6,66,128
"900","1600-1659",2019-02-03,82,7,74,156
"901","1600-1659",2019-02-04,84,1,78,162
"902","1600-1659",2019-02-05,75,2,77,152
"903","1600-1659",2019-02-06,76,3,79,155
"904","1600-1659",2019-02-07,83,4,80,163
"905","1600-1659",2019-02-08,85,5,79,164
"906","1600-1659",2019-02-09,67,6,68,135
"907","1600-1659",2019-02-10,80,7,79,159
"908","1600-1659",2019-02-11,86,1,79,165
"909","1600-1659",2019-02-12,75,2,77,152
"910","1600-1659",2019-02-13,77,3,79,156
"911","1600-1659",2019-02-14,81,4,84,165
"912","1600-1659",2019-02-15,83,5,83,166
"913","1600-1659",2019-02-16,60,6,75,135
"914","1600-1659",2019-02-17,75,7,82,157
"915","1600-1659",2019-02-18,81,1,82,163
"916","1600-1659",2019-02-19,74,2,81,155
"917","1600-1659",2019-02-20,80,3,81,161
"918","1600-1659",2019-02-21,81,4,84,165
"919","1600-1659",2019-02-22,82,5,83,165
"920","1600-1659",2019-02-23,68,6,75,143
"921","1600-1659",2019-02-24,79,7,85,164
"922","1600-1659",2019-02-25,83,1,83,166
"923","1600-1659",2019-02-26,75,2,81,156
"924","1600-1659",2019-02-27,79,3,79,158
"925","1600-1659",2019-02-28,83,4,84,167
"926","1700-1759",2019-02-01,82,5,84,166
"927","1700-1759",2019-02-02,69,6,65,134
"928","1700-1759",2019-02-03,73,7,68,141
"929","1700-1759",2019-02-04,83,1,86,169
"930","1700-1759",2019-02-05,76,2,80,156
"931","1700-1759",2019-02-06,78,3,81,159
"932","1700-1759",2019-02-07,81,4,85,166
"933","1700-1759",2019-02-08,80,5,85,165
"934","1700-1759",2019-02-09,68,6,65,133
"935","1700-1759",2019-02-10,80,7,75,155
"936","1700-1759",2019-02-11,80,1,86,166
"937","1700-1759",2019-02-12,75,2,80,155
"938","1700-1759",2019-02-13,79,3,81,160
"939","1700-1759",2019-02-14,88,4,96,184
"940","1700-1759",2019-02-15,89,5,98,187
"941","1700-1759",2019-02-16,72,6,72,144
"942","1700-1759",2019-02-17,78,7,80,158
"943","1700-1759",2019-02-18,89,1,96,185
"944","1700-1759",2019-02-19,83,2,92,175
"945","1700-1759",2019-02-20,84,3,94,178
"946","1700-1759",2019-02-21,88,4,96,184
"947","1700-1759",2019-02-22,89,5,97,186
"948","1700-1759",2019-02-23,74,6,76,150
"949","1700-1759",2019-02-24,87,7,88,175
"950","1700-1759",2019-02-25,89,1,99,188
"951","1700-1759",2019-02-26,83,2,93,176
"952","1700-1759",2019-02-27,83,3,89,172
"953","1700-1759",2019-02-28,88,4,97,185
"954","1800-1859",2019-02-01,74,5,86,160
"955","1800-1859",2019-02-02,58,6,63,121
"956","1800-1859",2019-02-03,69,7,79,148
"957","1800-1859",2019-02-04,73,1,86,159
"958","1800-1859",2019-02-05,64,2,80,144
"959","1800-1859",2019-02-06,65,3,79,144
"960","1800-1859",2019-02-07,74,4,84,158
"961","1800-1859",2019-02-08,74,5,85,159
"962","1800-1859",2019-02-09,57,6,64,121
"963","1800-1859",2019-02-10,80,7,80,160
"964","1800-1859",2019-02-11,73,1,86,159
"965","1800-1859",2019-02-12,64,2,79,143
"966","1800-1859",2019-02-13,66,3,80,146
"967","1800-1859",2019-02-14,75,4,87,162
"968","1800-1859",2019-02-15,75,5,84,159
"969","1800-1859",2019-02-16,62,6,66,128
"970","1800-1859",2019-02-17,74,7,81,155
"971","1800-1859",2019-02-18,73,1,85,158
"972","1800-1859",2019-02-19,71,2,81,152
"973","1800-1859",2019-02-20,71,3,83,154
"974","1800-1859",2019-02-21,75,4,86,161
"975","1800-1859",2019-02-22,75,5,84,159
"976","1800-1859",2019-02-23,61,6,68,129
"977","1800-1859",2019-02-24,79,7,81,160
"978","1800-1859",2019-02-25,73,1,84,157
"979","1800-1859",2019-02-26,70,2,81,151
"980","1800-1859",2019-02-27,68,3,81,149
"981","1800-1859",2019-02-28,75,4,86,161
"982","1900-1959",2019-02-01,82,5,74,156
"983","1900-1959",2019-02-02,54,6,64,118
"984","1900-1959",2019-02-03,64,7,72,136
"985","1900-1959",2019-02-04,82,1,71,153
"986","1900-1959",2019-02-05,69,2,68,137
"987","1900-1959",2019-02-06,74,3,69,143
"988","1900-1959",2019-02-07,80,4,72,152
"989","1900-1959",2019-02-08,82,5,72,154
"990","1900-1959",2019-02-09,57,6,65,122
"991","1900-1959",2019-02-10,72,7,73,145
"992","1900-1959",2019-02-11,81,1,70,151
"993","1900-1959",2019-02-12,68,2,68,136
"994","1900-1959",2019-02-13,72,3,69,141
"995","1900-1959",2019-02-14,80,4,72,152
"996","1900-1959",2019-02-15,80,5,73,153
"997","1900-1959",2019-02-16,56,6,66,122
"998","1900-1959",2019-02-17,65,7,65,130
"999","1900-1959",2019-02-18,79,1,71,150
"1000","1900-1959",2019-02-19,76,2,71,147
"1001","1900-1959",2019-02-20,78,3,73,151
"1002","1900-1959",2019-02-21,80,4,72,152
"1003","1900-1959",2019-02-22,80,5,73,153
"1004","1900-1959",2019-02-23,59,6,68,127
"1005","1900-1959",2019-02-24,73,7,72,145
"1006","1900-1959",2019-02-25,80,1,71,151
"1007","1900-1959",2019-02-26,76,2,71,147
"1008","1900-1959",2019-02-27,76,3,73,149
"1009","1900-1959",2019-02-28,80,4,72,152
"1010","2000-2059",2019-02-01,51,5,87,138
"1011","2000-2059",2019-02-02,36,6,71,107
"1012","2000-2059",2019-02-03,45,7,75,120
"1013","2000-2059",2019-02-04,52,1,87,139
"1014","2000-2059",2019-02-05,46,2,82,128
"1015","2000-2059",2019-02-06,46,3,82,128
"1016","2000-2059",2019-02-07,52,4,89,141
"1017","2000-2059",2019-02-08,50,5,88,138
"1018","2000-2059",2019-02-09,36,6,73,109
"1019","2000-2059",2019-02-10,51,7,86,137
"1020","2000-2059",2019-02-11,52,1,88,140
"1021","2000-2059",2019-02-12,47,2,82,129
"1022","2000-2059",2019-02-13,49,3,82,131
"1023","2000-2059",2019-02-14,51,4,86,137
"1024","2000-2059",2019-02-15,52,5,87,139
"1025","2000-2059",2019-02-16,36,6,64,100
"1026","2000-2059",2019-02-17,47,7,74,121
"1027","2000-2059",2019-02-18,53,1,87,140
"1028","2000-2059",2019-02-19,47,2,80,127
"1029","2000-2059",2019-02-20,48,3,81,129
"1030","2000-2059",2019-02-21,51,4,86,137
"1031","2000-2059",2019-02-22,52,5,87,139
"1032","2000-2059",2019-02-23,39,6,67,106
"1033","2000-2059",2019-02-24,49,7,83,132
"1034","2000-2059",2019-02-25,52,1,86,138
"1035","2000-2059",2019-02-26,47,2,80,127
"1036","2000-2059",2019-02-27,42,3,78,120
"1037","2000-2059",2019-02-28,51,4,86,137
"1038","2100-2159",2019-02-01,60,5,97,157
"1039","2100-2159",2019-02-02,35,6,80,115
"1040","2100-2159",2019-02-03,41,7,93,134
"1041","2100-2159",2019-02-04,59,1,96,155
"1042","2100-2159",2019-02-05,50,2,82,132
"1043","2100-2159",2019-02-06,51,3,84,135
"1044","2100-2159",2019-02-07,59,4,96,155
"1045","2100-2159",2019-02-08,60,5,96,156
"1046","2100-2159",2019-02-09,36,6,80,116
"1047","2100-2159",2019-02-10,54,7,93,147
"1048","2100-2159",2019-02-11,59,1,94,153
"1049","2100-2159",2019-02-12,50,2,80,130
"1050","2100-2159",2019-02-13,54,3,87,141
"1051","2100-2159",2019-02-14,58,4,94,152
"1052","2100-2159",2019-02-15,58,5,94,152
"1053","2100-2159",2019-02-16,35,6,78,113
"1054","2100-2159",2019-02-17,48,7,87,135
"1055","2100-2159",2019-02-18,58,1,91,149
"1056","2100-2159",2019-02-19,53,2,86,139
"1057","2100-2159",2019-02-20,57,3,87,144
"1058","2100-2159",2019-02-21,58,4,94,152
"1059","2100-2159",2019-02-22,58,5,94,152
"1060","2100-2159",2019-02-23,38,6,81,119
"1061","2100-2159",2019-02-24,54,7,90,144
"1062","2100-2159",2019-02-25,57,1,92,149
"1063","2100-2159",2019-02-26,53,2,85,138
"1064","2100-2159",2019-02-27,56,3,85,141
"1065","2100-2159",2019-02-28,58,4,94,152
"1066","2200-2259",2019-02-01,36,5,75,111
"1067","2200-2259",2019-02-02,22,6,46,68
"1068","2200-2259",2019-02-03,31,7,61,92
"1069","2200-2259",2019-02-04,35,1,77,112
"1070","2200-2259",2019-02-05,28,2,67,95
"1071","2200-2259",2019-02-06,30,3,72,102
"1072","2200-2259",2019-02-07,37,4,77,114
"1073","2200-2259",2019-02-08,36,5,76,112
"1074","2200-2259",2019-02-09,21,6,48,69
"1075","2200-2259",2019-02-10,36,7,75,111
"1076","2200-2259",2019-02-11,34,1,78,112
"1077","2200-2259",2019-02-12,28,2,69,97
"1078","2200-2259",2019-02-13,30,3,73,103
"1079","2200-2259",2019-02-14,39,4,78,117
"1080","2200-2259",2019-02-15,39,5,79,118
"1081","2200-2259",2019-02-16,27,6,52,79
"1082","2200-2259",2019-02-17,33,7,68,101
"1083","2200-2259",2019-02-18,37,1,79,116
"1084","2200-2259",2019-02-19,36,2,77,113
"1085","2200-2259",2019-02-20,35,3,78,113
"1086","2200-2259",2019-02-21,38,4,78,116
"1087","2200-2259",2019-02-22,38,5,79,117
"1088","2200-2259",2019-02-23,28,6,56,84
"1089","2200-2259",2019-02-24,37,7,75,112
"1090","2200-2259",2019-02-25,37,1,80,117
"1091","2200-2259",2019-02-26,34,2,77,111
"1092","2200-2259",2019-02-27,34,3,75,109
"1093","2200-2259",2019-02-28,38,4,78,116
"1094","2300-2359",2019-02-01,21,5,73,94
"1095","2300-2359",2019-02-02,18,6,49,67
"1096","2300-2359",2019-02-03,22,7,57,79
"1097","2300-2359",2019-02-04,21,1,75,96
"1098","2300-2359",2019-02-05,17,2,65,82
"1099","2300-2359",2019-02-06,20,3,69,89
"1100","2300-2359",2019-02-07,21,4,75,96
"1101","2300-2359",2019-02-08,21,5,73,94
"1102","2300-2359",2019-02-09,18,6,50,68
"1103","2300-2359",2019-02-10,20,7,70,90
"1104","2300-2359",2019-02-11,22,1,75,97
"1105","2300-2359",2019-02-12,19,2,65,84
"1106","2300-2359",2019-02-13,20,3,73,93
"1107","2300-2359",2019-02-14,25,4,74,99
"1108","2300-2359",2019-02-15,25,5,73,98
"1109","2300-2359",2019-02-16,20,6,52,72
"1110","2300-2359",2019-02-17,22,7,67,89
"1111","2300-2359",2019-02-18,24,1,75,99
"1112","2300-2359",2019-02-19,22,2,66,88
"1113","2300-2359",2019-02-20,23,3,71,94
"1114","2300-2359",2019-02-21,24,4,74,98
"1115","2300-2359",2019-02-22,24,5,72,96
"1116","2300-2359",2019-02-23,23,6,52,75
"1117","2300-2359",2019-02-24,23,7,71,94
"1118","2300-2359",2019-02-25,24,1,74,98
"1119","2300-2359",2019-02-26,22,2,65,87
"1120","2300-2359",2019-02-27,22,3,67,89
"1121","2300-2359",2019-02-28,24,4,74,98
"1122","0001-0559",2019-03-01,27,5,74,101
"1123","0001-0559",2019-03-02,18,6,52,70
"1124","0001-0559",2019-03-03,18,7,68,86
"1125","0001-0559",2019-03-04,25,1,69,94
"1126","0001-0559",2019-03-05,23,2,62,85
"1127","0001-0559",2019-03-06,23,3,63,86
"1128","0001-0559",2019-03-07,32,4,77,109
"1129","0001-0559",2019-03-08,35,5,80,115
"1130","0001-0559",2019-03-09,27,6,38,65
"1131","0001-0559",2019-03-10,30,7,92,122
"1132","0001-0559",2019-03-11,39,1,83,122
"1133","0001-0559",2019-03-12,37,2,77,114
"1134","0001-0559",2019-03-13,37,3,79,116
"1135","0001-0559",2019-03-14,39,4,83,122
"1136","0001-0559",2019-03-15,39,5,82,121
"1137","0001-0559",2019-03-16,30,6,59,89
"1138","0001-0559",2019-03-17,28,7,91,119
"1139","0001-0559",2019-03-18,39,1,81,120
"1140","0001-0559",2019-03-19,37,2,75,112
"1141","0001-0559",2019-03-20,37,3,77,114
"1142","0001-0559",2019-03-21,39,4,81,120
"1143","0001-0559",2019-03-22,39,5,80,119
"1144","0001-0559",2019-03-23,30,6,55,85
"1145","0001-0559",2019-03-24,28,7,89,117
"1146","0001-0559",2019-03-25,39,1,79,118
"1147","0001-0559",2019-03-26,37,2,74,111
"1148","0001-0559",2019-03-27,37,3,76,113
"1149","0001-0559",2019-03-28,39,4,79,118
"1150","0001-0559",2019-03-29,40,5,78,118
"1151","0001-0559",2019-03-30,31,6,57,88
"1152","0001-0559",2019-03-31,30,7,88,118
"1153","0600-0659",2019-03-01,110,5,20,130
"1154","0600-0659",2019-03-02,87,6,16,103
"1155","0600-0659",2019-03-03,97,7,19,116
"1156","0600-0659",2019-03-04,111,1,22,133
"1157","0600-0659",2019-03-05,104,2,19,123
"1158","0600-0659",2019-03-06,105,3,20,125
"1159","0600-0659",2019-03-07,107,4,28,135
"1160","0600-0659",2019-03-08,106,5,33,139
"1161","0600-0659",2019-03-09,88,6,35,123
"1162","0600-0659",2019-03-10,104,7,19,123
"1163","0600-0659",2019-03-11,108,1,29,137
"1164","0600-0659",2019-03-12,97,2,27,124
"1165","0600-0659",2019-03-13,96,3,28,124
"1166","0600-0659",2019-03-14,110,4,29,139
"1167","0600-0659",2019-03-15,109,5,31,140
"1168","0600-0659",2019-03-16,93,6,28,121
"1169","0600-0659",2019-03-17,104,7,21,125
"1170","0600-0659",2019-03-18,108,1,29,137
"1171","0600-0659",2019-03-19,97,2,27,124
"1172","0600-0659",2019-03-20,96,3,28,124
"1173","0600-0659",2019-03-21,109,4,29,138
"1174","0600-0659",2019-03-22,107,5,31,138
"1175","0600-0659",2019-03-23,91,6,28,119
"1176","0600-0659",2019-03-24,102,7,21,123
"1177","0600-0659",2019-03-25,106,1,29,135
"1178","0600-0659",2019-03-26,95,2,27,122
"1179","0600-0659",2019-03-27,94,3,28,122
"1180","0600-0659",2019-03-28,109,4,29,138
"1181","0600-0659",2019-03-29,107,5,31,138
"1182","0600-0659",2019-03-30,91,6,29,120
"1183","0600-0659",2019-03-31,98,7,22,120
"1184","0700-0759",2019-03-01,103,5,60,163
"1185","0700-0759",2019-03-02,93,6,49,142
"1186","0700-0759",2019-03-03,92,7,55,147
"1187","0700-0759",2019-03-04,106,1,60,166
"1188","0700-0759",2019-03-05,96,2,56,152
"1189","0700-0759",2019-03-06,97,3,60,157
"1190","0700-0759",2019-03-07,104,4,61,165
"1191","0700-0759",2019-03-08,106,5,61,167
"1192","0700-0759",2019-03-09,94,6,59,153
"1193","0700-0759",2019-03-10,95,7,64,159
"1194","0700-0759",2019-03-11,109,1,63,172
"1195","0700-0759",2019-03-12,102,2,57,159
"1196","0700-0759",2019-03-13,101,3,58,159
"1197","0700-0759",2019-03-14,107,4,66,173
"1198","0700-0759",2019-03-15,108,5,66,174
"1199","0700-0759",2019-03-16,93,6,59,152
"1200","0700-0759",2019-03-17,98,7,61,159
"1201","0700-0759",2019-03-18,110,1,64,174
"1202","0700-0759",2019-03-19,102,2,58,160
"1203","0700-0759",2019-03-20,101,3,59,160
"1204","0700-0759",2019-03-21,105,4,66,171
"1205","0700-0759",2019-03-22,106,5,66,172
"1206","0700-0759",2019-03-23,91,6,59,150
"1207","0700-0759",2019-03-24,95,7,61,156
"1208","0700-0759",2019-03-25,108,1,64,172
"1209","0700-0759",2019-03-26,100,2,58,158
"1210","0700-0759",2019-03-27,99,3,59,158
"1211","0700-0759",2019-03-28,105,4,66,171
"1212","0700-0759",2019-03-29,106,5,67,173
"1213","0700-0759",2019-03-30,91,6,59,150
"1214","0700-0759",2019-03-31,91,7,58,149
"1215","0800-0859",2019-03-01,109,5,81,190
"1216","0800-0859",2019-03-02,108,6,65,173
"1217","0800-0859",2019-03-03,112,7,67,179
"1218","0800-0859",2019-03-04,110,1,83,193
"1219","0800-0859",2019-03-05,105,2,75,180
"1220","0800-0859",2019-03-06,106,3,75,181
"1221","0800-0859",2019-03-07,108,4,79,187
"1222","0800-0859",2019-03-08,103,5,79,182
"1223","0800-0859",2019-03-09,94,6,64,158
"1224","0800-0859",2019-03-10,106,7,68,174
"1225","0800-0859",2019-03-11,102,1,78,180
"1226","0800-0859",2019-03-12,98,2,70,168
"1227","0800-0859",2019-03-13,99,3,70,169
"1228","0800-0859",2019-03-14,103,4,77,180
"1229","0800-0859",2019-03-15,102,5,77,179
"1230","0800-0859",2019-03-16,88,6,58,146
"1231","0800-0859",2019-03-17,104,7,69,173
"1232","0800-0859",2019-03-18,101,1,77,178
"1233","0800-0859",2019-03-19,99,2,70,169
"1234","0800-0859",2019-03-20,99,3,70,169
"1235","0800-0859",2019-03-21,103,4,76,179
"1236","0800-0859",2019-03-22,102,5,76,178
"1237","0800-0859",2019-03-23,88,6,57,145
"1238","0800-0859",2019-03-24,105,7,68,173
"1239","0800-0859",2019-03-25,101,1,77,178
"1240","0800-0859",2019-03-26,99,2,69,168
"1241","0800-0859",2019-03-27,98,3,69,167
"1242","0800-0859",2019-03-28,103,4,76,179
"1243","0800-0859",2019-03-29,102,5,76,178
"1244","0800-0859",2019-03-30,88,6,57,145
"1245","0800-0859",2019-03-31,109,7,66,175
"1246","0900-0959",2019-03-01,88,5,58,146
"1247","0900-0959",2019-03-02,72,6,52,124
"1248","0900-0959",2019-03-03,81,7,53,134
"1249","0900-0959",2019-03-04,89,1,58,147
"1250","0900-0959",2019-03-05,87,2,55,142
"1251","0900-0959",2019-03-06,87,3,53,140
"1252","0900-0959",2019-03-07,87,4,59,146
"1253","0900-0959",2019-03-08,90,5,61,151
"1254","0900-0959",2019-03-09,78,6,55,133
"1255","0900-0959",2019-03-10,85,7,62,147
"1256","0900-0959",2019-03-11,91,1,67,158
"1257","0900-0959",2019-03-12,91,2,63,154
"1258","0900-0959",2019-03-13,91,3,60,151
"1259","0900-0959",2019-03-14,92,4,70,162
"1260","0900-0959",2019-03-15,91,5,68,159
"1261","0900-0959",2019-03-16,78,6,59,137
"1262","0900-0959",2019-03-17,85,7,62,147
"1263","0900-0959",2019-03-18,91,1,68,159
"1264","0900-0959",2019-03-19,91,2,63,154
"1265","0900-0959",2019-03-20,92,3,60,152
"1266","0900-0959",2019-03-21,92,4,70,162
"1267","0900-0959",2019-03-22,90,5,68,158
"1268","0900-0959",2019-03-23,77,6,60,137
"1269","0900-0959",2019-03-24,84,7,62,146
"1270","0900-0959",2019-03-25,90,1,67,157
"1271","0900-0959",2019-03-26,89,2,63,152
"1272","0900-0959",2019-03-27,92,3,60,152
"1273","0900-0959",2019-03-28,92,4,70,162
"1274","0900-0959",2019-03-29,90,5,68,158
"1275","0900-0959",2019-03-30,77,6,60,137
"1276","0900-0959",2019-03-31,81,7,60,141
"1277","1000-1059",2019-03-01,76,5,71,147
"1278","1000-1059",2019-03-02,59,6,68,127
"1279","1000-1059",2019-03-03,77,7,71,148
"1280","1000-1059",2019-03-04,76,1,74,150
"1281","1000-1059",2019-03-05,73,2,69,142
"1282","1000-1059",2019-03-06,73,3,70,143
"1283","1000-1059",2019-03-07,79,4,69,148
"1284","1000-1059",2019-03-08,76,5,68,144
"1285","1000-1059",2019-03-09,61,6,64,125
"1286","1000-1059",2019-03-10,73,7,70,143
"1287","1000-1059",2019-03-11,79,1,66,145
"1288","1000-1059",2019-03-12,74,2,63,137
"1289","1000-1059",2019-03-13,73,3,65,138
"1290","1000-1059",2019-03-14,80,4,65,145
"1291","1000-1059",2019-03-15,79,5,66,145
"1292","1000-1059",2019-03-16,64,6,62,126
"1293","1000-1059",2019-03-17,75,7,71,146
"1294","1000-1059",2019-03-18,79,1,67,146
"1295","1000-1059",2019-03-19,74,2,64,138
"1296","1000-1059",2019-03-20,73,3,65,138
"1297","1000-1059",2019-03-21,80,4,64,144
"1298","1000-1059",2019-03-22,79,5,64,143
"1299","1000-1059",2019-03-23,65,6,60,125
"1300","1000-1059",2019-03-24,75,7,68,143
"1301","1000-1059",2019-03-25,79,1,65,144
"1302","1000-1059",2019-03-26,74,2,62,136
"1303","1000-1059",2019-03-27,73,3,63,136
"1304","1000-1059",2019-03-28,80,4,64,144
"1305","1000-1059",2019-03-29,79,5,64,143
"1306","1000-1059",2019-03-30,65,6,60,125
"1307","1000-1059",2019-03-31,75,7,68,143
"1308","1100-1159",2019-03-01,82,5,71,153
"1309","1100-1159",2019-03-02,76,6,54,130
"1310","1100-1159",2019-03-03,83,7,67,150
"1311","1100-1159",2019-03-04,85,1,68,153
"1312","1100-1159",2019-03-05,82,2,64,146
"1313","1100-1159",2019-03-06,85,3,65,150
"1314","1100-1159",2019-03-07,87,4,71,158
"1315","1100-1159",2019-03-08,84,5,71,155
"1316","1100-1159",2019-03-09,81,6,56,137
"1317","1100-1159",2019-03-10,82,7,76,158
"1318","1100-1159",2019-03-11,83,1,80,163
"1319","1100-1159",2019-03-12,80,2,78,158
"1320","1100-1159",2019-03-13,80,3,77,157
"1321","1100-1159",2019-03-14,82,4,81,163
"1322","1100-1159",2019-03-15,82,5,80,162
"1323","1100-1159",2019-03-16,76,6,64,140
"1324","1100-1159",2019-03-17,81,7,74,155
"1325","1100-1159",2019-03-18,82,1,79,161
"1326","1100-1159",2019-03-19,80,2,78,158
"1327","1100-1159",2019-03-20,79,3,78,157
"1328","1100-1159",2019-03-21,81,4,80,161
"1329","1100-1159",2019-03-22,81,5,79,160
"1330","1100-1159",2019-03-23,73,6,62,135
"1331","1100-1159",2019-03-24,80,7,74,154
"1332","1100-1159",2019-03-25,81,1,78,159
"1333","1100-1159",2019-03-26,80,2,77,157
"1334","1100-1159",2019-03-27,79,3,78,157
"1335","1100-1159",2019-03-28,81,4,80,161
"1336","1100-1159",2019-03-29,81,5,79,160
"1337","1100-1159",2019-03-30,73,6,62,135
"1338","1100-1159",2019-03-31,80,7,72,152
"1339","1200-1259",2019-03-01,74,5,81,155
"1340","1200-1259",2019-03-02,63,6,73,136
"1341","1200-1259",2019-03-03,74,7,71,145
"1342","1200-1259",2019-03-04,72,1,77,149
"1343","1200-1259",2019-03-05,70,2,75,145
"1344","1200-1259",2019-03-06,70,3,77,147
"1345","1200-1259",2019-03-07,75,4,76,151
"1346","1200-1259",2019-03-08,78,5,74,152
"1347","1200-1259",2019-03-09,58,6,76,134
"1348","1200-1259",2019-03-10,70,7,64,134
"1349","1200-1259",2019-03-11,78,1,67,145
"1350","1200-1259",2019-03-12,76,2,65,141
"1351","1200-1259",2019-03-13,76,3,67,143
"1352","1200-1259",2019-03-14,80,4,66,146
"1353","1200-1259",2019-03-15,79,5,67,146
"1354","1200-1259",2019-03-16,64,6,68,132
"1355","1200-1259",2019-03-17,71,7,64,135
"1356","1200-1259",2019-03-18,79,1,67,146
"1357","1200-1259",2019-03-19,77,2,65,142
"1358","1200-1259",2019-03-20,77,3,67,144
"1359","1200-1259",2019-03-21,78,4,67,145
"1360","1200-1259",2019-03-22,77,5,67,144
"1361","1200-1259",2019-03-23,63,6,69,132
"1362","1200-1259",2019-03-24,69,7,64,133
"1363","1200-1259",2019-03-25,77,1,67,144
"1364","1200-1259",2019-03-26,76,2,65,141
"1365","1200-1259",2019-03-27,76,3,67,143
"1366","1200-1259",2019-03-28,78,4,67,145
"1367","1200-1259",2019-03-29,77,5,67,144
"1368","1200-1259",2019-03-30,63,6,69,132
"1369","1200-1259",2019-03-31,62,7,67,129
"1370","1300-1359",2019-03-01,73,5,69,142
"1371","1300-1359",2019-03-02,61,6,57,118
"1372","1300-1359",2019-03-03,65,7,67,132
"1373","1300-1359",2019-03-04,71,1,65,136
"1374","1300-1359",2019-03-05,67,2,62,129
"1375","1300-1359",2019-03-06,69,3,62,131
"1376","1300-1359",2019-03-07,72,4,69,141
"1377","1300-1359",2019-03-08,68,5,69,137
"1378","1300-1359",2019-03-09,64,6,57,121
"1379","1300-1359",2019-03-10,77,7,64,141
"1380","1300-1359",2019-03-11,69,1,71,140
"1381","1300-1359",2019-03-12,67,2,68,135
"1382","1300-1359",2019-03-13,69,3,68,137
"1383","1300-1359",2019-03-14,71,4,73,144
"1384","1300-1359",2019-03-15,70,5,71,141
"1385","1300-1359",2019-03-16,61,6,60,121
"1386","1300-1359",2019-03-17,76,7,65,141
"1387","1300-1359",2019-03-18,70,1,71,141
"1388","1300-1359",2019-03-19,67,2,68,135
"1389","1300-1359",2019-03-20,69,3,68,137
"1390","1300-1359",2019-03-21,71,4,72,143
"1391","1300-1359",2019-03-22,70,5,70,140
"1392","1300-1359",2019-03-23,62,6,59,121
"1393","1300-1359",2019-03-24,76,7,64,140
"1394","1300-1359",2019-03-25,70,1,70,140
"1395","1300-1359",2019-03-26,67,2,67,134
"1396","1300-1359",2019-03-27,69,3,67,136
"1397","1300-1359",2019-03-28,71,4,72,143
"1398","1300-1359",2019-03-29,70,5,70,140
"1399","1300-1359",2019-03-30,62,6,59,121
"1400","1300-1359",2019-03-31,78,7,62,140
"1401","1400-1459",2019-03-01,82,5,82,164
"1402","1400-1459",2019-03-02,65,6,80,145
"1403","1400-1459",2019-03-03,78,7,92,170
"1404","1400-1459",2019-03-04,87,1,92,179
"1405","1400-1459",2019-03-05,82,2,91,173
"1406","1400-1459",2019-03-06,84,3,91,175
"1407","1400-1459",2019-03-07,82,4,95,177
"1408","1400-1459",2019-03-08,84,5,93,177
"1409","1400-1459",2019-03-09,66,6,78,144
"1410","1400-1459",2019-03-10,78,7,82,160
"1411","1400-1459",2019-03-11,85,1,85,170
"1412","1400-1459",2019-03-12,82,2,83,165
"1413","1400-1459",2019-03-13,82,3,83,165
"1414","1400-1459",2019-03-14,84,4,84,168
"1415","1400-1459",2019-03-15,85,5,85,170
"1416","1400-1459",2019-03-16,71,6,69,140
"1417","1400-1459",2019-03-17,79,7,81,160
"1418","1400-1459",2019-03-18,85,1,85,170
"1419","1400-1459",2019-03-19,82,2,84,166
"1420","1400-1459",2019-03-20,82,3,83,165
"1421","1400-1459",2019-03-21,84,4,83,167
"1422","1400-1459",2019-03-22,85,5,84,169
"1423","1400-1459",2019-03-23,71,6,67,138
"1424","1400-1459",2019-03-24,79,7,81,160
"1425","1400-1459",2019-03-25,85,1,84,169
"1426","1400-1459",2019-03-26,82,2,83,165
"1427","1400-1459",2019-03-27,82,3,82,164
"1428","1400-1459",2019-03-28,84,4,83,167
"1429","1400-1459",2019-03-29,85,5,84,169
"1430","1400-1459",2019-03-30,74,6,67,141
"1431","1400-1459",2019-03-31,81,7,82,163
"1432","1500-1559",2019-03-01,92,5,78,170
"1433","1500-1559",2019-03-02,86,6,59,145
"1434","1500-1559",2019-03-03,91,7,69,160
"1435","1500-1559",2019-03-04,93,1,79,172
"1436","1500-1559",2019-03-05,89,2,73,162
"1437","1500-1559",2019-03-06,88,3,75,163
"1438","1500-1559",2019-03-07,95,4,80,175
"1439","1500-1559",2019-03-08,94,5,80,174
"1440","1500-1559",2019-03-09,81,6,59,140
"1441","1500-1559",2019-03-10,87,7,86,173
"1442","1500-1559",2019-03-11,86,1,84,170
"1443","1500-1559",2019-03-12,82,2,81,163
"1444","1500-1559",2019-03-13,83,3,81,164
"1445","1500-1559",2019-03-14,86,4,86,172
"1446","1500-1559",2019-03-15,85,5,84,169
"1447","1500-1559",2019-03-16,74,6,64,138
"1448","1500-1559",2019-03-17,87,7,87,174
"1449","1500-1559",2019-03-18,87,1,84,171
"1450","1500-1559",2019-03-19,82,2,81,163
"1451","1500-1559",2019-03-20,83,3,81,164
"1452","1500-1559",2019-03-21,84,4,86,170
"1453","1500-1559",2019-03-22,83,5,84,167
"1454","1500-1559",2019-03-23,74,6,64,138
"1455","1500-1559",2019-03-24,85,7,86,171
"1456","1500-1559",2019-03-25,85,1,84,169
"1457","1500-1559",2019-03-26,80,2,81,161
"1458","1500-1559",2019-03-27,81,3,81,162
"1459","1500-1559",2019-03-28,84,4,86,170
"1460","1500-1559",2019-03-29,83,5,84,167
"1461","1500-1559",2019-03-30,72,6,64,136
"1462","1500-1559",2019-03-31,87,7,80,167
"1463","1600-1659",2019-03-01,82,5,83,165
"1464","1600-1659",2019-03-02,63,6,77,140
"1465","1600-1659",2019-03-03,77,7,85,162
"1466","1600-1659",2019-03-04,80,1,82,162
"1467","1600-1659",2019-03-05,75,2,80,155
"1468","1600-1659",2019-03-06,82,3,80,162
"1469","1600-1659",2019-03-07,84,4,78,162
"1470","1600-1659",2019-03-08,81,5,77,158
"1471","1600-1659",2019-03-09,64,6,76,140
"1472","1600-1659",2019-03-10,78,7,81,159
"1473","1600-1659",2019-03-11,83,1,80,163
"1474","1600-1659",2019-03-12,78,2,79,157
"1475","1600-1659",2019-03-13,81,3,78,159
"1476","1600-1659",2019-03-14,83,4,81,164
"1477","1600-1659",2019-03-15,83,5,80,163
"1478","1600-1659",2019-03-16,62,6,75,137
"1479","1600-1659",2019-03-17,79,7,81,160
"1480","1600-1659",2019-03-18,82,1,82,164
"1481","1600-1659",2019-03-19,79,2,79,158
"1482","1600-1659",2019-03-20,83,3,78,161
"1483","1600-1659",2019-03-21,83,4,81,164
"1484","1600-1659",2019-03-22,83,5,80,163
"1485","1600-1659",2019-03-23,61,6,76,137
"1486","1600-1659",2019-03-24,80,7,81,161
"1487","1600-1659",2019-03-25,82,1,82,164
"1488","1600-1659",2019-03-26,79,2,79,158
"1489","1600-1659",2019-03-27,83,3,78,161
"1490","1600-1659",2019-03-28,83,4,81,164
"1491","1600-1659",2019-03-29,83,5,80,163
"1492","1600-1659",2019-03-30,64,6,78,142
"1493","1600-1659",2019-03-31,75,7,86,161
"1494","1700-1759",2019-03-01,89,5,97,186
"1495","1700-1759",2019-03-02,77,6,77,154
"1496","1700-1759",2019-03-03,90,7,87,177
"1497","1700-1759",2019-03-04,93,1,98,191
"1498","1700-1759",2019-03-05,84,2,93,177
"1499","1700-1759",2019-03-06,85,3,96,181
"1500","1700-1759",2019-03-07,88,4,93,181
"1501","1700-1759",2019-03-08,90,5,93,183
"1502","1700-1759",2019-03-09,77,6,69,146
"1503","1700-1759",2019-03-10,92,7,81,173
"1504","1700-1759",2019-03-11,94,1,87,181
"1505","1700-1759",2019-03-12,87,2,82,169
"1506","1700-1759",2019-03-13,89,3,84,173
"1507","1700-1759",2019-03-14,92,4,86,178
"1508","1700-1759",2019-03-15,94,5,86,180
"1509","1700-1759",2019-03-16,84,6,64,148
"1510","1700-1759",2019-03-17,90,7,83,173
"1511","1700-1759",2019-03-18,93,1,85,178
"1512","1700-1759",2019-03-19,87,2,82,169
"1513","1700-1759",2019-03-20,89,3,84,173
"1514","1700-1759",2019-03-21,92,4,85,177
"1515","1700-1759",2019-03-22,94,5,85,179
"1516","1700-1759",2019-03-23,86,6,64,150
"1517","1700-1759",2019-03-24,90,7,81,171
"1518","1700-1759",2019-03-25,93,1,84,177
"1519","1700-1759",2019-03-26,87,2,81,168
"1520","1700-1759",2019-03-27,88,3,84,172
"1521","1700-1759",2019-03-28,92,4,85,177
"1522","1700-1759",2019-03-29,94,5,85,179
"1523","1700-1759",2019-03-30,86,6,64,150
"1524","1700-1759",2019-03-31,91,7,80,171
"1525","1800-1859",2019-03-01,74,5,84,158
"1526","1800-1859",2019-03-02,64,6,63,127
"1527","1800-1859",2019-03-03,80,7,85,165
"1528","1800-1859",2019-03-04,75,1,87,162
"1529","1800-1859",2019-03-05,70,2,87,157
"1530","1800-1859",2019-03-06,71,3,87,158
"1531","1800-1859",2019-03-07,77,4,87,164
"1532","1800-1859",2019-03-08,79,5,86,165
"1533","1800-1859",2019-03-09,60,6,72,132
"1534","1800-1859",2019-03-10,72,7,89,161
"1535","1800-1859",2019-03-11,74,1,87,161
"1536","1800-1859",2019-03-12,69,2,85,154
"1537","1800-1859",2019-03-13,70,3,86,156
"1538","1800-1859",2019-03-14,76,4,91,167
"1539","1800-1859",2019-03-15,76,5,90,166
"1540","1800-1859",2019-03-16,58,6,76,134
"1541","1800-1859",2019-03-17,72,7,89,161
"1542","1800-1859",2019-03-18,74,1,89,163
"1543","1800-1859",2019-03-19,70,2,86,156
"1544","1800-1859",2019-03-20,71,3,89,160
"1545","1800-1859",2019-03-21,75,4,90,165
"1546","1800-1859",2019-03-22,75,5,89,164
"1547","1800-1859",2019-03-23,59,6,75,134
"1548","1800-1859",2019-03-24,71,7,90,161
"1549","1800-1859",2019-03-25,73,1,88,161
"1550","1800-1859",2019-03-26,70,2,85,155
"1551","1800-1859",2019-03-27,71,3,88,159
"1552","1800-1859",2019-03-28,75,4,90,165
"1553","1800-1859",2019-03-29,75,5,89,164
"1554","1800-1859",2019-03-30,58,6,75,133
"1555","1800-1859",2019-03-31,70,7,83,153
"1556","1900-1959",2019-03-01,81,5,72,153
"1557","1900-1959",2019-03-02,57,6,71,128
"1558","1900-1959",2019-03-03,71,7,68,139
"1559","1900-1959",2019-03-04,76,1,70,146
"1560","1900-1959",2019-03-05,74,2,68,142
"1561","1900-1959",2019-03-06,76,3,71,147
"1562","1900-1959",2019-03-07,78,4,77,155
"1563","1900-1959",2019-03-08,80,5,83,163
"1564","1900-1959",2019-03-09,62,6,66,128
"1565","1900-1959",2019-03-10,75,7,80,155
"1566","1900-1959",2019-03-11,73,1,86,159
"1567","1900-1959",2019-03-12,71,2,84,155
"1568","1900-1959",2019-03-13,72,3,84,156
"1569","1900-1959",2019-03-14,74,4,85,159
"1570","1900-1959",2019-03-15,75,5,85,160
"1571","1900-1959",2019-03-16,58,6,71,129
"1572","1900-1959",2019-03-17,75,7,80,155
"1573","1900-1959",2019-03-18,74,1,87,161
"1574","1900-1959",2019-03-19,71,2,86,157
"1575","1900-1959",2019-03-20,72,3,84,156
"1576","1900-1959",2019-03-21,74,4,84,158
"1577","1900-1959",2019-03-22,75,5,84,159
"1578","1900-1959",2019-03-23,58,6,71,129
"1579","1900-1959",2019-03-24,75,7,79,154
"1580","1900-1959",2019-03-25,74,1,86,160
"1581","1900-1959",2019-03-26,71,2,86,157
"1582","1900-1959",2019-03-27,72,3,82,154
"1583","1900-1959",2019-03-28,74,4,84,158
"1584","1900-1959",2019-03-29,75,5,84,159
"1585","1900-1959",2019-03-30,59,6,72,131
"1586","1900-1959",2019-03-31,76,7,79,155
"1587","2000-2059",2019-03-01,52,5,88,140
"1588","2000-2059",2019-03-02,40,6,72,112
"1589","2000-2059",2019-03-03,54,7,88,142
"1590","2000-2059",2019-03-04,58,1,88,146
"1591","2000-2059",2019-03-05,49,2,81,130
"1592","2000-2059",2019-03-06,51,3,83,134
"1593","2000-2059",2019-03-07,58,4,88,146
"1594","2000-2059",2019-03-08,61,5,85,146
"1595","2000-2059",2019-03-09,60,6,76,136
"1596","2000-2059",2019-03-10,74,7,77,151
"1597","2000-2059",2019-03-11,72,1,80,152
"1598","2000-2059",2019-03-12,66,2,73,139
"1599","2000-2059",2019-03-13,69,3,74,143
"1600","2000-2059",2019-03-14,71,4,77,148
"1601","2000-2059",2019-03-15,71,5,81,152
"1602","2000-2059",2019-03-16,63,6,68,131
"1603","2000-2059",2019-03-17,75,7,76,151
"1604","2000-2059",2019-03-18,72,1,77,149
"1605","2000-2059",2019-03-19,66,2,71,137
"1606","2000-2059",2019-03-20,69,3,72,141
"1607","2000-2059",2019-03-21,70,4,77,147
"1608","2000-2059",2019-03-22,70,5,81,151
"1609","2000-2059",2019-03-23,62,6,68,130
"1610","2000-2059",2019-03-24,74,7,76,150
"1611","2000-2059",2019-03-25,72,1,77,149
"1612","2000-2059",2019-03-26,66,2,71,137
"1613","2000-2059",2019-03-27,68,3,72,140
"1614","2000-2059",2019-03-28,70,4,77,147
"1615","2000-2059",2019-03-29,70,5,81,151
"1616","2000-2059",2019-03-30,63,6,69,132
"1617","2000-2059",2019-03-31,72,7,78,150
"1618","2100-2159",2019-03-01,58,5,94,152
"1619","2100-2159",2019-03-02,37,6,79,116
"1620","2100-2159",2019-03-03,53,7,89,142
"1621","2100-2159",2019-03-04,57,1,94,151
"1622","2100-2159",2019-03-05,54,2,82,136
"1623","2100-2159",2019-03-06,54,3,83,137
"1624","2100-2159",2019-03-07,57,4,90,147
"1625","2100-2159",2019-03-08,60,5,92,152
"1626","2100-2159",2019-03-09,44,6,75,119
"1627","2100-2159",2019-03-10,59,7,95,154
"1628","2100-2159",2019-03-11,62,1,94,156
"1629","2100-2159",2019-03-12,58,2,89,147
"1630","2100-2159",2019-03-13,58,3,91,149
"1631","2100-2159",2019-03-14,62,4,96,158
"1632","2100-2159",2019-03-15,63,5,96,159
"1633","2100-2159",2019-03-16,46,6,81,127
"1634","2100-2159",2019-03-17,59,7,96,155
"1635","2100-2159",2019-03-18,62,1,95,157
"1636","2100-2159",2019-03-19,58,2,90,148
"1637","2100-2159",2019-03-20,58,3,93,151
"1638","2100-2159",2019-03-21,60,4,95,155
"1639","2100-2159",2019-03-22,61,5,95,156
"1640","2100-2159",2019-03-23,44,6,83,127
"1641","2100-2159",2019-03-24,57,7,95,152
"1642","2100-2159",2019-03-25,60,1,94,154
"1643","2100-2159",2019-03-26,57,2,90,147
"1644","2100-2159",2019-03-27,57,3,93,150
"1645","2100-2159",2019-03-28,60,4,95,155
"1646","2100-2159",2019-03-29,62,5,95,157
"1647","2100-2159",2019-03-30,45,6,83,128
"1648","2100-2159",2019-03-31,56,7,92,148
"1649","2200-2259",2019-03-01,38,5,79,117
"1650","2200-2259",2019-03-02,25,6,59,84
"1651","2200-2259",2019-03-03,38,7,74,112
"1652","2200-2259",2019-03-04,39,1,79,118
"1653","2200-2259",2019-03-05,35,2,77,112
"1654","2200-2259",2019-03-06,37,3,78,115
"1655","2200-2259",2019-03-07,46,4,82,128
"1656","2200-2259",2019-03-08,48,5,82,130
"1657","2200-2259",2019-03-09,32,6,66,98
"1658","2200-2259",2019-03-10,50,7,84,134
"1659","2200-2259",2019-03-11,43,1,86,129
"1660","2200-2259",2019-03-12,39,2,81,120
"1661","2200-2259",2019-03-13,42,3,83,125
"1662","2200-2259",2019-03-14,44,4,86,130
"1663","2200-2259",2019-03-15,45,5,85,130
"1664","2200-2259",2019-03-16,29,6,68,97
"1665","2200-2259",2019-03-17,50,7,85,135
"1666","2200-2259",2019-03-18,43,1,87,130
"1667","2200-2259",2019-03-19,39,2,82,121
"1668","2200-2259",2019-03-20,42,3,84,126
"1669","2200-2259",2019-03-21,44,4,84,128
"1670","2200-2259",2019-03-22,45,5,83,128
"1671","2200-2259",2019-03-23,28,6,66,94
"1672","2200-2259",2019-03-24,50,7,83,133
"1673","2200-2259",2019-03-25,43,1,86,129
"1674","2200-2259",2019-03-26,39,2,81,120
"1675","2200-2259",2019-03-27,42,3,82,124
"1676","2200-2259",2019-03-28,43,4,84,127
"1677","2200-2259",2019-03-29,44,5,83,127
"1678","2200-2259",2019-03-30,29,6,66,95
"1679","2200-2259",2019-03-31,50,7,88,138
"1680","2300-2359",2019-03-01,24,5,72,96
"1681","2300-2359",2019-03-02,22,6,50,72
"1682","2300-2359",2019-03-03,24,7,80,104
"1683","2300-2359",2019-03-04,24,1,82,106
"1684","2300-2359",2019-03-05,22,2,72,94
"1685","2300-2359",2019-03-06,24,3,78,102
"1686","2300-2359",2019-03-07,26,4,83,109
"1687","2300-2359",2019-03-08,30,5,86,116
"1688","2300-2359",2019-03-09,16,6,66,82
"1689","2300-2359",2019-03-10,23,7,76,99
"1690","2300-2359",2019-03-11,21,1,78,99
"1691","2300-2359",2019-03-12,20,2,69,89
"1692","2300-2359",2019-03-13,21,3,73,94
"1693","2300-2359",2019-03-14,24,4,78,102
"1694","2300-2359",2019-03-15,23,5,79,102
"1695","2300-2359",2019-03-16,20,6,59,79
"1696","2300-2359",2019-03-17,23,7,75,98
"1697","2300-2359",2019-03-18,21,1,78,99
"1698","2300-2359",2019-03-19,20,2,69,89
"1699","2300-2359",2019-03-20,21,3,73,94
"1700","2300-2359",2019-03-21,24,4,78,102
"1701","2300-2359",2019-03-22,23,5,79,102
"1702","2300-2359",2019-03-23,19,6,59,78
"1703","2300-2359",2019-03-24,23,7,75,98
"1704","2300-2359",2019-03-25,21,1,78,99
"1705","2300-2359",2019-03-26,20,2,69,89
"1706","2300-2359",2019-03-27,21,3,73,94
"1707","2300-2359",2019-03-28,23,4,78,101
"1708","2300-2359",2019-03-29,22,5,80,102
"1709","2300-2359",2019-03-30,18,6,59,77
"1710","2300-2359",2019-03-31,21,7,72,93
"1711","0001-0559",2019-04-01,38,1,76,114
"1712","0001-0559",2019-04-02,37,2,73,110
"1713","0001-0559",2019-04-03,35,3,74,109
"1714","0001-0559",2019-04-04,37,4,80,117
"1715","0001-0559",2019-04-05,37,5,80,117
"1716","0001-0559",2019-04-06,28,6,61,89
"1717","0001-0559",2019-04-07,26,7,85,111
"1718","0001-0559",2019-04-08,35,1,77,112
"1719","0001-0559",2019-04-09,34,2,73,107
"1720","0001-0559",2019-04-10,34,3,74,108
"1721","0001-0559",2019-04-11,34,4,77,111
"1722","0001-0559",2019-04-12,35,5,77,112
"1723","0001-0559",2019-04-13,21,6,55,76
"1724","0001-0559",2019-04-14,22,7,81,103
"1725","0001-0559",2019-04-15,35,1,76,111
"1726","0001-0559",2019-04-16,33,2,73,106
"1727","0001-0559",2019-04-17,33,3,73,106
"1728","0001-0559",2019-04-18,34,4,77,111
"1729","0001-0559",2019-04-19,35,5,77,112
"1730","0001-0559",2019-04-20,19,6,54,73
"1731","0001-0559",2019-04-21,21,7,82,103
"1732","0001-0559",2019-04-22,36,1,75,111
"1733","0001-0559",2019-04-23,33,2,73,106
"1734","0001-0559",2019-04-24,33,3,73,106
"1735","0001-0559",2019-04-25,34,4,78,112
"1736","0001-0559",2019-04-26,35,5,77,112
"1737","0001-0559",2019-04-27,21,6,55,76
"1738","0001-0559",2019-04-28,23,7,80,103
"1739","0001-0559",2019-04-29,37,1,74,111
"1740","0001-0559",2019-04-30,35,2,70,105
"1741","0600-0659",2019-04-01,107,1,29,136
"1742","0600-0659",2019-04-02,94,2,30,124
"1743","0600-0659",2019-04-03,93,3,31,124
"1744","0600-0659",2019-04-04,107,4,29,136
"1745","0600-0659",2019-04-05,107,5,30,137
"1746","0600-0659",2019-04-06,95,6,29,124
"1747","0600-0659",2019-04-07,98,7,24,122
"1748","0600-0659",2019-04-08,107,1,28,135
"1749","0600-0659",2019-04-09,94,2,29,123
"1750","0600-0659",2019-04-10,92,3,30,122
"1751","0600-0659",2019-04-11,106,4,29,135
"1752","0600-0659",2019-04-12,105,5,29,134
"1753","0600-0659",2019-04-13,93,6,26,119
"1754","0600-0659",2019-04-14,100,7,23,123
"1755","0600-0659",2019-04-15,107,1,28,135
"1756","0600-0659",2019-04-16,94,2,29,123
"1757","0600-0659",2019-04-17,91,3,31,122
"1758","0600-0659",2019-04-18,106,4,29,135
"1759","0600-0659",2019-04-19,105,5,29,134
"1760","0600-0659",2019-04-20,89,6,26,115
"1761","0600-0659",2019-04-21,89,7,23,112
"1762","0600-0659",2019-04-22,107,1,29,136
"1763","0600-0659",2019-04-23,93,2,29,122
"1764","0600-0659",2019-04-24,91,3,31,122
"1765","0600-0659",2019-04-25,105,4,29,134
"1766","0600-0659",2019-04-26,106,5,29,135
"1767","0600-0659",2019-04-27,93,6,26,119
"1768","0600-0659",2019-04-28,99,7,22,121
"1769","0600-0659",2019-04-29,106,1,28,134
"1770","0600-0659",2019-04-30,96,2,29,125
"1771","0700-0759",2019-04-01,102,1,62,164
"1772","0700-0759",2019-04-02,99,2,58,157
"1773","0700-0759",2019-04-03,97,3,58,155
"1774","0700-0759",2019-04-04,104,4,63,167
"1775","0700-0759",2019-04-05,105,5,64,169
"1776","0700-0759",2019-04-06,85,6,54,139
"1777","0700-0759",2019-04-07,91,7,58,149
"1778","0700-0759",2019-04-08,104,1,63,167
"1779","0700-0759",2019-04-09,99,2,58,157
"1780","0700-0759",2019-04-10,97,3,57,154
"1781","0700-0759",2019-04-11,103,4,61,164
"1782","0700-0759",2019-04-12,105,5,62,167
"1783","0700-0759",2019-04-13,87,6,52,139
"1784","0700-0759",2019-04-14,89,7,56,145
"1785","0700-0759",2019-04-15,103,1,64,167
"1786","0700-0759",2019-04-16,99,2,57,156
"1787","0700-0759",2019-04-17,97,3,56,153
"1788","0700-0759",2019-04-18,103,4,61,164
"1789","0700-0759",2019-04-19,105,5,62,167
"1790","0700-0759",2019-04-20,85,6,51,136
"1791","0700-0759",2019-04-21,83,7,48,131
"1792","0700-0759",2019-04-22,103,1,64,167
"1793","0700-0759",2019-04-23,100,2,57,157
"1794","0700-0759",2019-04-24,98,3,56,154
"1795","0700-0759",2019-04-25,103,4,61,164
"1796","0700-0759",2019-04-26,106,5,62,168
"1797","0700-0759",2019-04-27,88,6,52,140
"1798","0700-0759",2019-04-28,89,7,56,145
"1799","0700-0759",2019-04-29,107,1,62,169
"1800","0700-0759",2019-04-30,103,2,59,162
"1801","0800-0859",2019-04-01,103,1,74,177
"1802","0800-0859",2019-04-02,101,2,69,170
"1803","0800-0859",2019-04-03,97,3,69,166
"1804","0800-0859",2019-04-04,104,4,74,178
"1805","0800-0859",2019-04-05,102,5,74,176
"1806","0800-0859",2019-04-06,88,6,62,150
"1807","0800-0859",2019-04-07,108,7,65,173
"1808","0800-0859",2019-04-08,100,1,69,169
"1809","0800-0859",2019-04-09,99,2,69,168
"1810","0800-0859",2019-04-10,97,3,68,165
"1811","0800-0859",2019-04-11,104,4,74,178
"1812","0800-0859",2019-04-12,102,5,73,175
"1813","0800-0859",2019-04-13,91,6,67,158
"1814","0800-0859",2019-04-14,110,7,70,180
"1815","0800-0859",2019-04-15,101,1,71,172
"1816","0800-0859",2019-04-16,98,2,69,167
"1817","0800-0859",2019-04-17,97,3,68,165
"1818","0800-0859",2019-04-18,104,4,74,178
"1819","0800-0859",2019-04-19,102,5,73,175
"1820","0800-0859",2019-04-20,88,6,62,150
"1821","0800-0859",2019-04-21,107,7,65,172
"1822","0800-0859",2019-04-22,101,1,71,172
"1823","0800-0859",2019-04-23,98,2,68,166
"1824","0800-0859",2019-04-24,97,3,68,165
"1825","0800-0859",2019-04-25,104,4,73,177
"1826","0800-0859",2019-04-26,102,5,75,177
"1827","0800-0859",2019-04-27,91,6,67,158
"1828","0800-0859",2019-04-28,110,7,71,181
"1829","0800-0859",2019-04-29,100,1,77,177
"1830","0800-0859",2019-04-30,95,2,71,166
"1831","0900-0959",2019-04-01,85,1,66,151
"1832","0900-0959",2019-04-02,86,2,64,150
"1833","0900-0959",2019-04-03,86,3,60,146
"1834","0900-0959",2019-04-04,91,4,70,161
"1835","0900-0959",2019-04-05,89,5,68,157
"1836","0900-0959",2019-04-06,75,6,53,128
"1837","0900-0959",2019-04-07,84,7,65,149
"1838","0900-0959",2019-04-08,86,1,68,154
"1839","0900-0959",2019-04-09,84,2,64,148
"1840","0900-0959",2019-04-10,83,3,60,143
"1841","0900-0959",2019-04-11,88,4,68,156
"1842","0900-0959",2019-04-12,86,5,68,154
"1843","0900-0959",2019-04-13,77,6,54,131
"1844","0900-0959",2019-04-14,84,7,59,143
"1845","0900-0959",2019-04-15,87,1,67,154
"1846","0900-0959",2019-04-16,84,2,63,147
"1847","0900-0959",2019-04-17,83,3,60,143
"1848","0900-0959",2019-04-18,88,4,68,156
"1849","0900-0959",2019-04-19,86,5,68,154
"1850","0900-0959",2019-04-20,73,6,53,126
"1851","0900-0959",2019-04-21,79,7,57,136
"1852","0900-0959",2019-04-22,87,1,67,154
"1853","0900-0959",2019-04-23,84,2,63,147
"1854","0900-0959",2019-04-24,83,3,60,143
"1855","0900-0959",2019-04-25,88,4,68,156
"1856","0900-0959",2019-04-26,88,5,67,155
"1857","0900-0959",2019-04-27,78,6,54,132
"1858","0900-0959",2019-04-28,84,7,58,142
"1859","0900-0959",2019-04-29,89,1,64,153
"1860","0900-0959",2019-04-30,90,2,61,151
"1861","1000-1059",2019-04-01,78,1,64,142
"1862","1000-1059",2019-04-02,72,2,63,135
"1863","1000-1059",2019-04-03,71,3,59,130
"1864","1000-1059",2019-04-04,77,4,62,139
"1865","1000-1059",2019-04-05,77,5,63,140
"1866","1000-1059",2019-04-06,66,6,60,126
"1867","1000-1059",2019-04-07,74,7,65,139
"1868","1000-1059",2019-04-08,75,1,65,140
"1869","1000-1059",2019-04-09,72,2,63,135
"1870","1000-1059",2019-04-10,71,3,62,133
"1871","1000-1059",2019-04-11,75,4,65,140
"1872","1000-1059",2019-04-12,76,5,65,141
"1873","1000-1059",2019-04-13,67,6,59,126
"1874","1000-1059",2019-04-14,74,7,65,139
"1875","1000-1059",2019-04-15,75,1,66,141
"1876","1000-1059",2019-04-16,71,2,63,134
"1877","1000-1059",2019-04-17,71,3,62,133
"1878","1000-1059",2019-04-18,76,4,65,141
"1879","1000-1059",2019-04-19,76,5,65,141
"1880","1000-1059",2019-04-20,68,6,58,126
"1881","1000-1059",2019-04-21,71,7,61,132
"1882","1000-1059",2019-04-22,75,1,66,141
"1883","1000-1059",2019-04-23,71,2,63,134
"1884","1000-1059",2019-04-24,71,3,62,133
"1885","1000-1059",2019-04-25,76,4,65,141
"1886","1000-1059",2019-04-26,75,5,67,142
"1887","1000-1059",2019-04-27,67,6,60,127
"1888","1000-1059",2019-04-28,74,7,66,140
"1889","1000-1059",2019-04-29,74,1,69,143
"1890","1000-1059",2019-04-30,70,2,67,137
"1891","1100-1159",2019-04-01,81,1,76,157
"1892","1100-1159",2019-04-02,80,2,74,154
"1893","1100-1159",2019-04-03,79,3,73,152
"1894","1100-1159",2019-04-04,80,4,80,160
"1895","1100-1159",2019-04-05,79,5,78,157
"1896","1100-1159",2019-04-06,72,6,66,138
"1897","1100-1159",2019-04-07,79,7,72,151
"1898","1100-1159",2019-04-08,75,1,75,150
"1899","1100-1159",2019-04-09,76,2,70,146
"1900","1100-1159",2019-04-10,75,3,68,143
"1901","1100-1159",2019-04-11,76,4,75,151
"1902","1100-1159",2019-04-12,75,5,74,149
"1903","1100-1159",2019-04-13,67,6,67,134
"1904","1100-1159",2019-04-14,75,7,77,152
"1905","1100-1159",2019-04-15,75,1,73,148
"1906","1100-1159",2019-04-16,75,2,69,144
"1907","1100-1159",2019-04-17,75,3,67,142
"1908","1100-1159",2019-04-18,76,4,75,151
"1909","1100-1159",2019-04-19,75,5,74,149
"1910","1100-1159",2019-04-20,67,6,64,131
"1911","1100-1159",2019-04-21,75,7,75,150
"1912","1100-1159",2019-04-22,75,1,73,148
"1913","1100-1159",2019-04-23,75,2,69,144
"1914","1100-1159",2019-04-24,74,3,67,141
"1915","1100-1159",2019-04-25,77,4,76,153
"1916","1100-1159",2019-04-26,76,5,74,150
"1917","1100-1159",2019-04-27,68,6,68,136
"1918","1100-1159",2019-04-28,78,7,77,155
"1919","1100-1159",2019-04-29,74,1,72,146
"1920","1100-1159",2019-04-30,74,2,70,144
"1921","1200-1259",2019-04-01,70,1,70,140
"1922","1200-1259",2019-04-02,74,2,69,143
"1923","1200-1259",2019-04-03,73,3,68,141
"1924","1200-1259",2019-04-04,75,4,70,145
"1925","1200-1259",2019-04-05,75,5,71,146
"1926","1200-1259",2019-04-06,55,6,63,118
"1927","1200-1259",2019-04-07,65,7,69,134
"1928","1200-1259",2019-04-08,72,1,72,144
"1929","1200-1259",2019-04-09,71,2,72,143
"1930","1200-1259",2019-04-10,71,3,72,143
"1931","1200-1259",2019-04-11,73,4,73,146
"1932","1200-1259",2019-04-12,73,5,74,147
"1933","1200-1259",2019-04-13,59,6,58,117
"1934","1200-1259",2019-04-14,70,7,70,140
"1935","1200-1259",2019-04-15,73,1,73,146
"1936","1200-1259",2019-04-16,72,2,72,144
"1937","1200-1259",2019-04-17,71,3,72,143
"1938","1200-1259",2019-04-18,73,4,73,146
"1939","1200-1259",2019-04-19,73,5,74,147
"1940","1200-1259",2019-04-20,60,6,56,116
"1941","1200-1259",2019-04-21,68,7,68,136
"1942","1200-1259",2019-04-22,73,1,73,146
"1943","1200-1259",2019-04-23,72,2,72,144
"1944","1200-1259",2019-04-24,71,3,72,143
"1945","1200-1259",2019-04-25,74,4,73,147
"1946","1200-1259",2019-04-26,74,5,74,148
"1947","1200-1259",2019-04-27,60,6,58,118
"1948","1200-1259",2019-04-28,70,7,70,140
"1949","1200-1259",2019-04-29,74,1,72,146
"1950","1200-1259",2019-04-30,70,2,71,141
"1951","1300-1359",2019-04-01,73,1,68,141
"1952","1300-1359",2019-04-02,67,2,67,134
"1953","1300-1359",2019-04-03,68,3,68,136
"1954","1300-1359",2019-04-04,71,4,71,142
"1955","1300-1359",2019-04-05,70,5,70,140
"1956","1300-1359",2019-04-06,57,6,59,116
"1957","1300-1359",2019-04-07,75,7,64,139
"1958","1300-1359",2019-04-08,71,1,60,131
"1959","1300-1359",2019-04-09,68,2,59,127
"1960","1300-1359",2019-04-10,69,3,60,129
"1961","1300-1359",2019-04-11,71,4,63,134
"1962","1300-1359",2019-04-12,70,5,61,131
"1963","1300-1359",2019-04-13,56,6,61,117
"1964","1300-1359",2019-04-14,68,7,63,131
"1965","1300-1359",2019-04-15,70,1,61,131
"1966","1300-1359",2019-04-16,68,2,59,127
"1967","1300-1359",2019-04-17,70,3,60,130
"1968","1300-1359",2019-04-18,71,4,63,134
"1969","1300-1359",2019-04-19,70,5,61,131
"1970","1300-1359",2019-04-20,56,6,64,120
"1971","1300-1359",2019-04-21,70,7,61,131
"1972","1300-1359",2019-04-22,70,1,61,131
"1973","1300-1359",2019-04-23,68,2,59,127
"1974","1300-1359",2019-04-24,70,3,60,130
"1975","1300-1359",2019-04-25,71,4,64,135
"1976","1300-1359",2019-04-26,70,5,62,132
"1977","1300-1359",2019-04-27,56,6,63,119
"1978","1300-1359",2019-04-28,67,7,63,130
"1979","1300-1359",2019-04-29,72,1,62,134
"1980","1300-1359",2019-04-30,70,2,60,130
"1981","1400-1459",2019-04-01,85,1,82,167
"1982","1400-1459",2019-04-02,77,2,72,149
"1983","1400-1459",2019-04-03,79,3,72,151
"1984","1400-1459",2019-04-04,81,4,73,154
"1985","1400-1459",2019-04-05,81,5,74,155
"1986","1400-1459",2019-04-06,67,6,55,122
"1987","1400-1459",2019-04-07,75,7,69,144
"1988","1400-1459",2019-04-08,79,1,77,156
"1989","1400-1459",2019-04-09,75,2,73,148
"1990","1400-1459",2019-04-10,77,3,75,152
"1991","1400-1459",2019-04-11,79,4,76,155
"1992","1400-1459",2019-04-12,79,5,78,157
"1993","1400-1459",2019-04-13,66,6,59,125
"1994","1400-1459",2019-04-14,71,7,67,138
"1995","1400-1459",2019-04-15,79,1,78,157
"1996","1400-1459",2019-04-16,75,2,73,148
"1997","1400-1459",2019-04-17,77,3,75,152
"1998","1400-1459",2019-04-18,79,4,76,155
"1999","1400-1459",2019-04-19,79,5,78,157
"2000","1400-1459",2019-04-20,67,6,57,124
"2001","1400-1459",2019-04-21,70,7,65,135
"2002","1400-1459",2019-04-22,79,1,78,157
"2003","1400-1459",2019-04-23,75,2,74,149
"2004","1400-1459",2019-04-24,77,3,76,153
"2005","1400-1459",2019-04-25,80,4,76,156
"2006","1400-1459",2019-04-26,79,5,78,157
"2007","1400-1459",2019-04-27,66,6,58,124
"2008","1400-1459",2019-04-28,72,7,68,140
"2009","1400-1459",2019-04-29,77,1,77,154
"2010","1400-1459",2019-04-30,74,2,72,146
"2011","1500-1559",2019-04-01,87,1,80,167
"2012","1500-1559",2019-04-02,84,2,79,163
"2013","1500-1559",2019-04-03,84,3,79,163
"2014","1500-1559",2019-04-04,86,4,82,168
"2015","1500-1559",2019-04-05,87,5,79,166
"2016","1500-1559",2019-04-06,70,6,61,131
"2017","1500-1559",2019-04-07,86,7,79,165
"2018","1500-1559",2019-04-08,87,1,75,162
"2019","1500-1559",2019-04-09,84,2,73,157
"2020","1500-1559",2019-04-10,85,3,73,158
"2021","1500-1559",2019-04-11,87,4,76,163
"2022","1500-1559",2019-04-12,88,5,73,161
"2023","1500-1559",2019-04-13,72,6,60,132
"2024","1500-1559",2019-04-14,81,7,74,155
"2025","1500-1559",2019-04-15,88,1,73,161
"2026","1500-1559",2019-04-16,84,2,73,157
"2027","1500-1559",2019-04-17,85,3,73,158
"2028","1500-1559",2019-04-18,87,4,76,163
"2029","1500-1559",2019-04-19,88,5,73,161
"2030","1500-1559",2019-04-20,70,6,58,128
"2031","1500-1559",2019-04-21,78,7,71,149
"2032","1500-1559",2019-04-22,88,1,73,161
"2033","1500-1559",2019-04-23,85,2,73,158
"2034","1500-1559",2019-04-24,86,3,73,159
"2035","1500-1559",2019-04-25,88,4,76,164
"2036","1500-1559",2019-04-26,89,5,73,162
"2037","1500-1559",2019-04-27,73,6,60,133
"2038","1500-1559",2019-04-28,81,7,73,154
"2039","1500-1559",2019-04-29,87,1,77,164
"2040","1500-1559",2019-04-30,84,2,76,160
"2041","1600-1659",2019-04-01,79,1,84,163
"2042","1600-1659",2019-04-02,73,2,77,150
"2043","1600-1659",2019-04-03,76,3,81,157
"2044","1600-1659",2019-04-04,79,4,86,165
"2045","1600-1659",2019-04-05,77,5,86,163
"2046","1600-1659",2019-04-06,62,6,75,137
"2047","1600-1659",2019-04-07,73,7,86,159
"2048","1600-1659",2019-04-08,75,1,86,161
"2049","1600-1659",2019-04-09,70,2,79,149
"2050","1600-1659",2019-04-10,73,3,82,155
"2051","1600-1659",2019-04-11,76,4,87,163
"2052","1600-1659",2019-04-12,75,5,87,162
"2053","1600-1659",2019-04-13,64,6,74,138
"2054","1600-1659",2019-04-14,75,7,85,160
"2055","1600-1659",2019-04-15,75,1,87,162
"2056","1600-1659",2019-04-16,70,2,80,150
"2057","1600-1659",2019-04-17,74,3,83,157
"2058","1600-1659",2019-04-18,76,4,87,163
"2059","1600-1659",2019-04-19,75,5,87,162
"2060","1600-1659",2019-04-20,61,6,74,135
"2061","1600-1659",2019-04-21,75,7,84,159
"2062","1600-1659",2019-04-22,75,1,87,162
"2063","1600-1659",2019-04-23,70,2,80,150
"2064","1600-1659",2019-04-24,73,3,83,156
"2065","1600-1659",2019-04-25,76,4,87,163
"2066","1600-1659",2019-04-26,75,5,87,162
"2067","1600-1659",2019-04-27,64,6,74,138
"2068","1600-1659",2019-04-28,75,7,83,158
"2069","1600-1659",2019-04-29,76,1,86,162
"2070","1600-1659",2019-04-30,69,2,82,151
"2071","1700-1759",2019-04-01,90,1,82,172
"2072","1700-1759",2019-04-02,83,2,82,165
"2073","1700-1759",2019-04-03,82,3,80,162
"2074","1700-1759",2019-04-04,89,4,84,173
"2075","1700-1759",2019-04-05,92,5,81,173
"2076","1700-1759",2019-04-06,79,6,65,144
"2077","1700-1759",2019-04-07,90,7,79,169
"2078","1700-1759",2019-04-08,93,1,86,179
"2079","1700-1759",2019-04-09,87,2,84,171
"2080","1700-1759",2019-04-10,87,3,83,170
"2081","1700-1759",2019-04-11,94,4,87,181
"2082","1700-1759",2019-04-12,96,5,85,181
"2083","1700-1759",2019-04-13,74,6,67,141
"2084","1700-1759",2019-04-14,92,7,78,170
"2085","1700-1759",2019-04-15,93,1,86,179
"2086","1700-1759",2019-04-16,88,2,84,172
"2087","1700-1759",2019-04-17,88,3,84,172
"2088","1700-1759",2019-04-18,94,4,87,181
"2089","1700-1759",2019-04-19,96,5,85,181
"2090","1700-1759",2019-04-20,72,6,66,138
"2091","1700-1759",2019-04-21,90,7,75,165
"2092","1700-1759",2019-04-22,93,1,86,179
"2093","1700-1759",2019-04-23,88,2,84,172
"2094","1700-1759",2019-04-24,88,3,83,171
"2095","1700-1759",2019-04-25,94,4,87,181
"2096","1700-1759",2019-04-26,96,5,85,181
"2097","1700-1759",2019-04-27,74,6,67,141
"2098","1700-1759",2019-04-28,92,7,78,170
"2099","1700-1759",2019-04-29,93,1,85,178
"2100","1700-1759",2019-04-30,89,2,83,172
"2101","1800-1859",2019-04-01,74,1,85,159
"2102","1800-1859",2019-04-02,70,2,81,151
"2103","1800-1859",2019-04-03,72,3,81,153
"2104","1800-1859",2019-04-04,75,4,87,162
"2105","1800-1859",2019-04-05,76,5,87,163
"2106","1800-1859",2019-04-06,59,6,75,134
"2107","1800-1859",2019-04-07,69,7,85,154
"2108","1800-1859",2019-04-08,74,1,91,165
"2109","1800-1859",2019-04-09,70,2,87,157
"2110","1800-1859",2019-04-10,71,3,87,158
"2111","1800-1859",2019-04-11,74,4,91,165
"2112","1800-1859",2019-04-12,75,5,91,166
"2113","1800-1859",2019-04-13,62,6,72,134
"2114","1800-1859",2019-04-14,71,7,85,156
"2115","1800-1859",2019-04-15,74,1,91,165
"2116","1800-1859",2019-04-16,70,2,86,156
"2117","1800-1859",2019-04-17,71,3,87,158
"2118","1800-1859",2019-04-18,74,4,92,166
"2119","1800-1859",2019-04-19,74,5,91,165
"2120","1800-1859",2019-04-20,59,6,69,128
"2121","1800-1859",2019-04-21,71,7,85,156
"2122","1800-1859",2019-04-22,73,1,91,164
"2123","1800-1859",2019-04-23,70,2,87,157
"2124","1800-1859",2019-04-24,71,3,88,159
"2125","1800-1859",2019-04-25,73,4,92,165
"2126","1800-1859",2019-04-26,75,5,91,166
"2127","1800-1859",2019-04-27,62,6,71,133
"2128","1800-1859",2019-04-28,71,7,85,156
"2129","1800-1859",2019-04-29,75,1,91,166
"2130","1800-1859",2019-04-30,69,2,87,156
"2131","1900-1959",2019-04-01,75,1,84,159
"2132","1900-1959",2019-04-02,75,2,81,156
"2133","1900-1959",2019-04-03,76,3,78,154
"2134","1900-1959",2019-04-04,78,4,82,160
"2135","1900-1959",2019-04-05,77,5,83,160
"2136","1900-1959",2019-04-06,63,6,71,134
"2137","1900-1959",2019-04-07,78,7,79,157
"2138","1900-1959",2019-04-08,78,1,80,158
"2139","1900-1959",2019-04-09,74,2,77,151
"2140","1900-1959",2019-04-10,75,3,74,149
"2141","1900-1959",2019-04-11,77,4,78,155
"2142","1900-1959",2019-04-12,76,5,79,155
"2143","1900-1959",2019-04-13,69,6,70,139
"2144","1900-1959",2019-04-14,78,7,77,155
"2145","1900-1959",2019-04-15,77,1,78,155
"2146","1900-1959",2019-04-16,74,2,76,150
"2147","1900-1959",2019-04-17,75,3,74,149
"2148","1900-1959",2019-04-18,77,4,78,155
"2149","1900-1959",2019-04-19,76,5,79,155
"2150","1900-1959",2019-04-20,67,6,70,137
"2151","1900-1959",2019-04-21,77,7,75,152
"2152","1900-1959",2019-04-22,77,1,78,155
"2153","1900-1959",2019-04-23,74,2,76,150
"2154","1900-1959",2019-04-24,75,3,73,148
"2155","1900-1959",2019-04-25,77,4,79,156
"2156","1900-1959",2019-04-26,76,5,80,156
"2157","1900-1959",2019-04-27,68,6,72,140
"2158","1900-1959",2019-04-28,76,7,80,156
"2159","1900-1959",2019-04-29,72,1,77,149
"2160","1900-1959",2019-04-30,70,2,74,144
"2161","2000-2059",2019-04-01,69,1,79,148
"2162","2000-2059",2019-04-02,60,2,77,137
"2163","2000-2059",2019-04-03,60,3,78,138
"2164","2000-2059",2019-04-04,65,4,81,146
"2165","2000-2059",2019-04-05,66,5,82,148
"2166","2000-2059",2019-04-06,63,6,73,136
"2167","2000-2059",2019-04-07,69,7,79,148
"2168","2000-2059",2019-04-08,68,1,76,144
"2169","2000-2059",2019-04-09,64,2,74,138
"2170","2000-2059",2019-04-10,63,3,77,140
"2171","2000-2059",2019-04-11,68,4,80,148
"2172","2000-2059",2019-04-12,69,5,81,150
"2173","2000-2059",2019-04-13,54,6,76,130
"2174","2000-2059",2019-04-14,68,7,80,148
"2175","2000-2059",2019-04-15,69,1,80,149
"2176","2000-2059",2019-04-16,63,2,76,139
"2177","2000-2059",2019-04-17,62,3,77,139
"2178","2000-2059",2019-04-18,68,4,80,148
"2179","2000-2059",2019-04-19,69,5,81,150
"2180","2000-2059",2019-04-20,54,6,75,129
"2181","2000-2059",2019-04-21,67,7,79,146
"2182","2000-2059",2019-04-22,68,1,80,148
"2183","2000-2059",2019-04-23,63,2,76,139
"2184","2000-2059",2019-04-24,62,3,77,139
"2185","2000-2059",2019-04-25,69,4,79,148
"2186","2000-2059",2019-04-26,69,5,81,150
"2187","2000-2059",2019-04-27,55,6,76,131
"2188","2000-2059",2019-04-28,70,7,80,150
"2189","2000-2059",2019-04-29,70,1,75,145
"2190","2000-2059",2019-04-30,64,2,70,134
"2191","2100-2159",2019-04-01,56,1,91,147
"2192","2100-2159",2019-04-02,53,2,87,140
"2193","2100-2159",2019-04-03,54,3,87,141
"2194","2100-2159",2019-04-04,59,4,92,151
"2195","2100-2159",2019-04-05,59,5,95,154
"2196","2100-2159",2019-04-06,45,6,74,119
"2197","2100-2159",2019-04-07,59,7,95,154
"2198","2100-2159",2019-04-08,60,1,92,152
"2199","2100-2159",2019-04-09,55,2,86,141
"2200","2100-2159",2019-04-10,56,3,83,139
"2201","2100-2159",2019-04-11,60,4,88,148
"2202","2100-2159",2019-04-12,59,5,90,149
"2203","2100-2159",2019-04-13,38,6,77,115
"2204","2100-2159",2019-04-14,60,7,95,155
"2205","2100-2159",2019-04-15,59,1,88,147
"2206","2100-2159",2019-04-16,55,2,84,139
"2207","2100-2159",2019-04-17,56,3,83,139
"2208","2100-2159",2019-04-18,60,4,88,148
"2209","2100-2159",2019-04-19,60,5,90,150
"2210","2100-2159",2019-04-20,38,6,75,113
"2211","2100-2159",2019-04-21,62,7,95,157
"2212","2100-2159",2019-04-22,59,1,88,147
"2213","2100-2159",2019-04-23,55,2,84,139
"2214","2100-2159",2019-04-24,56,3,83,139
"2215","2100-2159",2019-04-25,61,4,88,149
"2216","2100-2159",2019-04-26,60,5,90,150
"2217","2100-2159",2019-04-27,39,6,77,116
"2218","2100-2159",2019-04-28,60,7,93,153
"2219","2100-2159",2019-04-29,63,1,93,156
"2220","2100-2159",2019-04-30,58,2,85,143
"2221","2200-2259",2019-04-01,44,1,89,133
"2222","2200-2259",2019-04-02,42,2,81,123
"2223","2200-2259",2019-04-03,46,3,85,131
"2224","2200-2259",2019-04-04,45,4,87,132
"2225","2200-2259",2019-04-05,44,5,85,129
"2226","2200-2259",2019-04-06,30,6,70,100
"2227","2200-2259",2019-04-07,49,7,82,131
"2228","2200-2259",2019-04-08,43,1,88,131
"2229","2200-2259",2019-04-09,41,2,82,123
"2230","2200-2259",2019-04-10,44,3,86,130
"2231","2200-2259",2019-04-11,43,4,88,131
"2232","2200-2259",2019-04-12,43,5,88,131
"2233","2200-2259",2019-04-13,30,6,69,99
"2234","2200-2259",2019-04-14,42,7,76,118
"2235","2200-2259",2019-04-15,42,1,89,131
"2236","2200-2259",2019-04-16,40,2,82,122
"2237","2200-2259",2019-04-17,44,3,87,131
"2238","2200-2259",2019-04-18,43,4,88,131
"2239","2200-2259",2019-04-19,42,5,88,130
"2240","2200-2259",2019-04-20,28,6,67,95
"2241","2200-2259",2019-04-21,43,7,77,120
"2242","2200-2259",2019-04-22,42,1,89,131
"2243","2200-2259",2019-04-23,40,2,82,122
"2244","2200-2259",2019-04-24,44,3,86,130
"2245","2200-2259",2019-04-25,43,4,90,133
"2246","2200-2259",2019-04-26,43,5,90,133
"2247","2200-2259",2019-04-27,30,6,70,100
"2248","2200-2259",2019-04-28,40,7,78,118
"2249","2200-2259",2019-04-29,41,1,89,130
"2250","2200-2259",2019-04-30,38,2,82,120
"2251","2300-2359",2019-04-01,21,1,76,97
"2252","2300-2359",2019-04-02,21,2,64,85
"2253","2300-2359",2019-04-03,22,3,69,91
"2254","2300-2359",2019-04-04,22,4,72,94
"2255","2300-2359",2019-04-05,23,5,73,96
"2256","2300-2359",2019-04-06,19,6,52,71
"2257","2300-2359",2019-04-07,24,7,72,96
"2258","2300-2359",2019-04-08,22,1,76,98
"2259","2300-2359",2019-04-09,21,2,66,87
"2260","2300-2359",2019-04-10,22,3,71,93
"2261","2300-2359",2019-04-11,23,4,75,98
"2262","2300-2359",2019-04-12,23,5,75,98
"2263","2300-2359",2019-04-13,19,6,43,62
"2264","2300-2359",2019-04-14,24,7,73,97
"2265","2300-2359",2019-04-15,22,1,75,97
"2266","2300-2359",2019-04-16,21,2,66,87
"2267","2300-2359",2019-04-17,22,3,70,92
"2268","2300-2359",2019-04-18,23,4,75,98
"2269","2300-2359",2019-04-19,23,5,74,97
"2270","2300-2359",2019-04-20,19,6,41,60
"2271","2300-2359",2019-04-21,24,7,74,98
"2272","2300-2359",2019-04-22,22,1,74,96
"2273","2300-2359",2019-04-23,21,2,66,87
"2274","2300-2359",2019-04-24,22,3,71,93
"2275","2300-2359",2019-04-25,23,4,75,98
"2276","2300-2359",2019-04-26,23,5,75,98
"2277","2300-2359",2019-04-27,19,6,44,63
"2278","2300-2359",2019-04-28,24,7,74,98
"2279","2300-2359",2019-04-29,22,1,79,101
"2280","2300-2359",2019-04-30,21,2,70,91
"2281","0001-0559",2019-05-01,35,3,65,100
"2282","0001-0559",2019-05-02,37,4,75,112
"2283","0001-0559",2019-05-03,37,5,72,109
"2284","0001-0559",2019-05-04,20,6,51,71
"2285","0001-0559",2019-05-05,21,7,79,100
"2286","0001-0559",2019-05-06,33,1,75,108
"2287","0001-0559",2019-05-07,33,2,69,102
"2288","0001-0559",2019-05-08,33,3,70,103
"2289","0001-0559",2019-05-09,33,4,77,110
"2290","0001-0559",2019-05-10,34,5,73,107
"2291","0001-0559",2019-05-11,20,6,50,70
"2292","0001-0559",2019-05-12,21,7,76,97
"2293","0001-0559",2019-05-13,33,1,76,109
"2294","0001-0559",2019-05-14,34,2,70,104
"2295","0001-0559",2019-05-15,33,3,70,103
"2296","0001-0559",2019-05-16,33,4,77,110
"2297","0001-0559",2019-05-17,34,5,73,107
"2298","0001-0559",2019-05-18,20,6,50,70
"2299","0001-0559",2019-05-19,21,7,80,101
"2300","0001-0559",2019-05-20,33,1,76,109
"2301","0001-0559",2019-05-21,33,2,72,105
"2302","0001-0559",2019-05-22,33,3,73,106
"2303","0001-0559",2019-05-23,33,4,76,109
"2304","0001-0559",2019-05-24,34,5,73,107
"2305","0001-0559",2019-05-25,21,6,48,69
"2306","0001-0559",2019-05-26,19,7,63,82
"2307","0001-0559",2019-05-27,21,1,74,95
"2308","0001-0559",2019-05-28,33,2,72,105
"2309","0001-0559",2019-05-29,33,3,71,104
"2310","0001-0559",2019-05-30,33,4,76,109
"2311","0001-0559",2019-05-31,34,5,73,107
"2312","0600-0659",2019-05-01,91,3,31,122
"2313","0600-0659",2019-05-02,103,4,32,135
"2314","0600-0659",2019-05-03,102,5,35,137
"2315","0600-0659",2019-05-04,92,6,26,118
"2316","0600-0659",2019-05-05,103,7,25,128
"2317","0600-0659",2019-05-06,107,1,32,139
"2318","0600-0659",2019-05-07,94,2,30,124
"2319","0600-0659",2019-05-08,94,3,31,125
"2320","0600-0659",2019-05-09,104,4,33,137
"2321","0600-0659",2019-05-10,102,5,33,135
"2322","0600-0659",2019-05-11,93,6,25,118
"2323","0600-0659",2019-05-12,99,7,25,124
"2324","0600-0659",2019-05-13,107,1,31,138
"2325","0600-0659",2019-05-14,93,2,30,123
"2326","0600-0659",2019-05-15,94,3,31,125
"2327","0600-0659",2019-05-16,103,4,33,136
"2328","0600-0659",2019-05-17,102,5,34,136
"2329","0600-0659",2019-05-18,92,6,26,118
"2330","0600-0659",2019-05-19,101,7,28,129
"2331","0600-0659",2019-05-20,107,1,34,141
"2332","0600-0659",2019-05-21,94,2,32,126
"2333","0600-0659",2019-05-22,94,3,34,128
"2334","0600-0659",2019-05-23,103,4,35,138
"2335","0600-0659",2019-05-24,101,5,36,137
"2336","0600-0659",2019-05-25,88,6,26,114
"2337","0600-0659",2019-05-26,82,7,27,109
"2338","0600-0659",2019-05-27,95,1,29,124
"2339","0600-0659",2019-05-28,93,2,32,125
"2340","0600-0659",2019-05-29,95,3,33,128
"2341","0600-0659",2019-05-30,103,4,34,137
"2342","0600-0659",2019-05-31,101,5,35,136
"2343","0700-0759",2019-05-01,106,3,59,165
"2344","0700-0759",2019-05-02,110,4,63,173
"2345","0700-0759",2019-05-03,111,5,63,174
"2346","0700-0759",2019-05-04,92,6,52,144
"2347","0700-0759",2019-05-05,91,7,59,150
"2348","0700-0759",2019-05-06,110,1,64,174
"2349","0700-0759",2019-05-07,103,2,62,165
"2350","0700-0759",2019-05-08,105,3,62,167
"2351","0700-0759",2019-05-09,110,4,64,174
"2352","0700-0759",2019-05-10,112,5,63,175
"2353","0700-0759",2019-05-11,92,6,53,145
"2354","0700-0759",2019-05-12,92,7,57,149
"2355","0700-0759",2019-05-13,110,1,65,175
"2356","0700-0759",2019-05-14,103,2,62,165
"2357","0700-0759",2019-05-15,105,3,62,167
"2358","0700-0759",2019-05-16,111,4,66,177
"2359","0700-0759",2019-05-17,110,5,63,173
"2360","0700-0759",2019-05-18,93,6,53,146
"2361","0700-0759",2019-05-19,93,7,59,152
"2362","0700-0759",2019-05-20,109,1,65,174
"2363","0700-0759",2019-05-21,103,2,62,165
"2364","0700-0759",2019-05-22,106,3,62,168
"2365","0700-0759",2019-05-23,112,4,65,177
"2366","0700-0759",2019-05-24,112,5,63,175
"2367","0700-0759",2019-05-25,94,6,53,147
"2368","0700-0759",2019-05-26,91,7,50,141
"2369","0700-0759",2019-05-27,102,1,54,156
"2370","0700-0759",2019-05-28,104,2,62,166
"2371","0700-0759",2019-05-29,105,3,62,167
"2372","0700-0759",2019-05-30,112,4,66,178
"2373","0700-0759",2019-05-31,112,5,64,176
"2374","0800-0859",2019-05-01,99,3,73,172
"2375","0800-0859",2019-05-02,105,4,78,183
"2376","0800-0859",2019-05-03,100,5,76,176
"2377","0800-0859",2019-05-04,86,6,64,150
"2378","0800-0859",2019-05-05,106,7,74,180
"2379","0800-0859",2019-05-06,97,1,76,173
"2380","0800-0859",2019-05-07,95,2,66,161
"2381","0800-0859",2019-05-08,95,3,71,166
"2382","0800-0859",2019-05-09,100,4,77,177
"2383","0800-0859",2019-05-10,98,5,78,176
"2384","0800-0859",2019-05-11,86,6,63,149
"2385","0800-0859",2019-05-12,104,7,70,174
"2386","0800-0859",2019-05-13,98,1,76,174
"2387","0800-0859",2019-05-14,95,2,66,161
"2388","0800-0859",2019-05-15,95,3,71,166
"2389","0800-0859",2019-05-16,98,4,76,174
"2390","0800-0859",2019-05-17,99,5,78,177
"2391","0800-0859",2019-05-18,87,6,63,150
"2392","0800-0859",2019-05-19,103,7,73,176
"2393","0800-0859",2019-05-20,98,1,76,174
"2394","0800-0859",2019-05-21,95,2,66,161
"2395","0800-0859",2019-05-22,95,3,72,167
"2396","0800-0859",2019-05-23,98,4,77,175
"2397","0800-0859",2019-05-24,98,5,77,175
"2398","0800-0859",2019-05-25,85,6,63,148
"2399","0800-0859",2019-05-26,85,7,62,147
"2400","0800-0859",2019-05-27,98,1,67,165
"2401","0800-0859",2019-05-28,95,2,66,161
"2402","0800-0859",2019-05-29,96,3,71,167
"2403","0800-0859",2019-05-30,98,4,77,175
"2404","0800-0859",2019-05-31,98,5,77,175
"2405","0900-0959",2019-05-01,87,3,59,146
"2406","0900-0959",2019-05-02,90,4,66,156
"2407","0900-0959",2019-05-03,85,5,68,153
"2408","0900-0959",2019-05-04,77,6,59,136
"2409","0900-0959",2019-05-05,84,7,57,141
"2410","0900-0959",2019-05-06,88,1,67,155
"2411","0900-0959",2019-05-07,83,2,63,146
"2412","0900-0959",2019-05-08,84,3,62,146
"2413","0900-0959",2019-05-09,88,4,67,155
"2414","0900-0959",2019-05-10,88,5,67,155
"2415","0900-0959",2019-05-11,75,6,60,135
"2416","0900-0959",2019-05-12,83,7,59,142
"2417","0900-0959",2019-05-13,88,1,67,155
"2418","0900-0959",2019-05-14,83,2,63,146
"2419","0900-0959",2019-05-15,84,3,62,146
"2420","0900-0959",2019-05-16,87,4,67,154
"2421","0900-0959",2019-05-17,88,5,66,154
"2422","0900-0959",2019-05-18,78,6,60,138
"2423","0900-0959",2019-05-19,86,7,57,143
"2424","0900-0959",2019-05-20,88,1,66,154
"2425","0900-0959",2019-05-21,83,2,63,146
"2426","0900-0959",2019-05-22,85,3,62,147
"2427","0900-0959",2019-05-23,88,4,67,155
"2428","0900-0959",2019-05-24,88,5,66,154
"2429","0900-0959",2019-05-25,77,6,57,134
"2430","0900-0959",2019-05-26,84,7,50,134
"2431","0900-0959",2019-05-27,86,1,64,150
"2432","0900-0959",2019-05-28,82,2,62,144
"2433","0900-0959",2019-05-29,84,3,63,147
"2434","0900-0959",2019-05-30,88,4,67,155
"2435","0900-0959",2019-05-31,88,5,67,155
"2436","1000-1059",2019-05-01,68,3,65,133
"2437","1000-1059",2019-05-02,73,4,69,142
"2438","1000-1059",2019-05-03,70,5,70,140
"2439","1000-1059",2019-05-04,60,6,50,110
"2440","1000-1059",2019-05-05,71,7,65,136
"2441","1000-1059",2019-05-06,71,1,65,136
"2442","1000-1059",2019-05-07,67,2,60,127
"2443","1000-1059",2019-05-08,68,3,60,128
"2444","1000-1059",2019-05-09,73,4,65,138
"2445","1000-1059",2019-05-10,71,5,65,136
"2446","1000-1059",2019-05-11,62,6,51,113
"2447","1000-1059",2019-05-12,70,7,65,135
"2448","1000-1059",2019-05-13,71,1,65,136
"2449","1000-1059",2019-05-14,68,2,61,129
"2450","1000-1059",2019-05-15,69,3,60,129
"2451","1000-1059",2019-05-16,74,4,66,140
"2452","1000-1059",2019-05-17,71,5,64,135
"2453","1000-1059",2019-05-18,63,6,52,115
"2454","1000-1059",2019-05-19,72,7,67,139
"2455","1000-1059",2019-05-20,71,1,65,136
"2456","1000-1059",2019-05-21,68,2,60,128
"2457","1000-1059",2019-05-22,69,3,60,129
"2458","1000-1059",2019-05-23,74,4,65,139
"2459","1000-1059",2019-05-24,71,5,65,136
"2460","1000-1059",2019-05-25,61,6,52,113
"2461","1000-1059",2019-05-26,60,7,64,124
"2462","1000-1059",2019-05-27,72,1,64,136
"2463","1000-1059",2019-05-28,68,2,60,128
"2464","1000-1059",2019-05-29,69,3,60,129
"2465","1000-1059",2019-05-30,74,4,66,140
"2466","1000-1059",2019-05-31,72,5,64,136
"2467","1100-1159",2019-05-01,75,3,68,143
"2468","1100-1159",2019-05-02,76,4,72,148
"2469","1100-1159",2019-05-03,81,5,64,145
"2470","1100-1159",2019-05-04,73,6,70,143
"2471","1100-1159",2019-05-05,84,7,75,159
"2472","1100-1159",2019-05-06,81,1,70,151
"2473","1100-1159",2019-05-07,80,2,71,151
"2474","1100-1159",2019-05-08,80,3,70,150
"2475","1100-1159",2019-05-09,83,4,74,157
"2476","1100-1159",2019-05-10,82,5,71,153
"2477","1100-1159",2019-05-11,71,6,68,139
"2478","1100-1159",2019-05-12,80,7,75,155
"2479","1100-1159",2019-05-13,82,1,72,154
"2480","1100-1159",2019-05-14,81,2,70,151
"2481","1100-1159",2019-05-15,80,3,71,151
"2482","1100-1159",2019-05-16,82,4,73,155
"2483","1100-1159",2019-05-17,84,5,74,158
"2484","1100-1159",2019-05-18,73,6,71,144
"2485","1100-1159",2019-05-19,84,7,75,159
"2486","1100-1159",2019-05-20,83,1,74,157
"2487","1100-1159",2019-05-21,82,2,72,154
"2488","1100-1159",2019-05-22,81,3,72,153
"2489","1100-1159",2019-05-23,81,4,74,155
"2490","1100-1159",2019-05-24,82,5,73,155
"2491","1100-1159",2019-05-25,69,6,69,138
"2492","1100-1159",2019-05-26,69,7,61,130
"2493","1100-1159",2019-05-27,83,1,73,156
"2494","1100-1159",2019-05-28,80,2,71,151
"2495","1100-1159",2019-05-29,80,3,72,152
"2496","1100-1159",2019-05-30,81,4,73,154
"2497","1100-1159",2019-05-31,81,5,73,154
"2498","1200-1259",2019-05-01,66,3,71,137
"2499","1200-1259",2019-05-02,69,4,73,142
"2500","1200-1259",2019-05-03,71,5,72,143
"2501","1200-1259",2019-05-04,60,6,56,116
"2502","1200-1259",2019-05-05,67,7,66,133
"2503","1200-1259",2019-05-06,71,1,71,142
"2504","1200-1259",2019-05-07,68,2,66,134
"2505","1200-1259",2019-05-08,69,3,66,135
"2506","1200-1259",2019-05-09,69,4,69,138
"2507","1200-1259",2019-05-10,71,5,70,141
"2508","1200-1259",2019-05-11,61,6,55,116
"2509","1200-1259",2019-05-12,65,7,64,129
"2510","1200-1259",2019-05-13,71,1,70,141
"2511","1200-1259",2019-05-14,68,2,66,134
"2512","1200-1259",2019-05-15,69,3,67,136
"2513","1200-1259",2019-05-16,70,4,70,140
"2514","1200-1259",2019-05-17,70,5,70,140
"2515","1200-1259",2019-05-18,60,6,55,115
"2516","1200-1259",2019-05-19,69,7,67,136
"2517","1200-1259",2019-05-20,70,1,70,140
"2518","1200-1259",2019-05-21,68,2,66,134
"2519","1200-1259",2019-05-22,69,3,68,137
"2520","1200-1259",2019-05-23,71,4,72,143
"2521","1200-1259",2019-05-24,71,5,72,143
"2522","1200-1259",2019-05-25,62,6,56,118
"2523","1200-1259",2019-05-26,64,7,59,123
"2524","1200-1259",2019-05-27,68,1,73,141
"2525","1200-1259",2019-05-28,69,2,68,137
"2526","1200-1259",2019-05-29,71,3,69,140
"2527","1200-1259",2019-05-30,71,4,72,143
"2528","1200-1259",2019-05-31,71,5,71,142
"2529","1300-1359",2019-05-01,69,3,62,131
"2530","1300-1359",2019-05-02,74,4,63,137
"2531","1300-1359",2019-05-03,72,5,60,132
"2532","1300-1359",2019-05-04,62,6,59,121
"2533","1300-1359",2019-05-05,70,7,63,133
"2534","1300-1359",2019-05-06,72,1,61,133
"2535","1300-1359",2019-05-07,69,2,59,128
"2536","1300-1359",2019-05-08,69,3,62,131
"2537","1300-1359",2019-05-09,74,4,62,136
"2538","1300-1359",2019-05-10,72,5,61,133
"2539","1300-1359",2019-05-11,62,6,59,121
"2540","1300-1359",2019-05-12,70,7,62,132
"2541","1300-1359",2019-05-13,72,1,61,133
"2542","1300-1359",2019-05-14,69,2,59,128
"2543","1300-1359",2019-05-15,70,3,61,131
"2544","1300-1359",2019-05-16,73,4,60,133
"2545","1300-1359",2019-05-17,73,5,61,134
"2546","1300-1359",2019-05-18,63,6,60,123
"2547","1300-1359",2019-05-19,69,7,62,131
"2548","1300-1359",2019-05-20,73,1,61,134
"2549","1300-1359",2019-05-21,70,2,59,129
"2550","1300-1359",2019-05-22,71,3,61,132
"2551","1300-1359",2019-05-23,74,4,60,134
"2552","1300-1359",2019-05-24,73,5,60,133
"2553","1300-1359",2019-05-25,64,6,58,122
"2554","1300-1359",2019-05-26,67,7,56,123
"2555","1300-1359",2019-05-27,75,1,60,135
"2556","1300-1359",2019-05-28,70,2,58,128
"2557","1300-1359",2019-05-29,69,3,62,131
"2558","1300-1359",2019-05-30,73,4,60,133
"2559","1300-1359",2019-05-31,72,5,62,134
"2560","1400-1459",2019-05-01,78,3,72,150
"2561","1400-1459",2019-05-02,78,4,74,152
"2562","1400-1459",2019-05-03,76,5,82,158
"2563","1400-1459",2019-05-04,65,6,66,131
"2564","1400-1459",2019-05-05,68,7,71,139
"2565","1400-1459",2019-05-06,75,1,80,155
"2566","1400-1459",2019-05-07,70,2,77,147
"2567","1400-1459",2019-05-08,73,3,79,152
"2568","1400-1459",2019-05-09,72,4,81,153
"2569","1400-1459",2019-05-10,75,5,81,156
"2570","1400-1459",2019-05-11,65,6,66,131
"2571","1400-1459",2019-05-12,64,7,68,132
"2572","1400-1459",2019-05-13,75,1,81,156
"2573","1400-1459",2019-05-14,70,2,78,148
"2574","1400-1459",2019-05-15,72,3,80,152
"2575","1400-1459",2019-05-16,73,4,79,152
"2576","1400-1459",2019-05-17,74,5,81,155
"2577","1400-1459",2019-05-18,66,6,66,132
"2578","1400-1459",2019-05-19,69,7,72,141
"2579","1400-1459",2019-05-20,76,1,80,156
"2580","1400-1459",2019-05-21,71,2,78,149
"2581","1400-1459",2019-05-22,74,3,79,153
"2582","1400-1459",2019-05-23,74,4,80,154
"2583","1400-1459",2019-05-24,75,5,81,156
"2584","1400-1459",2019-05-25,62,6,65,127
"2585","1400-1459",2019-05-26,66,7,63,129
"2586","1400-1459",2019-05-27,76,1,78,154
"2587","1400-1459",2019-05-28,71,2,78,149
"2588","1400-1459",2019-05-29,74,3,78,152
"2589","1400-1459",2019-05-30,74,4,80,154
"2590","1400-1459",2019-05-31,76,5,80,156
"2591","1500-1559",2019-05-01,82,3,77,159
"2592","1500-1559",2019-05-02,84,4,76,160
"2593","1500-1559",2019-05-03,89,5,72,161
"2594","1500-1559",2019-05-04,76,6,70,146
"2595","1500-1559",2019-05-05,80,7,75,155
"2596","1500-1559",2019-05-06,89,1,75,164
"2597","1500-1559",2019-05-07,86,2,75,161
"2598","1500-1559",2019-05-08,86,3,76,162
"2599","1500-1559",2019-05-09,87,4,76,163
"2600","1500-1559",2019-05-10,89,5,75,164
"2601","1500-1559",2019-05-11,73,6,70,143
"2602","1500-1559",2019-05-12,78,7,75,153
"2603","1500-1559",2019-05-13,89,1,75,164
"2604","1500-1559",2019-05-14,86,2,75,161
"2605","1500-1559",2019-05-15,86,3,74,160
"2606","1500-1559",2019-05-16,86,4,77,163
"2607","1500-1559",2019-05-17,88,5,76,164
"2608","1500-1559",2019-05-18,74,6,69,143
"2609","1500-1559",2019-05-19,79,7,74,153
"2610","1500-1559",2019-05-20,88,1,76,164
"2611","1500-1559",2019-05-21,86,2,74,160
"2612","1500-1559",2019-05-22,86,3,75,161
"2613","1500-1559",2019-05-23,87,4,75,162
"2614","1500-1559",2019-05-24,88,5,76,164
"2615","1500-1559",2019-05-25,67,6,69,136
"2616","1500-1559",2019-05-26,67,7,70,137
"2617","1500-1559",2019-05-27,86,1,73,159
"2618","1500-1559",2019-05-28,86,2,74,160
"2619","1500-1559",2019-05-29,86,3,75,161
"2620","1500-1559",2019-05-30,87,4,75,162
"2621","1500-1559",2019-05-31,89,5,76,165
"2622","1600-1659",2019-05-01,74,3,86,160
"2623","1600-1659",2019-05-02,75,4,93,168
"2624","1600-1659",2019-05-03,72,5,94,166
"2625","1600-1659",2019-05-04,64,6,78,142
"2626","1600-1659",2019-05-05,74,7,91,165
"2627","1600-1659",2019-05-06,74,1,91,165
"2628","1600-1659",2019-05-07,71,2,87,158
"2629","1600-1659",2019-05-08,74,3,87,161
"2630","1600-1659",2019-05-09,77,4,92,169
"2631","1600-1659",2019-05-10,74,5,91,165
"2632","1600-1659",2019-05-11,64,6,74,138
"2633","1600-1659",2019-05-12,74,7,85,159
"2634","1600-1659",2019-05-13,75,1,91,166
"2635","1600-1659",2019-05-14,73,2,87,160
"2636","1600-1659",2019-05-15,74,3,87,161
"2637","1600-1659",2019-05-16,77,4,91,168
"2638","1600-1659",2019-05-17,75,5,90,165
"2639","1600-1659",2019-05-18,66,6,76,142
"2640","1600-1659",2019-05-19,75,7,89,164
"2641","1600-1659",2019-05-20,76,1,91,167
"2642","1600-1659",2019-05-21,73,2,88,161
"2643","1600-1659",2019-05-22,75,3,88,163
"2644","1600-1659",2019-05-23,78,4,91,169
"2645","1600-1659",2019-05-24,76,5,89,165
"2646","1600-1659",2019-05-25,63,6,70,133
"2647","1600-1659",2019-05-26,71,7,81,152
"2648","1600-1659",2019-05-27,78,1,91,169
"2649","1600-1659",2019-05-28,73,2,87,160
"2650","1600-1659",2019-05-29,75,3,86,161
"2651","1600-1659",2019-05-30,78,4,90,168
"2652","1600-1659",2019-05-31,75,5,89,164
"2653","1700-1759",2019-05-01,89,3,79,168
"2654","1700-1759",2019-05-02,95,4,81,176
"2655","1700-1759",2019-05-03,92,5,73,165
"2656","1700-1759",2019-05-04,69,6,54,123
"2657","1700-1759",2019-05-05,84,7,68,152
"2658","1700-1759",2019-05-06,88,1,74,162
"2659","1700-1759",2019-05-07,84,2,71,155
"2660","1700-1759",2019-05-08,85,3,72,157
"2661","1700-1759",2019-05-09,88,4,74,162
"2662","1700-1759",2019-05-10,90,5,73,163
"2663","1700-1759",2019-05-11,66,6,57,123
"2664","1700-1759",2019-05-12,78,7,64,142
"2665","1700-1759",2019-05-13,88,1,74,162
"2666","1700-1759",2019-05-14,84,2,71,155
"2667","1700-1759",2019-05-15,84,3,72,156
"2668","1700-1759",2019-05-16,88,4,74,162
"2669","1700-1759",2019-05-17,89,5,72,161
"2670","1700-1759",2019-05-18,68,6,57,125
"2671","1700-1759",2019-05-19,85,7,68,153
"2672","1700-1759",2019-05-20,90,1,73,163
"2673","1700-1759",2019-05-21,87,2,72,159
"2674","1700-1759",2019-05-22,88,3,72,160
"2675","1700-1759",2019-05-23,89,4,74,163
"2676","1700-1759",2019-05-24,90,5,71,161
"2677","1700-1759",2019-05-25,61,6,55,116
"2678","1700-1759",2019-05-26,67,7,57,124
"2679","1700-1759",2019-05-27,87,1,72,159
"2680","1700-1759",2019-05-28,86,2,71,157
"2681","1700-1759",2019-05-29,87,3,72,159
"2682","1700-1759",2019-05-30,89,4,73,162
"2683","1700-1759",2019-05-31,90,5,72,162
"2684","1800-1859",2019-05-01,73,3,89,162
"2685","1800-1859",2019-05-02,79,4,96,175
"2686","1800-1859",2019-05-03,77,5,96,173
"2687","1800-1859",2019-05-04,66,6,75,141
"2688","1800-1859",2019-05-05,74,7,89,163
"2689","1800-1859",2019-05-06,78,1,97,175
"2690","1800-1859",2019-05-07,71,2,94,165
"2691","1800-1859",2019-05-08,75,3,93,168
"2692","1800-1859",2019-05-09,79,4,97,176
"2693","1800-1859",2019-05-10,79,5,98,177
"2694","1800-1859",2019-05-11,67,6,71,138
"2695","1800-1859",2019-05-12,73,7,88,161
"2696","1800-1859",2019-05-13,78,1,97,175
"2697","1800-1859",2019-05-14,71,2,95,166
"2698","1800-1859",2019-05-15,75,3,94,169
"2699","1800-1859",2019-05-16,80,4,96,176
"2700","1800-1859",2019-05-17,79,5,98,177
"2701","1800-1859",2019-05-18,66,6,76,142
"2702","1800-1859",2019-05-19,76,7,89,165
"2703","1800-1859",2019-05-20,78,1,96,174
"2704","1800-1859",2019-05-21,72,2,93,165
"2705","1800-1859",2019-05-22,76,3,93,169
"2706","1800-1859",2019-05-23,80,4,96,176
"2707","1800-1859",2019-05-24,80,5,98,178
"2708","1800-1859",2019-05-25,64,6,71,135
"2709","1800-1859",2019-05-26,70,7,76,146
"2710","1800-1859",2019-05-27,79,1,93,172
"2711","1800-1859",2019-05-28,72,2,93,165
"2712","1800-1859",2019-05-29,75,3,93,168
"2713","1800-1859",2019-05-30,80,4,98,178
"2714","1800-1859",2019-05-31,80,5,97,177
"2715","1900-1959",2019-05-01,72,3,73,145
"2716","1900-1959",2019-05-02,73,4,72,145
"2717","1900-1959",2019-05-03,74,5,78,152
"2718","1900-1959",2019-05-04,67,6,66,133
"2719","1900-1959",2019-05-05,77,7,73,150
"2720","1900-1959",2019-05-06,74,1,76,150
"2721","1900-1959",2019-05-07,70,2,71,141
"2722","1900-1959",2019-05-08,72,3,74,146
"2723","1900-1959",2019-05-09,74,4,75,149
"2724","1900-1959",2019-05-10,75,5,77,152
"2725","1900-1959",2019-05-11,67,6,67,134
"2726","1900-1959",2019-05-12,73,7,73,146
"2727","1900-1959",2019-05-13,74,1,76,150
"2728","1900-1959",2019-05-14,71,2,72,143
"2729","1900-1959",2019-05-15,73,3,74,147
"2730","1900-1959",2019-05-16,74,4,77,151
"2731","1900-1959",2019-05-17,75,5,76,151
"2732","1900-1959",2019-05-18,69,6,67,136
"2733","1900-1959",2019-05-19,76,7,76,152
"2734","1900-1959",2019-05-20,74,1,77,151
"2735","1900-1959",2019-05-21,71,2,74,145
"2736","1900-1959",2019-05-22,73,3,75,148
"2737","1900-1959",2019-05-23,74,4,79,153
"2738","1900-1959",2019-05-24,74,5,77,151
"2739","1900-1959",2019-05-25,67,6,65,132
"2740","1900-1959",2019-05-26,71,7,72,143
"2741","1900-1959",2019-05-27,74,1,79,153
"2742","1900-1959",2019-05-28,71,2,74,145
"2743","1900-1959",2019-05-29,74,3,75,149
"2744","1900-1959",2019-05-30,76,4,78,154
"2745","1900-1959",2019-05-31,75,5,77,152
"2746","2000-2059",2019-05-01,64,3,71,135
"2747","2000-2059",2019-05-02,68,4,79,147
"2748","2000-2059",2019-05-03,72,5,76,148
"2749","2000-2059",2019-05-04,51,6,71,122
"2750","2000-2059",2019-05-05,74,7,73,147
"2751","2000-2059",2019-05-06,71,1,74,145
"2752","2000-2059",2019-05-07,67,2,69,136
"2753","2000-2059",2019-05-08,68,3,69,137
"2754","2000-2059",2019-05-09,71,4,74,145
"2755","2000-2059",2019-05-10,72,5,76,148
"2756","2000-2059",2019-05-11,50,6,71,121
"2757","2000-2059",2019-05-12,74,7,68,142
"2758","2000-2059",2019-05-13,71,1,74,145
"2759","2000-2059",2019-05-14,67,2,69,136
"2760","2000-2059",2019-05-15,68,3,68,136
"2761","2000-2059",2019-05-16,72,4,74,146
"2762","2000-2059",2019-05-17,72,5,74,146
"2763","2000-2059",2019-05-18,50,6,72,122
"2764","2000-2059",2019-05-19,76,7,73,149
"2765","2000-2059",2019-05-20,71,1,75,146
"2766","2000-2059",2019-05-21,67,2,71,138
"2767","2000-2059",2019-05-22,69,3,72,141
"2768","2000-2059",2019-05-23,73,4,76,149
"2769","2000-2059",2019-05-24,73,5,77,150
"2770","2000-2059",2019-05-25,47,6,69,116
"2771","2000-2059",2019-05-26,60,7,68,128
"2772","2000-2059",2019-05-27,75,1,75,150
"2773","2000-2059",2019-05-28,69,2,72,141
"2774","2000-2059",2019-05-29,70,3,72,142
"2775","2000-2059",2019-05-30,72,4,77,149
"2776","2000-2059",2019-05-31,74,5,78,152
"2777","2100-2159",2019-05-01,57,3,87,144
"2778","2100-2159",2019-05-02,66,4,91,157
"2779","2100-2159",2019-05-03,58,5,90,148
"2780","2100-2159",2019-05-04,38,6,85,123
"2781","2100-2159",2019-05-05,61,7,99,160
"2782","2100-2159",2019-05-06,61,1,91,152
"2783","2100-2159",2019-05-07,59,2,85,144
"2784","2100-2159",2019-05-08,58,3,88,146
"2785","2100-2159",2019-05-09,60,4,91,151
"2786","2100-2159",2019-05-10,58,5,91,149
"2787","2100-2159",2019-05-11,38,6,84,122
"2788","2100-2159",2019-05-12,59,7,99,158
"2789","2100-2159",2019-05-13,61,1,91,152
"2790","2100-2159",2019-05-14,59,2,85,144
"2791","2100-2159",2019-05-15,58,3,88,146
"2792","2100-2159",2019-05-16,59,4,92,151
"2793","2100-2159",2019-05-17,58,5,94,152
"2794","2100-2159",2019-05-18,38,6,83,121
"2795","2100-2159",2019-05-19,60,7,101,161
"2796","2100-2159",2019-05-20,62,1,93,155
"2797","2100-2159",2019-05-21,59,2,85,144
"2798","2100-2159",2019-05-22,58,3,89,147
"2799","2100-2159",2019-05-23,60,4,93,153
"2800","2100-2159",2019-05-24,59,5,95,154
"2801","2100-2159",2019-05-25,37,6,82,119
"2802","2100-2159",2019-05-26,39,7,84,123
"2803","2100-2159",2019-05-27,59,1,98,157
"2804","2100-2159",2019-05-28,59,2,86,145
"2805","2100-2159",2019-05-29,59,3,90,149
"2806","2100-2159",2019-05-30,60,4,94,154
"2807","2100-2159",2019-05-31,58,5,95,153
"2808","2200-2259",2019-05-01,41,3,88,129
"2809","2200-2259",2019-05-02,48,4,92,140
"2810","2200-2259",2019-05-03,45,5,88,133
"2811","2200-2259",2019-05-04,28,6,63,91
"2812","2200-2259",2019-05-05,43,7,76,119
"2813","2200-2259",2019-05-06,45,1,86,131
"2814","2200-2259",2019-05-07,40,2,82,122
"2815","2200-2259",2019-05-08,42,3,82,124
"2816","2200-2259",2019-05-09,46,4,85,131
"2817","2200-2259",2019-05-10,45,5,86,131
"2818","2200-2259",2019-05-11,27,6,61,88
"2819","2200-2259",2019-05-12,41,7,74,115
"2820","2200-2259",2019-05-13,45,1,86,131
"2821","2200-2259",2019-05-14,40,2,83,123
"2822","2200-2259",2019-05-15,42,3,83,125
"2823","2200-2259",2019-05-16,47,4,85,132
"2824","2200-2259",2019-05-17,46,5,85,131
"2825","2200-2259",2019-05-18,28,6,64,92
"2826","2200-2259",2019-05-19,46,7,76,122
"2827","2200-2259",2019-05-20,47,1,87,134
"2828","2200-2259",2019-05-21,41,2,84,125
"2829","2200-2259",2019-05-22,45,3,86,131
"2830","2200-2259",2019-05-23,48,4,88,136
"2831","2200-2259",2019-05-24,47,5,86,133
"2832","2200-2259",2019-05-25,27,6,62,89
"2833","2200-2259",2019-05-26,35,7,71,106
"2834","2200-2259",2019-05-27,49,1,85,134
"2835","2200-2259",2019-05-28,42,2,84,126
"2836","2200-2259",2019-05-29,45,3,86,131
"2837","2200-2259",2019-05-30,49,4,87,136
"2838","2200-2259",2019-05-31,48,5,87,135
"2839","2300-2359",2019-05-01,22,3,73,95
"2840","2300-2359",2019-05-02,20,4,78,98
"2841","2300-2359",2019-05-03,25,5,80,105
"2842","2300-2359",2019-05-04,19,6,50,69
"2843","2300-2359",2019-05-05,26,7,80,106
"2844","2300-2359",2019-05-06,23,1,83,106
"2845","2300-2359",2019-05-07,21,2,74,95
"2846","2300-2359",2019-05-08,24,3,80,104
"2847","2300-2359",2019-05-09,26,4,81,107
"2848","2300-2359",2019-05-10,25,5,83,108
"2849","2300-2359",2019-05-11,19,6,53,72
"2850","2300-2359",2019-05-12,26,7,77,103
"2851","2300-2359",2019-05-13,23,1,83,106
"2852","2300-2359",2019-05-14,21,2,74,95
"2853","2300-2359",2019-05-15,24,3,80,104
"2854","2300-2359",2019-05-16,26,4,80,106
"2855","2300-2359",2019-05-17,25,5,83,108
"2856","2300-2359",2019-05-18,19,6,53,72
"2857","2300-2359",2019-05-19,26,7,80,106
"2858","2300-2359",2019-05-20,23,1,82,105
"2859","2300-2359",2019-05-21,21,2,73,94
"2860","2300-2359",2019-05-22,25,3,79,104
"2861","2300-2359",2019-05-23,26,4,80,106
"2862","2300-2359",2019-05-24,25,5,82,107
"2863","2300-2359",2019-05-25,18,6,44,62
"2864","2300-2359",2019-05-26,22,7,55,77
"2865","2300-2359",2019-05-27,23,1,84,107
"2866","2300-2359",2019-05-28,21,2,74,95
"2867","2300-2359",2019-05-29,24,3,81,105
"2868","2300-2359",2019-05-30,26,4,81,107
"2869","2300-2359",2019-05-31,25,5,82,107
"2870","0001-0559",2019-06-01,19,6,51,70
"2871","0001-0559",2019-06-02,19,7,79,98
"2872","0001-0559",2019-06-03,35,1,76,111
"2873","0001-0559",2019-06-04,33,2,70,103
"2874","0001-0559",2019-06-05,32,3,72,104
"2875","0001-0559",2019-06-06,34,4,75,109
"2876","0001-0559",2019-06-07,34,5,73,107
"2877","0001-0559",2019-06-08,19,6,53,72
"2878","0001-0559",2019-06-09,24,7,79,103
"2879","0001-0559",2019-06-10,30,1,87,117
"2880","0001-0559",2019-06-11,31,2,84,115
"2881","0001-0559",2019-06-12,31,3,87,118
"2882","0001-0559",2019-06-13,31,4,87,118
"2883","0001-0559",2019-06-14,32,5,84,116
"2884","0001-0559",2019-06-15,23,6,58,81
"2885","0001-0559",2019-06-16,24,7,76,100
"2886","0001-0559",2019-06-17,32,1,85,117
"2887","0001-0559",2019-06-18,32,2,83,115
"2888","0001-0559",2019-06-19,32,3,85,117
"2889","0001-0559",2019-06-20,33,4,87,120
"2890","0001-0559",2019-06-21,31,5,85,116
"2891","0001-0559",2019-06-22,24,6,59,83
"2892","0001-0559",2019-06-23,24,7,79,103
"2893","0001-0559",2019-06-24,32,1,86,118
"2894","0001-0559",2019-06-25,31,2,85,116
"2895","0001-0559",2019-06-26,31,3,86,117
"2896","0001-0559",2019-06-27,31,4,87,118
"2897","0001-0559",2019-06-28,31,5,85,116
"2898","0001-0559",2019-06-29,24,6,63,87
"2899","0001-0559",2019-06-30,24,7,74,98
"2900","0600-0659",2019-06-01,95,6,25,120
"2901","0600-0659",2019-06-02,101,7,27,128
"2902","0600-0659",2019-06-03,106,1,33,139
"2903","0600-0659",2019-06-04,95,2,32,127
"2904","0600-0659",2019-06-05,99,3,32,131
"2905","0600-0659",2019-06-06,106,4,38,144
"2906","0600-0659",2019-06-07,106,5,38,144
"2907","0600-0659",2019-06-08,96,6,32,128
"2908","0600-0659",2019-06-09,103,7,35,138
"2909","0600-0659",2019-06-10,114,1,39,153
"2910","0600-0659",2019-06-11,109,2,37,146
"2911","0600-0659",2019-06-12,112,3,37,149
"2912","0600-0659",2019-06-13,115,4,38,153
"2913","0600-0659",2019-06-14,115,5,39,154
"2914","0600-0659",2019-06-15,98,6,31,129
"2915","0600-0659",2019-06-16,104,7,36,140
"2916","0600-0659",2019-06-17,115,1,39,154
"2917","0600-0659",2019-06-18,110,2,38,148
"2918","0600-0659",2019-06-19,113,3,38,151
"2919","0600-0659",2019-06-20,113,4,37,150
"2920","0600-0659",2019-06-21,114,5,37,151
"2921","0600-0659",2019-06-22,97,6,29,126
"2922","0600-0659",2019-06-23,103,7,33,136
"2923","0600-0659",2019-06-24,114,1,37,151
"2924","0600-0659",2019-06-25,109,2,35,144
"2925","0600-0659",2019-06-26,112,3,35,147
"2926","0600-0659",2019-06-27,114,4,37,151
"2927","0600-0659",2019-06-28,114,5,37,151
"2928","0600-0659",2019-06-29,98,6,30,128
"2929","0600-0659",2019-06-30,96,7,31,127
"2930","0700-0759",2019-06-01,95,6,54,149
"2931","0700-0759",2019-06-02,93,7,59,152
"2932","0700-0759",2019-06-03,111,1,67,178
"2933","0700-0759",2019-06-04,103,2,63,166
"2934","0700-0759",2019-06-05,107,3,63,170
"2935","0700-0759",2019-06-06,108,4,72,180
"2936","0700-0759",2019-06-07,111,5,67,178
"2937","0700-0759",2019-06-08,102,6,63,165
"2938","0700-0759",2019-06-09,104,7,69,173
"2939","0700-0759",2019-06-10,109,1,73,182
"2940","0700-0759",2019-06-11,105,2,73,178
"2941","0700-0759",2019-06-12,107,3,73,180
"2942","0700-0759",2019-06-13,105,4,75,180
"2943","0700-0759",2019-06-14,105,5,75,180
"2944","0700-0759",2019-06-15,101,6,67,168
"2945","0700-0759",2019-06-16,102,7,67,169
"2946","0700-0759",2019-06-17,106,1,75,181
"2947","0700-0759",2019-06-18,104,2,73,177
"2948","0700-0759",2019-06-19,106,3,73,179
"2949","0700-0759",2019-06-20,109,4,78,187
"2950","0700-0759",2019-06-21,109,5,75,184
"2951","0700-0759",2019-06-22,103,6,68,171
"2952","0700-0759",2019-06-23,105,7,69,174
"2953","0700-0759",2019-06-24,108,1,76,184
"2954","0700-0759",2019-06-25,107,2,74,181
"2955","0700-0759",2019-06-26,109,3,74,183
"2956","0700-0759",2019-06-27,108,4,76,184
"2957","0700-0759",2019-06-28,109,5,75,184
"2958","0700-0759",2019-06-29,103,6,69,172
"2959","0700-0759",2019-06-30,102,7,65,167
"2960","0800-0859",2019-06-01,86,6,65,151
"2961","0800-0859",2019-06-02,103,7,71,174
"2962","0800-0859",2019-06-03,98,1,76,174
"2963","0800-0859",2019-06-04,96,2,65,161
"2964","0800-0859",2019-06-05,97,3,71,168
"2965","0800-0859",2019-06-06,98,4,79,177
"2966","0800-0859",2019-06-07,98,5,79,177
"2967","0800-0859",2019-06-08,85,6,68,153
"2968","0800-0859",2019-06-09,93,7,72,165
"2969","0800-0859",2019-06-10,97,1,80,177
"2970","0800-0859",2019-06-11,97,2,76,173
"2971","0800-0859",2019-06-12,97,3,77,174
"2972","0800-0859",2019-06-13,98,4,79,177
"2973","0800-0859",2019-06-14,98,5,78,176
"2974","0800-0859",2019-06-15,83,6,63,146
"2975","0800-0859",2019-06-16,91,7,72,163
"2976","0800-0859",2019-06-17,97,1,79,176
"2977","0800-0859",2019-06-18,97,2,76,173
"2978","0800-0859",2019-06-19,97,3,76,173
"2979","0800-0859",2019-06-20,97,4,80,177
"2980","0800-0859",2019-06-21,96,5,80,176
"2981","0800-0859",2019-06-22,81,6,64,145
"2982","0800-0859",2019-06-23,91,7,73,164
"2983","0800-0859",2019-06-24,96,1,79,175
"2984","0800-0859",2019-06-25,96,2,78,174
"2985","0800-0859",2019-06-26,95,3,79,174
"2986","0800-0859",2019-06-27,97,4,81,178
"2987","0800-0859",2019-06-28,96,5,80,176
"2988","0800-0859",2019-06-29,81,6,64,145
"2989","0800-0859",2019-06-30,91,7,69,160
"2990","0900-0959",2019-06-01,79,6,60,139
"2991","0900-0959",2019-06-02,85,7,56,141
"2992","0900-0959",2019-06-03,87,1,67,154
"2993","0900-0959",2019-06-04,82,2,64,146
"2994","0900-0959",2019-06-05,83,3,65,148
"2995","0900-0959",2019-06-06,99,4,64,163
"2996","0900-0959",2019-06-07,92,5,66,158
"2997","0900-0959",2019-06-08,88,6,56,144
"2998","0900-0959",2019-06-09,99,7,57,156
"2999","0900-0959",2019-06-10,97,1,65,162
"3000","0900-0959",2019-06-11,100,2,63,163
"3001","0900-0959",2019-06-12,97,3,63,160
"3002","0900-0959",2019-06-13,102,4,64,166
"3003","0900-0959",2019-06-14,97,5,65,162
"3004","0900-0959",2019-06-15,88,6,52,140
"3005","0900-0959",2019-06-16,101,7,57,158
"3006","0900-0959",2019-06-17,98,1,65,163
"3007","0900-0959",2019-06-18,100,2,63,163
"3008","0900-0959",2019-06-19,97,3,63,160
"3009","0900-0959",2019-06-20,104,4,64,168
"3010","0900-0959",2019-06-21,100,5,65,165
"3011","0900-0959",2019-06-22,91,6,52,143
"3012","0900-0959",2019-06-23,102,7,57,159
"3013","0900-0959",2019-06-24,99,1,65,164
"3014","0900-0959",2019-06-25,101,2,61,162
"3015","0900-0959",2019-06-26,99,3,61,160
"3016","0900-0959",2019-06-27,103,4,63,166
"3017","0900-0959",2019-06-28,100,5,64,164
"3018","0900-0959",2019-06-29,92,6,52,144
"3019","0900-0959",2019-06-30,101,7,56,157
"3020","1000-1059",2019-06-01,65,6,53,118
"3021","1000-1059",2019-06-02,73,7,67,140
"3022","1000-1059",2019-06-03,74,1,65,139
"3023","1000-1059",2019-06-04,69,2,60,129
"3024","1000-1059",2019-06-05,72,3,60,132
"3025","1000-1059",2019-06-06,73,4,60,133
"3026","1000-1059",2019-06-07,75,5,59,134
"3027","1000-1059",2019-06-08,71,6,52,123
"3028","1000-1059",2019-06-09,62,7,67,129
"3029","1000-1059",2019-06-10,73,1,60,133
"3030","1000-1059",2019-06-11,71,2,59,130
"3031","1000-1059",2019-06-12,72,3,60,132
"3032","1000-1059",2019-06-13,73,4,61,134
"3033","1000-1059",2019-06-14,76,5,59,135
"3034","1000-1059",2019-06-15,69,6,61,130
"3035","1000-1059",2019-06-16,63,7,65,128
"3036","1000-1059",2019-06-17,75,1,59,134
"3037","1000-1059",2019-06-18,72,2,60,132
"3038","1000-1059",2019-06-19,73,3,60,133
"3039","1000-1059",2019-06-20,72,4,61,133
"3040","1000-1059",2019-06-21,75,5,59,134
"3041","1000-1059",2019-06-22,69,6,61,130
"3042","1000-1059",2019-06-23,63,7,65,128
"3043","1000-1059",2019-06-24,75,1,59,134
"3044","1000-1059",2019-06-25,72,2,61,133
"3045","1000-1059",2019-06-26,73,3,60,133
"3046","1000-1059",2019-06-27,73,4,61,134
"3047","1000-1059",2019-06-28,75,5,60,135
"3048","1000-1059",2019-06-29,68,6,61,129
"3049","1000-1059",2019-06-30,62,7,64,126
"3050","1100-1159",2019-06-01,74,6,73,147
"3051","1100-1159",2019-06-02,83,7,75,158
"3052","1100-1159",2019-06-03,81,1,73,154
"3053","1100-1159",2019-06-04,81,2,71,152
"3054","1100-1159",2019-06-05,80,3,72,152
"3055","1100-1159",2019-06-06,79,4,82,161
"3056","1100-1159",2019-06-07,76,5,81,157
"3057","1100-1159",2019-06-08,66,6,77,143
"3058","1100-1159",2019-06-09,83,7,76,159
"3059","1100-1159",2019-06-10,78,1,83,161
"3060","1100-1159",2019-06-11,79,2,80,159
"3061","1100-1159",2019-06-12,80,3,80,160
"3062","1100-1159",2019-06-13,79,4,88,167
"3063","1100-1159",2019-06-14,76,5,87,163
"3064","1100-1159",2019-06-15,69,6,76,145
"3065","1100-1159",2019-06-16,81,7,80,161
"3066","1100-1159",2019-06-17,76,1,87,163
"3067","1100-1159",2019-06-18,79,2,84,163
"3068","1100-1159",2019-06-19,77,3,83,160
"3069","1100-1159",2019-06-20,79,4,88,167
"3070","1100-1159",2019-06-21,77,5,87,164
"3071","1100-1159",2019-06-22,69,6,76,145
"3072","1100-1159",2019-06-23,80,7,81,161
"3073","1100-1159",2019-06-24,76,1,87,163
"3074","1100-1159",2019-06-25,79,2,84,163
"3075","1100-1159",2019-06-26,77,3,84,161
"3076","1100-1159",2019-06-27,79,4,88,167
"3077","1100-1159",2019-06-28,77,5,87,164
"3078","1100-1159",2019-06-29,69,6,78,147
"3079","1100-1159",2019-06-30,78,7,78,156
"3080","1200-1259",2019-06-01,62,6,57,119
"3081","1200-1259",2019-06-02,67,7,68,135
"3082","1200-1259",2019-06-03,69,1,73,142
"3083","1200-1259",2019-06-04,66,2,69,135
"3084","1200-1259",2019-06-05,70,3,72,142
"3085","1200-1259",2019-06-06,85,4,86,171
"3086","1200-1259",2019-06-07,86,5,87,173
"3087","1200-1259",2019-06-08,74,6,71,145
"3088","1200-1259",2019-06-09,79,7,87,166
"3089","1200-1259",2019-06-10,87,1,84,171
"3090","1200-1259",2019-06-11,84,2,84,168
"3091","1200-1259",2019-06-12,86,3,87,173
"3092","1200-1259",2019-06-13,90,4,83,173
"3093","1200-1259",2019-06-14,90,5,82,172
"3094","1200-1259",2019-06-15,75,6,75,150
"3095","1200-1259",2019-06-16,83,7,85,168
"3096","1200-1259",2019-06-17,90,1,82,172
"3097","1200-1259",2019-06-18,87,2,82,169
"3098","1200-1259",2019-06-19,89,3,84,173
"3099","1200-1259",2019-06-20,89,4,83,172
"3100","1200-1259",2019-06-21,90,5,83,173
"3101","1200-1259",2019-06-22,75,6,75,150
"3102","1200-1259",2019-06-23,83,7,85,168
"3103","1200-1259",2019-06-24,89,1,82,171
"3104","1200-1259",2019-06-25,86,2,82,168
"3105","1200-1259",2019-06-26,89,3,85,174
"3106","1200-1259",2019-06-27,89,4,83,172
"3107","1200-1259",2019-06-28,90,5,83,173
"3108","1200-1259",2019-06-29,77,6,75,152
"3109","1200-1259",2019-06-30,79,7,85,164
"3110","1300-1359",2019-06-01,64,6,60,124
"3111","1300-1359",2019-06-02,72,7,62,134
"3112","1300-1359",2019-06-03,77,1,61,138
"3113","1300-1359",2019-06-04,72,2,58,130
"3114","1300-1359",2019-06-05,76,3,62,138
"3115","1300-1359",2019-06-06,77,4,56,133
"3116","1300-1359",2019-06-07,77,5,58,135
"3117","1300-1359",2019-06-08,68,6,61,129
"3118","1300-1359",2019-06-09,77,7,52,129
"3119","1300-1359",2019-06-10,80,1,66,146
"3120","1300-1359",2019-06-11,77,2,65,142
"3121","1300-1359",2019-06-12,79,3,66,145
"3122","1300-1359",2019-06-13,78,4,65,143
"3123","1300-1359",2019-06-14,77,5,67,144
"3124","1300-1359",2019-06-15,70,6,59,129
"3125","1300-1359",2019-06-16,74,7,52,126
"3126","1300-1359",2019-06-17,78,1,66,144
"3127","1300-1359",2019-06-18,77,2,65,142
"3128","1300-1359",2019-06-19,77,3,66,143
"3129","1300-1359",2019-06-20,80,4,65,145
"3130","1300-1359",2019-06-21,79,5,67,146
"3131","1300-1359",2019-06-22,71,6,59,130
"3132","1300-1359",2019-06-23,74,7,52,126
"3133","1300-1359",2019-06-24,80,1,66,146
"3134","1300-1359",2019-06-25,79,2,65,144
"3135","1300-1359",2019-06-26,80,3,66,146
"3136","1300-1359",2019-06-27,80,4,65,145
"3137","1300-1359",2019-06-28,79,5,67,146
"3138","1300-1359",2019-06-29,72,6,59,131
"3139","1300-1359",2019-06-30,73,7,51,124
"3140","1400-1459",2019-06-01,65,6,68,133
"3141","1400-1459",2019-06-02,68,7,70,138
"3142","1400-1459",2019-06-03,77,1,79,156
"3143","1400-1459",2019-06-04,71,2,77,148
"3144","1400-1459",2019-06-05,74,3,78,152
"3145","1400-1459",2019-06-06,68,4,89,157
"3146","1400-1459",2019-06-07,68,5,89,157
"3147","1400-1459",2019-06-08,56,6,65,121
"3148","1400-1459",2019-06-09,60,7,84,144
"3149","1400-1459",2019-06-10,66,1,85,151
"3150","1400-1459",2019-06-11,64,2,82,146
"3151","1400-1459",2019-06-12,66,3,86,152
"3152","1400-1459",2019-06-13,64,4,86,150
"3153","1400-1459",2019-06-14,64,5,84,148
"3154","1400-1459",2019-06-15,55,6,66,121
"3155","1400-1459",2019-06-16,61,7,84,145
"3156","1400-1459",2019-06-17,66,1,85,151
"3157","1400-1459",2019-06-18,64,2,83,147
"3158","1400-1459",2019-06-19,66,3,85,151
"3159","1400-1459",2019-06-20,66,4,85,151
"3160","1400-1459",2019-06-21,66,5,85,151
"3161","1400-1459",2019-06-22,58,6,69,127
"3162","1400-1459",2019-06-23,64,7,84,148
"3163","1400-1459",2019-06-24,67,1,85,152
"3164","1400-1459",2019-06-25,65,2,83,148
"3165","1400-1459",2019-06-26,67,3,85,152
"3166","1400-1459",2019-06-27,65,4,86,151
"3167","1400-1459",2019-06-28,66,5,85,151
"3168","1400-1459",2019-06-29,58,6,70,128
"3169","1400-1459",2019-06-30,64,7,82,146
"3170","1500-1559",2019-06-01,73,6,72,145
"3171","1500-1559",2019-06-02,79,7,76,155
"3172","1500-1559",2019-06-03,87,1,80,167
"3173","1500-1559",2019-06-04,84,2,76,160
"3174","1500-1559",2019-06-05,85,3,80,165
"3175","1500-1559",2019-06-06,93,4,70,163
"3176","1500-1559",2019-06-07,95,5,70,165
"3177","1500-1559",2019-06-08,83,6,75,158
"3178","1500-1559",2019-06-09,90,7,69,159
"3179","1500-1559",2019-06-10,93,1,69,162
"3180","1500-1559",2019-06-11,91,2,69,160
"3181","1500-1559",2019-06-12,93,3,69,162
"3182","1500-1559",2019-06-13,93,4,68,161
"3183","1500-1559",2019-06-14,93,5,68,161
"3184","1500-1559",2019-06-15,83,6,77,160
"3185","1500-1559",2019-06-16,91,7,68,159
"3186","1500-1559",2019-06-17,94,1,69,163
"3187","1500-1559",2019-06-18,91,2,67,158
"3188","1500-1559",2019-06-19,92,3,68,160
"3189","1500-1559",2019-06-20,90,4,71,161
"3190","1500-1559",2019-06-21,91,5,70,161
"3191","1500-1559",2019-06-22,81,6,77,158
"3192","1500-1559",2019-06-23,89,7,70,159
"3193","1500-1559",2019-06-24,91,1,70,161
"3194","1500-1559",2019-06-25,88,2,68,156
"3195","1500-1559",2019-06-26,91,3,70,161
"3196","1500-1559",2019-06-27,90,4,69,159
"3197","1500-1559",2019-06-28,91,5,70,161
"3198","1500-1559",2019-06-29,82,6,77,159
"3199","1500-1559",2019-06-30,84,7,65,149
"3200","1600-1659",2019-06-01,68,6,72,140
"3201","1600-1659",2019-06-02,76,7,88,164
"3202","1600-1659",2019-06-03,77,1,90,167
"3203","1600-1659",2019-06-04,72,2,86,158
"3204","1600-1659",2019-06-05,73,3,85,158
"3205","1600-1659",2019-06-06,74,4,87,161
"3206","1600-1659",2019-06-07,74,5,85,159
"3207","1600-1659",2019-06-08,74,6,73,147
"3208","1600-1659",2019-06-09,69,7,79,148
"3209","1600-1659",2019-06-10,70,1,86,156
"3210","1600-1659",2019-06-11,69,2,86,155
"3211","1600-1659",2019-06-12,69,3,84,153
"3212","1600-1659",2019-06-13,68,4,85,153
"3213","1600-1659",2019-06-14,70,5,84,154
"3214","1600-1659",2019-06-15,72,6,71,143
"3215","1600-1659",2019-06-16,68,7,80,148
"3216","1600-1659",2019-06-17,69,1,85,154
"3217","1600-1659",2019-06-18,68,2,85,153
"3218","1600-1659",2019-06-19,68,3,84,152
"3219","1600-1659",2019-06-20,70,4,87,157
"3220","1600-1659",2019-06-21,72,5,86,158
"3221","1600-1659",2019-06-22,72,6,71,143
"3222","1600-1659",2019-06-23,68,7,81,149
"3223","1600-1659",2019-06-24,71,1,87,158
"3224","1600-1659",2019-06-25,70,2,87,157
"3225","1600-1659",2019-06-26,70,3,86,156
"3226","1600-1659",2019-06-27,70,4,87,157
"3227","1600-1659",2019-06-28,72,5,86,158
"3228","1600-1659",2019-06-29,71,6,72,143
"3229","1600-1659",2019-06-30,64,7,79,143
"3230","1700-1759",2019-06-01,69,6,56,125
"3231","1700-1759",2019-06-02,84,7,67,151
"3232","1700-1759",2019-06-03,89,1,70,159
"3233","1700-1759",2019-06-04,85,2,68,153
"3234","1700-1759",2019-06-05,85,3,68,153
"3235","1700-1759",2019-06-06,95,4,74,169
"3236","1700-1759",2019-06-07,95,5,76,171
"3237","1700-1759",2019-06-08,75,6,64,139
"3238","1700-1759",2019-06-09,91,7,76,167
"3239","1700-1759",2019-06-10,96,1,79,175
"3240","1700-1759",2019-06-11,92,2,79,171
"3241","1700-1759",2019-06-12,92,3,78,170
"3242","1700-1759",2019-06-13,93,4,79,172
"3243","1700-1759",2019-06-14,92,5,80,172
"3244","1700-1759",2019-06-15,76,6,63,139
"3245","1700-1759",2019-06-16,91,7,75,166
"3246","1700-1759",2019-06-17,94,1,80,174
"3247","1700-1759",2019-06-18,91,2,79,170
"3248","1700-1759",2019-06-19,91,3,78,169
"3249","1700-1759",2019-06-20,93,4,79,172
"3250","1700-1759",2019-06-21,92,5,78,170
"3251","1700-1759",2019-06-22,76,6,65,141
"3252","1700-1759",2019-06-23,91,7,75,166
"3253","1700-1759",2019-06-24,94,1,77,171
"3254","1700-1759",2019-06-25,91,2,77,168
"3255","1700-1759",2019-06-26,91,3,77,168
"3256","1700-1759",2019-06-27,93,4,77,170
"3257","1700-1759",2019-06-28,92,5,77,169
"3258","1700-1759",2019-06-29,79,6,63,142
"3259","1700-1759",2019-06-30,89,7,74,163
"3260","1800-1859",2019-06-01,67,6,78,145
"3261","1800-1859",2019-06-02,79,7,89,168
"3262","1800-1859",2019-06-03,77,1,98,175
"3263","1800-1859",2019-06-04,71,2,94,165
"3264","1800-1859",2019-06-05,75,3,96,171
"3265","1800-1859",2019-06-06,76,4,104,180
"3266","1800-1859",2019-06-07,77,5,102,179
"3267","1800-1859",2019-06-08,73,6,84,157
"3268","1800-1859",2019-06-09,81,7,88,169
"3269","1800-1859",2019-06-10,82,1,89,171
"3270","1800-1859",2019-06-11,83,2,89,172
"3271","1800-1859",2019-06-12,81,3,89,170
"3272","1800-1859",2019-06-13,80,4,90,170
"3273","1800-1859",2019-06-14,80,5,88,168
"3274","1800-1859",2019-06-15,69,6,82,151
"3275","1800-1859",2019-06-16,77,7,88,165
"3276","1800-1859",2019-06-17,79,1,88,167
"3277","1800-1859",2019-06-18,79,2,88,167
"3278","1800-1859",2019-06-19,78,3,88,166
"3279","1800-1859",2019-06-20,81,4,88,169
"3280","1800-1859",2019-06-21,80,5,88,168
"3281","1800-1859",2019-06-22,69,6,81,150
"3282","1800-1859",2019-06-23,76,7,87,163
"3283","1800-1859",2019-06-24,80,1,89,169
"3284","1800-1859",2019-06-25,80,2,88,168
"3285","1800-1859",2019-06-26,80,3,89,169
"3286","1800-1859",2019-06-27,81,4,90,171
"3287","1800-1859",2019-06-28,80,5,89,169
"3288","1800-1859",2019-06-29,69,6,81,150
"3289","1800-1859",2019-06-30,70,7,81,151
"3290","1900-1959",2019-06-01,70,6,69,139
"3291","1900-1959",2019-06-02,78,7,79,157
"3292","1900-1959",2019-06-03,77,1,80,157
"3293","1900-1959",2019-06-04,73,2,76,149
"3294","1900-1959",2019-06-05,76,3,77,153
"3295","1900-1959",2019-06-06,87,4,82,169
"3296","1900-1959",2019-06-07,88,5,80,168
"3297","1900-1959",2019-06-08,76,6,72,148
"3298","1900-1959",2019-06-09,82,7,78,160
"3299","1900-1959",2019-06-10,84,1,84,168
"3300","1900-1959",2019-06-11,81,2,81,162
"3301","1900-1959",2019-06-12,84,3,82,166
"3302","1900-1959",2019-06-13,89,4,83,172
"3303","1900-1959",2019-06-14,86,5,83,169
"3304","1900-1959",2019-06-15,81,6,78,159
"3305","1900-1959",2019-06-16,85,7,80,165
"3306","1900-1959",2019-06-17,87,1,84,171
"3307","1900-1959",2019-06-18,86,2,82,168
"3308","1900-1959",2019-06-19,87,3,81,168
"3309","1900-1959",2019-06-20,88,4,85,173
"3310","1900-1959",2019-06-21,87,5,85,172
"3311","1900-1959",2019-06-22,83,6,79,162
"3312","1900-1959",2019-06-23,88,7,80,168
"3313","1900-1959",2019-06-24,87,1,86,173
"3314","1900-1959",2019-06-25,85,2,84,169
"3315","1900-1959",2019-06-26,88,3,84,172
"3316","1900-1959",2019-06-27,88,4,85,173
"3317","1900-1959",2019-06-28,87,5,85,172
"3318","1900-1959",2019-06-29,84,6,80,164
"3319","1900-1959",2019-06-30,84,7,81,165
"3320","2000-2059",2019-06-01,49,6,71,120
"3321","2000-2059",2019-06-02,72,7,72,144
"3322","2000-2059",2019-06-03,71,1,72,143
"3323","2000-2059",2019-06-04,67,2,69,136
"3324","2000-2059",2019-06-05,66,3,70,136
"3325","2000-2059",2019-06-06,73,4,79,152
"3326","2000-2059",2019-06-07,73,5,82,155
"3327","2000-2059",2019-06-08,60,6,78,138
"3328","2000-2059",2019-06-09,70,7,80,150
"3329","2000-2059",2019-06-10,77,1,88,165
"3330","2000-2059",2019-06-11,74,2,88,162
"3331","2000-2059",2019-06-12,74,3,87,161
"3332","2000-2059",2019-06-13,75,4,87,162
"3333","2000-2059",2019-06-14,77,5,87,164
"3334","2000-2059",2019-06-15,67,6,75,142
"3335","2000-2059",2019-06-16,69,7,79,148
"3336","2000-2059",2019-06-17,78,1,88,166
"3337","2000-2059",2019-06-18,75,2,88,163
"3338","2000-2059",2019-06-19,74,3,87,161
"3339","2000-2059",2019-06-20,76,4,86,162
"3340","2000-2059",2019-06-21,77,5,87,164
"3341","2000-2059",2019-06-22,65,6,74,139
"3342","2000-2059",2019-06-23,68,7,79,147
"3343","2000-2059",2019-06-24,77,1,87,164
"3344","2000-2059",2019-06-25,75,2,87,162
"3345","2000-2059",2019-06-26,73,3,86,159
"3346","2000-2059",2019-06-27,76,4,86,162
"3347","2000-2059",2019-06-28,77,5,87,164
"3348","2000-2059",2019-06-29,65,6,78,143
"3349","2000-2059",2019-06-30,69,7,76,145
"3350","2100-2159",2019-06-01,39,6,87,126
"3351","2100-2159",2019-06-02,59,7,105,164
"3352","2100-2159",2019-06-03,61,1,95,156
"3353","2100-2159",2019-06-04,60,2,86,146
"3354","2100-2159",2019-06-05,66,3,90,156
"3355","2100-2159",2019-06-06,71,4,90,161
"3356","2100-2159",2019-06-07,71,5,92,163
"3357","2100-2159",2019-06-08,51,6,89,140
"3358","2100-2159",2019-06-09,68,7,97,165
"3359","2100-2159",2019-06-10,67,1,96,163
"3360","2100-2159",2019-06-11,65,2,93,158
"3361","2100-2159",2019-06-12,68,3,96,164
"3362","2100-2159",2019-06-13,66,4,100,166
"3363","2100-2159",2019-06-14,68,5,101,169
"3364","2100-2159",2019-06-15,54,6,91,145
"3365","2100-2159",2019-06-16,68,7,100,168
"3366","2100-2159",2019-06-17,67,1,99,166
"3367","2100-2159",2019-06-18,65,2,97,162
"3368","2100-2159",2019-06-19,69,3,100,169
"3369","2100-2159",2019-06-20,66,4,102,168
"3370","2100-2159",2019-06-21,68,5,102,170
"3371","2100-2159",2019-06-22,54,6,92,146
"3372","2100-2159",2019-06-23,67,7,100,167
"3373","2100-2159",2019-06-24,67,1,101,168
"3374","2100-2159",2019-06-25,66,2,99,165
"3375","2100-2159",2019-06-26,68,3,102,170
"3376","2100-2159",2019-06-27,66,4,102,168
"3377","2100-2159",2019-06-28,68,5,102,170
"3378","2100-2159",2019-06-29,55,6,92,147
"3379","2100-2159",2019-06-30,63,7,96,159
"3380","2200-2259",2019-06-01,29,6,66,95
"3381","2200-2259",2019-06-02,48,7,75,123
"3382","2200-2259",2019-06-03,48,1,88,136
"3383","2200-2259",2019-06-04,42,2,86,128
"3384","2200-2259",2019-06-05,42,3,88,130
"3385","2200-2259",2019-06-06,48,4,107,155
"3386","2200-2259",2019-06-07,46,5,106,152
"3387","2200-2259",2019-06-08,37,6,88,125
"3388","2200-2259",2019-06-09,59,7,98,157
"3389","2200-2259",2019-06-10,58,1,100,158
"3390","2200-2259",2019-06-11,57,2,95,152
"3391","2200-2259",2019-06-12,57,3,97,154
"3392","2200-2259",2019-06-13,61,4,96,157
"3393","2200-2259",2019-06-14,58,5,97,155
"3394","2200-2259",2019-06-15,43,6,88,131
"3395","2200-2259",2019-06-16,60,7,95,155
"3396","2200-2259",2019-06-17,59,1,98,157
"3397","2200-2259",2019-06-18,58,2,94,152
"3398","2200-2259",2019-06-19,58,3,94,152
"3399","2200-2259",2019-06-20,60,4,95,155
"3400","2200-2259",2019-06-21,57,5,97,154
"3401","2200-2259",2019-06-22,42,6,87,129
"3402","2200-2259",2019-06-23,59,7,96,155
"3403","2200-2259",2019-06-24,58,1,96,154
"3404","2200-2259",2019-06-25,57,2,92,149
"3405","2200-2259",2019-06-26,57,3,93,150
"3406","2200-2259",2019-06-27,60,4,95,155
"3407","2200-2259",2019-06-28,57,5,97,154
"3408","2200-2259",2019-06-29,44,6,87,131
"3409","2200-2259",2019-06-30,53,7,89,142
"3410","2300-2359",2019-06-01,20,6,51,71
"3411","2300-2359",2019-06-02,25,7,79,104
"3412","2300-2359",2019-06-03,23,1,82,105
"3413","2300-2359",2019-06-04,21,2,73,94
"3414","2300-2359",2019-06-05,24,3,81,105
"3415","2300-2359",2019-06-06,30,4,80,110
"3416","2300-2359",2019-06-07,30,5,82,112
"3417","2300-2359",2019-06-08,26,6,59,85
"3418","2300-2359",2019-06-09,32,7,83,115
"3419","2300-2359",2019-06-10,32,1,77,109
"3420","2300-2359",2019-06-11,29,2,75,104
"3421","2300-2359",2019-06-12,30,3,77,107
"3422","2300-2359",2019-06-13,32,4,78,110
"3423","2300-2359",2019-06-14,32,5,78,110
"3424","2300-2359",2019-06-15,26,6,69,95
"3425","2300-2359",2019-06-16,31,7,85,116
"3426","2300-2359",2019-06-17,32,1,79,111
"3427","2300-2359",2019-06-18,29,2,77,106
"3428","2300-2359",2019-06-19,28,3,79,107
"3429","2300-2359",2019-06-20,33,4,78,111
"3430","2300-2359",2019-06-21,33,5,78,111
"3431","2300-2359",2019-06-22,27,6,69,96
"3432","2300-2359",2019-06-23,34,7,83,117
"3433","2300-2359",2019-06-24,33,1,79,112
"3434","2300-2359",2019-06-25,30,2,77,107
"3435","2300-2359",2019-06-26,30,3,78,108
"3436","2300-2359",2019-06-27,33,4,78,111
"3437","2300-2359",2019-06-28,33,5,78,111
"3438","2300-2359",2019-06-29,29,6,69,98
"3439","2300-2359",2019-06-30,31,7,81,112
"3440","0001-0559",2019-07-01,31,1,79,110
"3441","0001-0559",2019-07-02,29,2,76,105
"3442","0001-0559",2019-07-03,28,3,80,108
"3443","0001-0559",2019-07-04,18,4,53,71
"3444","0001-0559",2019-07-05,20,5,62,82
"3445","0001-0559",2019-07-06,23,6,60,83
"3446","0001-0559",2019-07-07,26,7,82,108
"3447","0001-0559",2019-07-08,34,1,89,123
"3448","0001-0559",2019-07-09,33,2,86,119
"3449","0001-0559",2019-07-10,33,3,87,120
"3450","0001-0559",2019-07-11,33,4,90,123
"3451","0001-0559",2019-07-12,33,5,86,119
"3452","0001-0559",2019-07-13,24,6,62,86
"3453","0001-0559",2019-07-14,24,7,82,106
"3454","0001-0559",2019-07-15,34,1,89,123
"3455","0001-0559",2019-07-16,33,2,86,119
"3456","0001-0559",2019-07-17,33,3,87,120
"3457","0001-0559",2019-07-18,33,4,89,122
"3458","0001-0559",2019-07-19,33,5,86,119
"3459","0001-0559",2019-07-20,25,6,62,87
"3460","0001-0559",2019-07-21,24,7,81,105
"3461","0001-0559",2019-07-22,34,1,89,123
"3462","0001-0559",2019-07-23,33,2,86,119
"3463","0001-0559",2019-07-24,33,3,87,120
"3464","0001-0559",2019-07-25,33,4,90,123
"3465","0001-0559",2019-07-26,33,5,85,118
"3466","0001-0559",2019-07-27,25,6,62,87
"3467","0001-0559",2019-07-28,24,7,82,106
"3468","0001-0559",2019-07-29,34,1,89,123
"3469","0001-0559",2019-07-30,33,2,86,119
"3470","0001-0559",2019-07-31,33,3,90,123
"3471","0600-0659",2019-07-01,103,1,33,136
"3472","0600-0659",2019-07-02,98,2,32,130
"3473","0600-0659",2019-07-03,102,3,30,132
"3474","0600-0659",2019-07-04,100,4,22,122
"3475","0600-0659",2019-07-05,97,5,24,121
"3476","0600-0659",2019-07-06,99,6,29,128
"3477","0600-0659",2019-07-07,102,7,34,136
"3478","0600-0659",2019-07-08,112,1,38,150
"3479","0600-0659",2019-07-09,109,2,37,146
"3480","0600-0659",2019-07-10,109,3,37,146
"3481","0600-0659",2019-07-11,113,4,37,150
"3482","0600-0659",2019-07-12,112,5,37,149
"3483","0600-0659",2019-07-13,97,6,30,127
"3484","0600-0659",2019-07-14,103,7,34,137
"3485","0600-0659",2019-07-15,112,1,38,150
"3486","0600-0659",2019-07-16,109,2,37,146
"3487","0600-0659",2019-07-17,109,3,37,146
"3488","0600-0659",2019-07-18,112,4,38,150
"3489","0600-0659",2019-07-19,111,5,37,148
"3490","0600-0659",2019-07-20,97,6,30,127
"3491","0600-0659",2019-07-21,103,7,33,136
"3492","0600-0659",2019-07-22,112,1,38,150
"3493","0600-0659",2019-07-23,109,2,37,146
"3494","0600-0659",2019-07-24,110,3,37,147
"3495","0600-0659",2019-07-25,113,4,37,150
"3496","0600-0659",2019-07-26,111,5,38,149
"3497","0600-0659",2019-07-27,97,6,30,127
"3498","0600-0659",2019-07-28,103,7,34,137
"3499","0600-0659",2019-07-29,112,1,38,150
"3500","0600-0659",2019-07-30,109,2,37,146
"3501","0600-0659",2019-07-31,110,3,37,147
"3502","0700-0759",2019-07-01,106,1,69,175
"3503","0700-0759",2019-07-02,103,2,69,172
"3504","0700-0759",2019-07-03,106,3,67,173
"3505","0700-0759",2019-07-04,101,4,64,165
"3506","0700-0759",2019-07-05,96,5,64,160
"3507","0700-0759",2019-07-06,102,6,69,171
"3508","0700-0759",2019-07-07,109,7,65,174
"3509","0700-0759",2019-07-08,111,1,73,184
"3510","0700-0759",2019-07-09,110,2,73,183
"3511","0700-0759",2019-07-10,113,3,72,185
"3512","0700-0759",2019-07-11,113,4,74,187
"3513","0700-0759",2019-07-12,113,5,73,186
"3514","0700-0759",2019-07-13,104,6,68,172
"3515","0700-0759",2019-07-14,111,7,67,178
"3516","0700-0759",2019-07-15,111,1,74,185
"3517","0700-0759",2019-07-16,110,2,74,184
"3518","0700-0759",2019-07-17,112,3,73,185
"3519","0700-0759",2019-07-18,112,4,74,186
"3520","0700-0759",2019-07-19,112,5,73,185
"3521","0700-0759",2019-07-20,103,6,68,171
"3522","0700-0759",2019-07-21,110,7,68,178
"3523","0700-0759",2019-07-22,111,1,74,185
"3524","0700-0759",2019-07-23,109,2,74,183
"3525","0700-0759",2019-07-24,112,3,74,186
"3526","0700-0759",2019-07-25,112,4,75,187
"3527","0700-0759",2019-07-26,112,5,73,185
"3528","0700-0759",2019-07-27,103,6,68,171
"3529","0700-0759",2019-07-28,111,7,67,178
"3530","0700-0759",2019-07-29,111,1,74,185
"3531","0700-0759",2019-07-30,109,2,74,183
"3532","0700-0759",2019-07-31,113,3,74,187
"3533","0800-0859",2019-07-01,95,1,74,169
"3534","0800-0859",2019-07-02,95,2,72,167
"3535","0800-0859",2019-07-03,95,3,74,169
"3536","0800-0859",2019-07-04,95,4,70,165
"3537","0800-0859",2019-07-05,95,5,66,161
"3538","0800-0859",2019-07-06,83,6,61,144
"3539","0800-0859",2019-07-07,87,7,76,163
"3540","0800-0859",2019-07-08,95,1,80,175
"3541","0800-0859",2019-07-09,95,2,79,174
"3542","0800-0859",2019-07-10,94,3,78,172
"3543","0800-0859",2019-07-11,94,4,81,175
"3544","0800-0859",2019-07-12,94,5,80,174
"3545","0800-0859",2019-07-13,82,6,61,143
"3546","0800-0859",2019-07-14,88,7,74,162
"3547","0800-0859",2019-07-15,95,1,80,175
"3548","0800-0859",2019-07-16,95,2,79,174
"3549","0800-0859",2019-07-17,95,3,78,173
"3550","0800-0859",2019-07-18,96,4,81,177
"3551","0800-0859",2019-07-19,96,5,80,176
"3552","0800-0859",2019-07-20,83,6,62,145
"3553","0800-0859",2019-07-21,89,7,74,163
"3554","0800-0859",2019-07-22,96,1,80,176
"3555","0800-0859",2019-07-23,96,2,79,175
"3556","0800-0859",2019-07-24,95,3,78,173
"3557","0800-0859",2019-07-25,96,4,81,177
"3558","0800-0859",2019-07-26,96,5,80,176
"3559","0800-0859",2019-07-27,83,6,62,145
"3560","0800-0859",2019-07-28,88,7,74,162
"3561","0800-0859",2019-07-29,96,1,80,176
"3562","0800-0859",2019-07-30,96,2,79,175
"3563","0800-0859",2019-07-31,93,3,78,171
"3564","0900-0959",2019-07-01,96,1,64,160
"3565","0900-0959",2019-07-02,99,2,60,159
"3566","0900-0959",2019-07-03,97,3,62,159
"3567","0900-0959",2019-07-04,95,4,62,157
"3568","0900-0959",2019-07-05,92,5,58,150
"3569","0900-0959",2019-07-06,90,6,55,145
"3570","0900-0959",2019-07-07,105,7,59,164
"3571","0900-0959",2019-07-08,99,1,67,166
"3572","0900-0959",2019-07-09,102,2,62,164
"3573","0900-0959",2019-07-10,99,3,66,165
"3574","0900-0959",2019-07-11,103,4,66,169
"3575","0900-0959",2019-07-12,101,5,66,167
"3576","0900-0959",2019-07-13,92,6,55,147
"3577","0900-0959",2019-07-14,104,7,60,164
"3578","0900-0959",2019-07-15,100,1,67,167
"3579","0900-0959",2019-07-16,102,2,63,165
"3580","0900-0959",2019-07-17,100,3,66,166
"3581","0900-0959",2019-07-18,103,4,66,169
"3582","0900-0959",2019-07-19,101,5,67,168
"3583","0900-0959",2019-07-20,92,6,55,147
"3584","0900-0959",2019-07-21,104,7,60,164
"3585","0900-0959",2019-07-22,100,1,67,167
"3586","0900-0959",2019-07-23,102,2,63,165
"3587","0900-0959",2019-07-24,100,3,65,165
"3588","0900-0959",2019-07-25,103,4,66,169
"3589","0900-0959",2019-07-26,101,5,67,168
"3590","0900-0959",2019-07-27,92,6,55,147
"3591","0900-0959",2019-07-28,104,7,60,164
"3592","0900-0959",2019-07-29,100,1,67,167
"3593","0900-0959",2019-07-30,102,2,63,165
"3594","0900-0959",2019-07-31,101,3,65,166
"3595","1000-1059",2019-07-01,72,1,58,130
"3596","1000-1059",2019-07-02,69,2,57,126
"3597","1000-1059",2019-07-03,74,3,57,131
"3598","1000-1059",2019-07-04,77,4,52,129
"3599","1000-1059",2019-07-05,73,5,54,127
"3600","1000-1059",2019-07-06,72,6,61,133
"3601","1000-1059",2019-07-07,67,7,67,134
"3602","1000-1059",2019-07-08,78,1,61,139
"3603","1000-1059",2019-07-09,74,2,64,138
"3604","1000-1059",2019-07-10,77,3,61,138
"3605","1000-1059",2019-07-11,78,4,63,141
"3606","1000-1059",2019-07-12,78,5,62,140
"3607","1000-1059",2019-07-13,72,6,63,135
"3608","1000-1059",2019-07-14,69,7,68,137
"3609","1000-1059",2019-07-15,78,1,60,138
"3610","1000-1059",2019-07-16,75,2,62,137
"3611","1000-1059",2019-07-17,77,3,61,138
"3612","1000-1059",2019-07-18,78,4,63,141
"3613","1000-1059",2019-07-19,78,5,61,139
"3614","1000-1059",2019-07-20,72,6,63,135
"3615","1000-1059",2019-07-21,69,7,68,137
"3616","1000-1059",2019-07-22,78,1,61,139
"3617","1000-1059",2019-07-23,75,2,62,137
"3618","1000-1059",2019-07-24,76,3,61,137
"3619","1000-1059",2019-07-25,78,4,63,141
"3620","1000-1059",2019-07-26,78,5,61,139
"3621","1000-1059",2019-07-27,72,6,63,135
"3622","1000-1059",2019-07-28,69,7,68,137
"3623","1000-1059",2019-07-29,78,1,61,139
"3624","1000-1059",2019-07-30,75,2,62,137
"3625","1000-1059",2019-07-31,76,3,61,137
"3626","1100-1159",2019-07-01,72,1,84,156
"3627","1100-1159",2019-07-02,74,2,81,155
"3628","1100-1159",2019-07-03,73,3,82,155
"3629","1100-1159",2019-07-04,62,4,82,144
"3630","1100-1159",2019-07-05,67,5,86,153
"3631","1100-1159",2019-07-06,70,6,78,148
"3632","1100-1159",2019-07-07,81,7,81,162
"3633","1100-1159",2019-07-08,77,1,88,165
"3634","1100-1159",2019-07-09,79,2,84,163
"3635","1100-1159",2019-07-10,79,3,85,164
"3636","1100-1159",2019-07-11,79,4,87,166
"3637","1100-1159",2019-07-12,78,5,88,166
"3638","1100-1159",2019-07-13,71,6,78,149
"3639","1100-1159",2019-07-14,80,7,80,160
"3640","1100-1159",2019-07-15,78,1,88,166
"3641","1100-1159",2019-07-16,79,2,84,163
"3642","1100-1159",2019-07-17,79,3,85,164
"3643","1100-1159",2019-07-18,79,4,87,166
"3644","1100-1159",2019-07-19,78,5,88,166
"3645","1100-1159",2019-07-20,70,6,78,148
"3646","1100-1159",2019-07-21,80,7,80,160
"3647","1100-1159",2019-07-22,77,1,88,165
"3648","1100-1159",2019-07-23,79,2,84,163
"3649","1100-1159",2019-07-24,79,3,86,165
"3650","1100-1159",2019-07-25,79,4,87,166
"3651","1100-1159",2019-07-26,78,5,88,166
"3652","1100-1159",2019-07-27,70,6,78,148
"3653","1100-1159",2019-07-28,80,7,80,160
"3654","1100-1159",2019-07-29,77,1,88,165
"3655","1100-1159",2019-07-30,79,2,84,163
"3656","1100-1159",2019-07-31,79,3,85,164
"3657","1200-1259",2019-07-01,81,1,80,161
"3658","1200-1259",2019-07-02,78,2,80,158
"3659","1200-1259",2019-07-03,82,3,85,167
"3660","1200-1259",2019-07-04,82,4,79,161
"3661","1200-1259",2019-07-05,78,5,77,155
"3662","1200-1259",2019-07-06,76,6,76,152
"3663","1200-1259",2019-07-07,81,7,84,165
"3664","1200-1259",2019-07-08,87,1,79,166
"3665","1200-1259",2019-07-09,84,2,80,164
"3666","1200-1259",2019-07-10,84,3,82,166
"3667","1200-1259",2019-07-11,87,4,82,169
"3668","1200-1259",2019-07-12,86,5,80,166
"3669","1200-1259",2019-07-13,75,6,74,149
"3670","1200-1259",2019-07-14,82,7,85,167
"3671","1200-1259",2019-07-15,85,1,80,165
"3672","1200-1259",2019-07-16,84,2,81,165
"3673","1200-1259",2019-07-17,84,3,82,166
"3674","1200-1259",2019-07-18,87,4,82,169
"3675","1200-1259",2019-07-19,86,5,81,167
"3676","1200-1259",2019-07-20,76,6,74,150
"3677","1200-1259",2019-07-21,82,7,85,167
"3678","1200-1259",2019-07-22,86,1,80,166
"3679","1200-1259",2019-07-23,84,2,81,165
"3680","1200-1259",2019-07-24,85,3,82,167
"3681","1200-1259",2019-07-25,87,4,82,169
"3682","1200-1259",2019-07-26,86,5,81,167
"3683","1200-1259",2019-07-27,76,6,74,150
"3684","1200-1259",2019-07-28,82,7,85,167
"3685","1200-1259",2019-07-29,86,1,80,166
"3686","1200-1259",2019-07-30,84,2,81,165
"3687","1200-1259",2019-07-31,84,3,83,167
"3688","1300-1359",2019-07-01,81,1,63,144
"3689","1300-1359",2019-07-02,78,2,62,140
"3690","1300-1359",2019-07-03,82,3,65,147
"3691","1300-1359",2019-07-04,72,4,60,132
"3692","1300-1359",2019-07-05,74,5,58,132
"3693","1300-1359",2019-07-06,71,6,59,130
"3694","1300-1359",2019-07-07,76,7,57,133
"3695","1300-1359",2019-07-08,80,1,70,150
"3696","1300-1359",2019-07-09,78,2,69,147
"3697","1300-1359",2019-07-10,81,3,71,152
"3698","1300-1359",2019-07-11,80,4,71,151
"3699","1300-1359",2019-07-12,81,5,73,154
"3700","1300-1359",2019-07-13,69,6,63,132
"3701","1300-1359",2019-07-14,75,7,57,132
"3702","1300-1359",2019-07-15,81,1,71,152
"3703","1300-1359",2019-07-16,78,2,69,147
"3704","1300-1359",2019-07-17,81,3,71,152
"3705","1300-1359",2019-07-18,80,4,71,151
"3706","1300-1359",2019-07-19,81,5,72,153
"3707","1300-1359",2019-07-20,69,6,63,132
"3708","1300-1359",2019-07-21,75,7,57,132
"3709","1300-1359",2019-07-22,81,1,71,152
"3710","1300-1359",2019-07-23,78,2,69,147
"3711","1300-1359",2019-07-24,81,3,71,152
"3712","1300-1359",2019-07-25,80,4,70,150
"3713","1300-1359",2019-07-26,81,5,71,152
"3714","1300-1359",2019-07-27,69,6,62,131
"3715","1300-1359",2019-07-28,75,7,56,131
"3716","1300-1359",2019-07-29,81,1,70,151
"3717","1300-1359",2019-07-30,78,2,68,146
"3718","1300-1359",2019-07-31,82,3,70,152
"3719","1400-1459",2019-07-01,66,1,80,146
"3720","1400-1459",2019-07-02,65,2,79,144
"3721","1400-1459",2019-07-03,68,3,83,151
"3722","1400-1459",2019-07-04,59,4,70,129
"3723","1400-1459",2019-07-05,56,5,76,132
"3724","1400-1459",2019-07-06,58,6,69,127
"3725","1400-1459",2019-07-07,66,7,83,149
"3726","1400-1459",2019-07-08,72,1,84,156
"3727","1400-1459",2019-07-09,72,2,83,155
"3728","1400-1459",2019-07-10,74,3,83,157
"3729","1400-1459",2019-07-11,70,4,83,153
"3730","1400-1459",2019-07-12,71,5,82,153
"3731","1400-1459",2019-07-13,63,6,67,130
"3732","1400-1459",2019-07-14,68,7,82,150
"3733","1400-1459",2019-07-15,72,1,82,154
"3734","1400-1459",2019-07-16,72,2,83,155
"3735","1400-1459",2019-07-17,74,3,83,157
"3736","1400-1459",2019-07-18,70,4,83,153
"3737","1400-1459",2019-07-19,71,5,82,153
"3738","1400-1459",2019-07-20,63,6,67,130
"3739","1400-1459",2019-07-21,67,7,82,149
"3740","1400-1459",2019-07-22,72,1,82,154
"3741","1400-1459",2019-07-23,72,2,83,155
"3742","1400-1459",2019-07-24,74,3,83,157
"3743","1400-1459",2019-07-25,70,4,84,154
"3744","1400-1459",2019-07-26,71,5,83,154
"3745","1400-1459",2019-07-27,63,6,68,131
"3746","1400-1459",2019-07-28,68,7,83,151
"3747","1400-1459",2019-07-29,72,1,83,155
"3748","1400-1459",2019-07-30,72,2,84,156
"3749","1400-1459",2019-07-31,71,3,84,155
"3750","1500-1559",2019-07-01,86,1,69,155
"3751","1500-1559",2019-07-02,83,2,66,149
"3752","1500-1559",2019-07-03,86,3,68,154
"3753","1500-1559",2019-07-04,83,4,70,153
"3754","1500-1559",2019-07-05,84,5,67,151
"3755","1500-1559",2019-07-06,80,6,78,158
"3756","1500-1559",2019-07-07,88,7,68,156
"3757","1500-1559",2019-07-08,89,1,70,159
"3758","1500-1559",2019-07-09,86,2,69,155
"3759","1500-1559",2019-07-10,87,3,70,157
"3760","1500-1559",2019-07-11,88,4,69,157
"3761","1500-1559",2019-07-12,89,5,71,160
"3762","1500-1559",2019-07-13,77,6,76,153
"3763","1500-1559",2019-07-14,87,7,68,155
"3764","1500-1559",2019-07-15,90,1,71,161
"3765","1500-1559",2019-07-16,86,2,69,155
"3766","1500-1559",2019-07-17,87,3,70,157
"3767","1500-1559",2019-07-18,88,4,69,157
"3768","1500-1559",2019-07-19,89,5,71,160
"3769","1500-1559",2019-07-20,77,6,76,153
"3770","1500-1559",2019-07-21,87,7,68,155
"3771","1500-1559",2019-07-22,89,1,71,160
"3772","1500-1559",2019-07-23,86,2,69,155
"3773","1500-1559",2019-07-24,87,3,70,157
"3774","1500-1559",2019-07-25,88,4,68,156
"3775","1500-1559",2019-07-26,89,5,70,159
"3776","1500-1559",2019-07-27,77,6,75,152
"3777","1500-1559",2019-07-28,87,7,67,154
"3778","1500-1559",2019-07-29,89,1,70,159
"3779","1500-1559",2019-07-30,86,2,68,154
"3780","1500-1559",2019-07-31,89,3,69,158
"3781","1600-1659",2019-07-01,68,1,84,152
"3782","1600-1659",2019-07-02,68,2,86,154
"3783","1600-1659",2019-07-03,68,3,85,153
"3784","1600-1659",2019-07-04,67,4,77,144
"3785","1600-1659",2019-07-05,63,5,77,140
"3786","1600-1659",2019-07-06,73,6,74,147
"3787","1600-1659",2019-07-07,69,7,82,151
"3788","1600-1659",2019-07-08,71,1,88,159
"3789","1600-1659",2019-07-09,71,2,88,159
"3790","1600-1659",2019-07-10,71,3,87,158
"3791","1600-1659",2019-07-11,70,4,88,158
"3792","1600-1659",2019-07-12,72,5,87,159
"3793","1600-1659",2019-07-13,72,6,75,147
"3794","1600-1659",2019-07-14,69,7,85,154
"3795","1600-1659",2019-07-15,71,1,89,160
"3796","1600-1659",2019-07-16,71,2,89,160
"3797","1600-1659",2019-07-17,71,3,88,159
"3798","1600-1659",2019-07-18,70,4,89,159
"3799","1600-1659",2019-07-19,72,5,88,160
"3800","1600-1659",2019-07-20,72,6,74,146
"3801","1600-1659",2019-07-21,68,7,83,151
"3802","1600-1659",2019-07-22,71,1,89,160
"3803","1600-1659",2019-07-23,71,2,89,160
"3804","1600-1659",2019-07-24,70,3,88,158
"3805","1600-1659",2019-07-25,70,4,90,160
"3806","1600-1659",2019-07-26,72,5,89,161
"3807","1600-1659",2019-07-27,72,6,75,147
"3808","1600-1659",2019-07-28,69,7,85,154
"3809","1600-1659",2019-07-29,71,1,90,161
"3810","1600-1659",2019-07-30,71,2,90,161
"3811","1600-1659",2019-07-31,69,3,90,159
"3812","1700-1759",2019-07-01,89,1,74,163
"3813","1700-1759",2019-07-02,88,2,73,161
"3814","1700-1759",2019-07-03,88,3,75,163
"3815","1700-1759",2019-07-04,78,4,77,155
"3816","1700-1759",2019-07-05,79,5,71,150
"3817","1700-1759",2019-07-06,77,6,63,140
"3818","1700-1759",2019-07-07,92,7,73,165
"3819","1700-1759",2019-07-08,95,1,76,171
"3820","1700-1759",2019-07-09,93,2,76,169
"3821","1700-1759",2019-07-10,93,3,77,170
"3822","1700-1759",2019-07-11,94,4,76,170
"3823","1700-1759",2019-07-12,93,5,76,169
"3824","1700-1759",2019-07-13,78,6,60,138
"3825","1700-1759",2019-07-14,93,7,74,167
"3826","1700-1759",2019-07-15,96,1,77,173
"3827","1700-1759",2019-07-16,94,2,76,170
"3828","1700-1759",2019-07-17,94,3,77,171
"3829","1700-1759",2019-07-18,94,4,77,171
"3830","1700-1759",2019-07-19,94,5,76,170
"3831","1700-1759",2019-07-20,78,6,61,139
"3832","1700-1759",2019-07-21,93,7,75,168
"3833","1700-1759",2019-07-22,96,1,76,172
"3834","1700-1759",2019-07-23,94,2,76,170
"3835","1700-1759",2019-07-24,94,3,76,170
"3836","1700-1759",2019-07-25,95,4,77,172
"3837","1700-1759",2019-07-26,94,5,76,170
"3838","1700-1759",2019-07-27,78,6,61,139
"3839","1700-1759",2019-07-28,93,7,74,167
"3840","1700-1759",2019-07-29,96,1,76,172
"3841","1700-1759",2019-07-30,94,2,76,170
"3842","1700-1759",2019-07-31,95,3,75,170
"3843","1800-1859",2019-07-01,70,1,81,151
"3844","1800-1859",2019-07-02,69,2,84,153
"3845","1800-1859",2019-07-03,71,3,82,153
"3846","1800-1859",2019-07-04,59,4,80,139
"3847","1800-1859",2019-07-05,68,5,75,143
"3848","1800-1859",2019-07-06,70,6,80,150
"3849","1800-1859",2019-07-07,74,7,91,165
"3850","1800-1859",2019-07-08,77,1,92,169
"3851","1800-1859",2019-07-09,76,2,93,169
"3852","1800-1859",2019-07-10,77,3,91,168
"3853","1800-1859",2019-07-11,78,4,93,171
"3854","1800-1859",2019-07-12,77,5,91,168
"3855","1800-1859",2019-07-13,69,6,83,152
"3856","1800-1859",2019-07-14,74,7,91,165
"3857","1800-1859",2019-07-15,77,1,92,169
"3858","1800-1859",2019-07-16,76,2,93,169
"3859","1800-1859",2019-07-17,77,3,91,168
"3860","1800-1859",2019-07-18,78,4,92,170
"3861","1800-1859",2019-07-19,77,5,91,168
"3862","1800-1859",2019-07-20,69,6,83,152
"3863","1800-1859",2019-07-21,74,7,90,164
"3864","1800-1859",2019-07-22,77,1,92,169
"3865","1800-1859",2019-07-23,76,2,93,169
"3866","1800-1859",2019-07-24,77,3,91,168
"3867","1800-1859",2019-07-25,79,4,92,171
"3868","1800-1859",2019-07-26,78,5,92,170
"3869","1800-1859",2019-07-27,70,6,83,153
"3870","1800-1859",2019-07-28,75,7,92,167
"3871","1800-1859",2019-07-29,78,1,92,170
"3872","1800-1859",2019-07-30,77,2,93,170
"3873","1800-1859",2019-07-31,78,3,91,169
"3874","1900-1959",2019-07-01,84,1,83,167
"3875","1900-1959",2019-07-02,83,2,82,165
"3876","1900-1959",2019-07-03,84,3,83,167
"3877","1900-1959",2019-07-04,73,4,70,143
"3878","1900-1959",2019-07-05,75,5,78,153
"3879","1900-1959",2019-07-06,82,6,79,161
"3880","1900-1959",2019-07-07,90,7,79,169
"3881","1900-1959",2019-07-08,93,1,85,178
"3882","1900-1959",2019-07-09,93,2,83,176
"3883","1900-1959",2019-07-10,93,3,85,178
"3884","1900-1959",2019-07-11,93,4,84,177
"3885","1900-1959",2019-07-12,93,5,85,178
"3886","1900-1959",2019-07-13,83,6,79,162
"3887","1900-1959",2019-07-14,91,7,80,171
"3888","1900-1959",2019-07-15,93,1,86,179
"3889","1900-1959",2019-07-16,93,2,84,177
"3890","1900-1959",2019-07-17,94,3,86,180
"3891","1900-1959",2019-07-18,93,4,85,178
"3892","1900-1959",2019-07-19,93,5,86,179
"3893","1900-1959",2019-07-20,83,6,79,162
"3894","1900-1959",2019-07-21,91,7,80,171
"3895","1900-1959",2019-07-22,93,1,86,179
"3896","1900-1959",2019-07-23,93,2,84,177
"3897","1900-1959",2019-07-24,93,3,86,179
"3898","1900-1959",2019-07-25,92,4,85,177
"3899","1900-1959",2019-07-26,92,5,85,177
"3900","1900-1959",2019-07-27,82,6,79,161
"3901","1900-1959",2019-07-28,90,7,80,170
"3902","1900-1959",2019-07-29,92,1,86,178
"3903","1900-1959",2019-07-30,92,2,84,176
"3904","1900-1959",2019-07-31,92,3,87,179
"3905","2000-2059",2019-07-01,73,1,81,154
"3906","2000-2059",2019-07-02,68,2,78,146
"3907","2000-2059",2019-07-03,71,3,81,152
"3908","2000-2059",2019-07-04,55,4,73,128
"3909","2000-2059",2019-07-05,64,5,77,141
"3910","2000-2059",2019-07-06,65,6,79,144
"3911","2000-2059",2019-07-07,70,7,80,150
"3912","2000-2059",2019-07-08,79,1,88,167
"3913","2000-2059",2019-07-09,77,2,87,164
"3914","2000-2059",2019-07-10,79,3,88,167
"3915","2000-2059",2019-07-11,79,4,88,167
"3916","2000-2059",2019-07-12,79,5,88,167
"3917","2000-2059",2019-07-13,68,6,77,145
"3918","2000-2059",2019-07-14,73,7,81,154
"3919","2000-2059",2019-07-15,79,1,88,167
"3920","2000-2059",2019-07-16,77,2,87,164
"3921","2000-2059",2019-07-17,78,3,88,166
"3922","2000-2059",2019-07-18,79,4,87,166
"3923","2000-2059",2019-07-19,79,5,88,167
"3924","2000-2059",2019-07-20,68,6,78,146
"3925","2000-2059",2019-07-21,73,7,81,154
"3926","2000-2059",2019-07-22,79,1,88,167
"3927","2000-2059",2019-07-23,77,2,87,164
"3928","2000-2059",2019-07-24,79,3,88,167
"3929","2000-2059",2019-07-25,79,4,87,166
"3930","2000-2059",2019-07-26,79,5,88,167
"3931","2000-2059",2019-07-27,68,6,77,145
"3932","2000-2059",2019-07-28,73,7,81,154
"3933","2000-2059",2019-07-29,79,1,88,167
"3934","2000-2059",2019-07-30,77,2,88,165
"3935","2000-2059",2019-07-31,77,3,87,164
"3936","2100-2159",2019-07-01,65,1,96,161
"3937","2100-2159",2019-07-02,62,2,95,157
"3938","2100-2159",2019-07-03,64,3,96,160
"3939","2100-2159",2019-07-04,49,4,85,134
"3940","2100-2159",2019-07-05,55,5,86,141
"3941","2100-2159",2019-07-06,56,6,90,146
"3942","2100-2159",2019-07-07,66,7,104,170
"3943","2100-2159",2019-07-08,66,1,103,169
"3944","2100-2159",2019-07-09,63,2,101,164
"3945","2100-2159",2019-07-10,66,3,103,169
"3946","2100-2159",2019-07-11,65,4,103,168
"3947","2100-2159",2019-07-12,66,5,103,169
"3948","2100-2159",2019-07-13,52,6,94,146
"3949","2100-2159",2019-07-14,65,7,104,169
"3950","2100-2159",2019-07-15,66,1,103,169
"3951","2100-2159",2019-07-16,63,2,101,164
"3952","2100-2159",2019-07-17,66,3,103,169
"3953","2100-2159",2019-07-18,63,4,104,167
"3954","2100-2159",2019-07-19,66,5,103,169
"3955","2100-2159",2019-07-20,52,6,93,145
"3956","2100-2159",2019-07-21,65,7,104,169
"3957","2100-2159",2019-07-22,66,1,103,169
"3958","2100-2159",2019-07-23,63,2,101,164
"3959","2100-2159",2019-07-24,65,3,103,168
"3960","2100-2159",2019-07-25,64,4,104,168
"3961","2100-2159",2019-07-26,66,5,103,169
"3962","2100-2159",2019-07-27,52,6,94,146
"3963","2100-2159",2019-07-28,65,7,104,169
"3964","2100-2159",2019-07-29,66,1,103,169
"3965","2100-2159",2019-07-30,63,2,100,163
"3966","2100-2159",2019-07-31,68,3,103,171
"3967","2200-2259",2019-07-01,49,1,89,138
"3968","2200-2259",2019-07-02,50,2,83,133
"3969","2200-2259",2019-07-03,51,3,89,140
"3970","2200-2259",2019-07-04,33,4,83,116
"3971","2200-2259",2019-07-05,36,5,83,119
"3972","2200-2259",2019-07-06,41,6,87,128
"3973","2200-2259",2019-07-07,57,7,94,151
"3974","2200-2259",2019-07-08,55,1,95,150
"3975","2200-2259",2019-07-09,54,2,92,146
"3976","2200-2259",2019-07-10,54,3,94,148
"3977","2200-2259",2019-07-11,56,4,94,150
"3978","2200-2259",2019-07-12,53,5,96,149
"3979","2200-2259",2019-07-13,40,6,85,125
"3980","2200-2259",2019-07-14,57,7,93,150
"3981","2200-2259",2019-07-15,56,1,94,150
"3982","2200-2259",2019-07-16,55,2,92,147
"3983","2200-2259",2019-07-17,55,3,93,148
"3984","2200-2259",2019-07-18,57,4,93,150
"3985","2200-2259",2019-07-19,54,5,94,148
"3986","2200-2259",2019-07-20,40,6,84,124
"3987","2200-2259",2019-07-21,57,7,92,149
"3988","2200-2259",2019-07-22,56,1,93,149
"3989","2200-2259",2019-07-23,55,2,91,146
"3990","2200-2259",2019-07-24,55,3,93,148
"3991","2200-2259",2019-07-25,57,4,93,150
"3992","2200-2259",2019-07-26,54,5,94,148
"3993","2200-2259",2019-07-27,40,6,84,124
"3994","2200-2259",2019-07-28,57,7,92,149
"3995","2200-2259",2019-07-29,56,1,93,149
"3996","2200-2259",2019-07-30,55,2,91,146
"3997","2200-2259",2019-07-31,56,3,92,148
"3998","2300-2359",2019-07-01,30,1,76,106
"3999","2300-2359",2019-07-02,28,2,72,100
"4000","2300-2359",2019-07-03,28,3,74,102
"4001","2300-2359",2019-07-04,27,4,56,83
"4002","2300-2359",2019-07-05,29,5,62,91
"4003","2300-2359",2019-07-06,29,6,70,99
"4004","2300-2359",2019-07-07,34,7,81,115
"4005","2300-2359",2019-07-08,35,1,79,114
"4006","2300-2359",2019-07-09,33,2,76,109
"4007","2300-2359",2019-07-10,33,3,79,112
"4008","2300-2359",2019-07-11,34,4,78,112
"4009","2300-2359",2019-07-12,34,5,79,113
"4010","2300-2359",2019-07-13,31,6,69,100
"4011","2300-2359",2019-07-14,36,7,84,120
"4012","2300-2359",2019-07-15,36,1,81,117
"4013","2300-2359",2019-07-16,34,2,77,111
"4014","2300-2359",2019-07-17,34,3,81,115
"4015","2300-2359",2019-07-18,35,4,77,112
"4016","2300-2359",2019-07-19,35,5,82,117
"4017","2300-2359",2019-07-20,31,6,70,101
"4018","2300-2359",2019-07-21,36,7,86,122
"4019","2300-2359",2019-07-22,36,1,82,118
"4020","2300-2359",2019-07-23,34,2,78,112
"4021","2300-2359",2019-07-24,34,3,80,114
"4022","2300-2359",2019-07-25,35,4,79,114
"4023","2300-2359",2019-07-26,35,5,82,117
"4024","2300-2359",2019-07-27,31,6,70,101
"4025","2300-2359",2019-07-28,36,7,85,121
"4026","2300-2359",2019-07-29,36,1,82,118
"4027","2300-2359",2019-07-30,34,2,78,112
"4028","2300-2359",2019-07-31,35,3,80,115
"4029","0001-0559",2019-08-01,33,4,90,123
"4030","0001-0559",2019-08-02,32,5,87,119
"4031","0001-0559",2019-08-03,25,6,64,89
"4032","0001-0559",2019-08-04,25,7,85,110
"4033","0001-0559",2019-08-05,34,1,91,125
"4034","0001-0559",2019-08-06,32,2,78,110
"4035","0001-0559",2019-08-07,32,3,79,111
"4036","0001-0559",2019-08-08,32,4,81,113
"4037","0001-0559",2019-08-09,32,5,79,111
"4038","0001-0559",2019-08-10,23,6,57,80
"4039","0001-0559",2019-08-11,21,7,79,100
"4040","0001-0559",2019-08-12,31,1,80,111
"4041","0001-0559",2019-08-13,30,2,74,104
"4042","0001-0559",2019-08-14,29,3,77,106
"4043","0001-0559",2019-08-15,29,4,79,108
"4044","0001-0559",2019-08-16,30,5,76,106
"4045","0001-0559",2019-08-17,20,6,55,75
"4046","0001-0559",2019-08-18,20,7,74,94
"4047","0001-0559",2019-08-19,30,1,78,108
"4048","0001-0559",2019-08-20,32,2,70,102
"4049","0001-0559",2019-08-21,28,3,70,98
"4050","0001-0559",2019-08-22,28,4,74,102
"4051","0001-0559",2019-08-23,29,5,73,102
"4052","0001-0559",2019-08-24,21,6,49,70
"4053","0001-0559",2019-08-25,19,7,71,90
"4054","0001-0559",2019-08-26,29,1,74,103
"4055","0001-0559",2019-08-27,29,2,65,94
"4056","0001-0559",2019-08-28,28,3,66,94
"4057","0001-0559",2019-08-29,28,4,68,96
"4058","0001-0559",2019-08-30,29,5,68,97
"4059","0001-0559",2019-08-31,21,6,41,62
"4060","0600-0659",2019-08-01,111,4,37,148
"4061","0600-0659",2019-08-02,110,5,37,147
"4062","0600-0659",2019-08-03,95,6,30,125
"4063","0600-0659",2019-08-04,102,7,33,135
"4064","0600-0659",2019-08-05,111,1,38,149
"4065","0600-0659",2019-08-06,109,2,41,150
"4066","0600-0659",2019-08-07,109,3,40,149
"4067","0600-0659",2019-08-08,112,4,41,153
"4068","0600-0659",2019-08-09,112,5,40,152
"4069","0600-0659",2019-08-10,96,6,32,128
"4070","0600-0659",2019-08-11,99,7,31,130
"4071","0600-0659",2019-08-12,113,1,38,151
"4072","0600-0659",2019-08-13,109,2,37,146
"4073","0600-0659",2019-08-14,107,3,37,144
"4074","0600-0659",2019-08-15,111,4,37,148
"4075","0600-0659",2019-08-16,111,5,37,148
"4076","0600-0659",2019-08-17,94,6,29,123
"4077","0600-0659",2019-08-18,95,7,29,124
"4078","0600-0659",2019-08-19,113,1,38,151
"4079","0600-0659",2019-08-20,102,2,35,137
"4080","0600-0659",2019-08-21,104,3,34,138
"4081","0600-0659",2019-08-22,106,4,35,141
"4082","0600-0659",2019-08-23,106,5,34,140
"4083","0600-0659",2019-08-24,89,6,30,119
"4084","0600-0659",2019-08-25,92,7,27,119
"4085","0600-0659",2019-08-26,108,1,36,144
"4086","0600-0659",2019-08-27,104,2,35,139
"4087","0600-0659",2019-08-28,105,3,36,141
"4088","0600-0659",2019-08-29,108,4,36,144
"4089","0600-0659",2019-08-30,108,5,37,145
"4090","0600-0659",2019-08-31,84,6,26,110
"4091","0700-0759",2019-08-01,111,4,74,185
"4092","0700-0759",2019-08-02,112,5,72,184
"4093","0700-0759",2019-08-03,103,6,67,170
"4094","0700-0759",2019-08-04,110,7,67,177
"4095","0700-0759",2019-08-05,113,1,73,186
"4096","0700-0759",2019-08-06,115,2,72,187
"4097","0700-0759",2019-08-07,118,3,72,190
"4098","0700-0759",2019-08-08,117,4,73,190
"4099","0700-0759",2019-08-09,118,5,73,191
"4100","0700-0759",2019-08-10,98,6,64,162
"4101","0700-0759",2019-08-11,111,7,65,176
"4102","0700-0759",2019-08-12,117,1,74,191
"4103","0700-0759",2019-08-13,115,2,73,188
"4104","0700-0759",2019-08-14,117,3,71,188
"4105","0700-0759",2019-08-15,120,4,73,193
"4106","0700-0759",2019-08-16,120,5,73,193
"4107","0700-0759",2019-08-17,95,6,64,159
"4108","0700-0759",2019-08-18,111,7,65,176
"4109","0700-0759",2019-08-19,119,1,73,192
"4110","0700-0759",2019-08-20,116,2,69,185
"4111","0700-0759",2019-08-21,123,3,67,190
"4112","0700-0759",2019-08-22,123,4,69,192
"4113","0700-0759",2019-08-23,123,5,71,194
"4114","0700-0759",2019-08-24,98,6,61,159
"4115","0700-0759",2019-08-25,113,7,63,176
"4116","0700-0759",2019-08-26,122,1,70,192
"4117","0700-0759",2019-08-27,118,2,66,184
"4118","0700-0759",2019-08-28,117,3,67,184
"4119","0700-0759",2019-08-29,120,4,69,189
"4120","0700-0759",2019-08-30,121,5,69,190
"4121","0700-0759",2019-08-31,89,6,55,144
"4122","0800-0859",2019-08-01,95,4,83,178
"4123","0800-0859",2019-08-02,95,5,82,177
"4124","0800-0859",2019-08-03,83,6,63,146
"4125","0800-0859",2019-08-04,90,7,75,165
"4126","0800-0859",2019-08-05,95,1,83,178
"4127","0800-0859",2019-08-06,96,2,84,180
"4128","0800-0859",2019-08-07,94,3,83,177
"4129","0800-0859",2019-08-08,95,4,86,181
"4130","0800-0859",2019-08-09,96,5,85,181
"4131","0800-0859",2019-08-10,89,6,66,155
"4132","0800-0859",2019-08-11,93,7,75,168
"4133","0800-0859",2019-08-12,96,1,82,178
"4134","0800-0859",2019-08-13,97,2,81,178
"4135","0800-0859",2019-08-14,96,3,80,176
"4136","0800-0859",2019-08-15,97,4,83,180
"4137","0800-0859",2019-08-16,98,5,82,180
"4138","0800-0859",2019-08-17,89,6,64,153
"4139","0800-0859",2019-08-18,91,7,70,161
"4140","0800-0859",2019-08-19,98,1,82,180
"4141","0800-0859",2019-08-20,99,2,78,177
"4142","0800-0859",2019-08-21,96,3,84,180
"4143","0800-0859",2019-08-22,98,4,86,184
"4144","0800-0859",2019-08-23,100,5,85,185
"4145","0800-0859",2019-08-24,93,6,65,158
"4146","0800-0859",2019-08-25,100,7,70,170
"4147","0800-0859",2019-08-26,100,1,85,185
"4148","0800-0859",2019-08-27,95,2,83,178
"4149","0800-0859",2019-08-28,94,3,84,178
"4150","0800-0859",2019-08-29,97,4,86,183
"4151","0800-0859",2019-08-30,97,5,85,182
"4152","0800-0859",2019-08-31,90,6,64,154
"4153","0900-0959",2019-08-01,104,4,64,168
"4154","0900-0959",2019-08-02,102,5,66,168
"4155","0900-0959",2019-08-03,91,6,53,144
"4156","0900-0959",2019-08-04,103,7,59,162
"4157","0900-0959",2019-08-05,101,1,66,167
"4158","0900-0959",2019-08-06,105,2,59,164
"4159","0900-0959",2019-08-07,104,3,63,167
"4160","0900-0959",2019-08-08,107,4,62,169
"4161","0900-0959",2019-08-09,104,5,64,168
"4162","0900-0959",2019-08-10,92,6,53,145
"4163","0900-0959",2019-08-11,100,7,60,160
"4164","0900-0959",2019-08-12,100,1,65,165
"4165","0900-0959",2019-08-13,100,2,60,160
"4166","0900-0959",2019-08-14,99,3,62,161
"4167","0900-0959",2019-08-15,102,4,63,165
"4168","0900-0959",2019-08-16,99,5,66,165
"4169","0900-0959",2019-08-17,93,6,54,147
"4170","0900-0959",2019-08-18,96,7,60,156
"4171","0900-0959",2019-08-19,99,1,67,166
"4172","0900-0959",2019-08-20,100,2,61,161
"4173","0900-0959",2019-08-21,99,3,62,161
"4174","0900-0959",2019-08-22,104,4,61,165
"4175","0900-0959",2019-08-23,99,5,64,163
"4176","0900-0959",2019-08-24,93,6,55,148
"4177","0900-0959",2019-08-25,95,7,63,158
"4178","0900-0959",2019-08-26,100,1,63,163
"4179","0900-0959",2019-08-27,99,2,63,162
"4180","0900-0959",2019-08-28,98,3,61,159
"4181","0900-0959",2019-08-29,101,4,64,165
"4182","0900-0959",2019-08-30,97,5,66,163
"4183","0900-0959",2019-08-31,89,6,56,145
"4184","1000-1059",2019-08-01,79,4,64,143
"4185","1000-1059",2019-08-02,78,5,61,139
"4186","1000-1059",2019-08-03,71,6,65,136
"4187","1000-1059",2019-08-04,69,7,69,138
"4188","1000-1059",2019-08-05,78,1,61,139
"4189","1000-1059",2019-08-06,74,2,60,134
"4190","1000-1059",2019-08-07,75,3,59,134
"4191","1000-1059",2019-08-08,77,4,60,137
"4192","1000-1059",2019-08-09,77,5,58,135
"4193","1000-1059",2019-08-10,72,6,61,133
"4194","1000-1059",2019-08-11,75,7,61,136
"4195","1000-1059",2019-08-12,79,1,60,139
"4196","1000-1059",2019-08-13,76,2,62,138
"4197","1000-1059",2019-08-14,77,3,59,136
"4198","1000-1059",2019-08-15,78,4,61,139
"4199","1000-1059",2019-08-16,80,5,60,140
"4200","1000-1059",2019-08-17,69,6,57,126
"4201","1000-1059",2019-08-18,76,7,61,137
"4202","1000-1059",2019-08-19,79,1,59,138
"4203","1000-1059",2019-08-20,70,2,66,136
"4204","1000-1059",2019-08-21,72,3,64,136
"4205","1000-1059",2019-08-22,72,4,68,140
"4206","1000-1059",2019-08-23,73,5,64,137
"4207","1000-1059",2019-08-24,66,6,66,132
"4208","1000-1059",2019-08-25,77,7,65,142
"4209","1000-1059",2019-08-26,74,1,65,139
"4210","1000-1059",2019-08-27,72,2,63,135
"4211","1000-1059",2019-08-28,73,3,62,135
"4212","1000-1059",2019-08-29,74,4,64,138
"4213","1000-1059",2019-08-30,75,5,62,137
"4214","1000-1059",2019-08-31,63,6,62,125
"4215","1100-1159",2019-08-01,77,4,86,163
"4216","1100-1159",2019-08-02,77,5,88,165
"4217","1100-1159",2019-08-03,71,6,78,149
"4218","1100-1159",2019-08-04,82,7,80,162
"4219","1100-1159",2019-08-05,77,1,89,166
"4220","1100-1159",2019-08-06,77,2,90,167
"4221","1100-1159",2019-08-07,78,3,90,168
"4222","1100-1159",2019-08-08,77,4,92,169
"4223","1100-1159",2019-08-09,76,5,94,170
"4224","1100-1159",2019-08-10,72,6,81,153
"4225","1100-1159",2019-08-11,83,7,87,170
"4226","1100-1159",2019-08-12,74,1,92,166
"4227","1100-1159",2019-08-13,77,2,89,166
"4228","1100-1159",2019-08-14,76,3,90,166
"4229","1100-1159",2019-08-15,75,4,92,167
"4230","1100-1159",2019-08-16,74,5,93,167
"4231","1100-1159",2019-08-17,69,6,80,149
"4232","1100-1159",2019-08-18,82,7,83,165
"4233","1100-1159",2019-08-19,74,1,92,166
"4234","1100-1159",2019-08-20,80,2,87,167
"4235","1100-1159",2019-08-21,78,3,85,163
"4236","1100-1159",2019-08-22,79,4,85,164
"4237","1100-1159",2019-08-23,76,5,87,163
"4238","1100-1159",2019-08-24,72,6,69,141
"4239","1100-1159",2019-08-25,82,7,80,162
"4240","1100-1159",2019-08-26,76,1,88,164
"4241","1100-1159",2019-08-27,83,2,82,165
"4242","1100-1159",2019-08-28,81,3,80,161
"4243","1100-1159",2019-08-29,82,4,82,164
"4244","1100-1159",2019-08-30,82,5,82,164
"4245","1100-1159",2019-08-31,80,6,66,146
"4246","1200-1259",2019-08-01,88,4,84,172
"4247","1200-1259",2019-08-02,87,5,81,168
"4248","1200-1259",2019-08-03,76,6,73,149
"4249","1200-1259",2019-08-04,82,7,85,167
"4250","1200-1259",2019-08-05,89,1,80,169
"4251","1200-1259",2019-08-06,92,2,85,177
"4252","1200-1259",2019-08-07,92,3,86,178
"4253","1200-1259",2019-08-08,95,4,88,183
"4254","1200-1259",2019-08-09,94,5,85,179
"4255","1200-1259",2019-08-10,77,6,71,148
"4256","1200-1259",2019-08-11,82,7,82,164
"4257","1200-1259",2019-08-12,92,1,84,176
"4258","1200-1259",2019-08-13,90,2,84,174
"4259","1200-1259",2019-08-14,90,3,83,173
"4260","1200-1259",2019-08-15,92,4,86,178
"4261","1200-1259",2019-08-16,95,5,84,179
"4262","1200-1259",2019-08-17,74,6,70,144
"4263","1200-1259",2019-08-18,79,7,80,159
"4264","1200-1259",2019-08-19,94,1,84,178
"4265","1200-1259",2019-08-20,87,2,81,168
"4266","1200-1259",2019-08-21,89,3,81,170
"4267","1200-1259",2019-08-22,89,4,84,173
"4268","1200-1259",2019-08-23,94,5,82,176
"4269","1200-1259",2019-08-24,71,6,77,148
"4270","1200-1259",2019-08-25,80,7,83,163
"4271","1200-1259",2019-08-26,95,1,83,178
"4272","1200-1259",2019-08-27,86,2,79,165
"4273","1200-1259",2019-08-28,88,3,79,167
"4274","1200-1259",2019-08-29,88,4,81,169
"4275","1200-1259",2019-08-30,89,5,81,170
"4276","1200-1259",2019-08-31,66,6,68,134
"4277","1300-1359",2019-08-01,80,4,68,148
"4278","1300-1359",2019-08-02,80,5,71,151
"4279","1300-1359",2019-08-03,69,6,62,131
"4280","1300-1359",2019-08-04,75,7,57,132
"4281","1300-1359",2019-08-05,80,1,72,152
"4282","1300-1359",2019-08-06,73,2,59,132
"4283","1300-1359",2019-08-07,76,3,60,136
"4284","1300-1359",2019-08-08,76,4,59,135
"4285","1300-1359",2019-08-09,76,5,62,138
"4286","1300-1359",2019-08-10,68,6,66,134
"4287","1300-1359",2019-08-11,77,7,64,141
"4288","1300-1359",2019-08-12,79,1,60,139
"4289","1300-1359",2019-08-13,77,2,59,136
"4290","1300-1359",2019-08-14,76,3,61,137
"4291","1300-1359",2019-08-15,77,4,58,135
"4292","1300-1359",2019-08-16,78,5,61,139
"4293","1300-1359",2019-08-17,69,6,62,131
"4294","1300-1359",2019-08-18,77,7,64,141
"4295","1300-1359",2019-08-19,78,1,62,140
"4296","1300-1359",2019-08-20,74,2,57,131
"4297","1300-1359",2019-08-21,74,3,60,134
"4298","1300-1359",2019-08-22,77,4,59,136
"4299","1300-1359",2019-08-23,77,5,61,138
"4300","1300-1359",2019-08-24,70,6,59,129
"4301","1300-1359",2019-08-25,78,7,64,142
"4302","1300-1359",2019-08-26,78,1,62,140
"4303","1300-1359",2019-08-27,71,2,59,130
"4304","1300-1359",2019-08-28,71,3,61,132
"4305","1300-1359",2019-08-29,75,4,60,135
"4306","1300-1359",2019-08-30,74,5,63,137
"4307","1300-1359",2019-08-31,66,6,60,126
"4308","1400-1459",2019-08-01,72,4,82,154
"4309","1400-1459",2019-08-02,73,5,81,154
"4310","1400-1459",2019-08-03,65,6,67,132
"4311","1400-1459",2019-08-04,69,7,81,150
"4312","1400-1459",2019-08-05,73,1,81,154
"4313","1400-1459",2019-08-06,70,2,90,160
"4314","1400-1459",2019-08-07,71,3,91,162
"4315","1400-1459",2019-08-08,69,4,90,159
"4316","1400-1459",2019-08-09,70,5,89,159
"4317","1400-1459",2019-08-10,67,6,73,140
"4318","1400-1459",2019-08-11,74,7,76,150
"4319","1400-1459",2019-08-12,69,1,90,159
"4320","1400-1459",2019-08-13,67,2,89,156
"4321","1400-1459",2019-08-14,68,3,89,157
"4322","1400-1459",2019-08-15,67,4,89,156
"4323","1400-1459",2019-08-16,69,5,92,161
"4324","1400-1459",2019-08-17,66,6,73,139
"4325","1400-1459",2019-08-18,73,7,74,147
"4326","1400-1459",2019-08-19,69,1,91,160
"4327","1400-1459",2019-08-20,62,2,85,147
"4328","1400-1459",2019-08-21,62,3,87,149
"4329","1400-1459",2019-08-22,64,4,85,149
"4330","1400-1459",2019-08-23,64,5,88,152
"4331","1400-1459",2019-08-24,64,6,74,138
"4332","1400-1459",2019-08-25,68,7,73,141
"4333","1400-1459",2019-08-26,64,1,88,152
"4334","1400-1459",2019-08-27,64,2,85,149
"4335","1400-1459",2019-08-28,65,3,86,151
"4336","1400-1459",2019-08-29,65,4,85,150
"4337","1400-1459",2019-08-30,65,5,86,151
"4338","1400-1459",2019-08-31,60,6,73,133
"4339","1500-1559",2019-08-01,85,4,72,157
"4340","1500-1559",2019-08-02,86,5,72,158
"4341","1500-1559",2019-08-03,74,6,76,150
"4342","1500-1559",2019-08-04,85,7,71,156
"4343","1500-1559",2019-08-05,87,1,72,159
"4344","1500-1559",2019-08-06,86,2,73,159
"4345","1500-1559",2019-08-07,87,3,73,160
"4346","1500-1559",2019-08-08,86,4,75,161
"4347","1500-1559",2019-08-09,88,5,75,163
"4348","1500-1559",2019-08-10,85,6,69,154
"4349","1500-1559",2019-08-11,83,7,75,158
"4350","1500-1559",2019-08-12,88,1,74,162
"4351","1500-1559",2019-08-13,86,2,72,158
"4352","1500-1559",2019-08-14,85,3,72,157
"4353","1500-1559",2019-08-15,86,4,74,160
"4354","1500-1559",2019-08-16,89,5,73,162
"4355","1500-1559",2019-08-17,88,6,66,154
"4356","1500-1559",2019-08-18,82,7,77,159
"4357","1500-1559",2019-08-19,89,1,73,162
"4358","1500-1559",2019-08-20,88,2,73,161
"4359","1500-1559",2019-08-21,88,3,72,160
"4360","1500-1559",2019-08-22,89,4,76,165
"4361","1500-1559",2019-08-23,91,5,74,165
"4362","1500-1559",2019-08-24,88,6,65,153
"4363","1500-1559",2019-08-25,84,7,79,163
"4364","1500-1559",2019-08-26,91,1,75,166
"4365","1500-1559",2019-08-27,86,2,75,161
"4366","1500-1559",2019-08-28,86,3,75,161
"4367","1500-1559",2019-08-29,85,4,78,163
"4368","1500-1559",2019-08-30,87,5,77,164
"4369","1500-1559",2019-08-31,76,6,70,146
"4370","1600-1659",2019-08-01,71,4,89,160
"4371","1600-1659",2019-08-02,74,5,88,162
"4372","1600-1659",2019-08-03,73,6,76,149
"4373","1600-1659",2019-08-04,71,7,83,154
"4374","1600-1659",2019-08-05,73,1,89,162
"4375","1600-1659",2019-08-06,82,2,84,166
"4376","1600-1659",2019-08-07,83,3,84,167
"4377","1600-1659",2019-08-08,81,4,84,165
"4378","1600-1659",2019-08-09,83,5,83,166
"4379","1600-1659",2019-08-10,73,6,81,154
"4380","1600-1659",2019-08-11,72,7,88,160
"4381","1600-1659",2019-08-12,83,1,84,167
"4382","1600-1659",2019-08-13,81,2,83,164
"4383","1600-1659",2019-08-14,80,3,83,163
"4384","1600-1659",2019-08-15,82,4,85,167
"4385","1600-1659",2019-08-16,82,5,84,166
"4386","1600-1659",2019-08-17,68,6,84,152
"4387","1600-1659",2019-08-18,73,7,86,159
"4388","1600-1659",2019-08-19,79,1,84,163
"4389","1600-1659",2019-08-20,78,2,88,166
"4390","1600-1659",2019-08-21,78,3,87,165
"4391","1600-1659",2019-08-22,80,4,91,171
"4392","1600-1659",2019-08-23,80,5,89,169
"4393","1600-1659",2019-08-24,65,6,84,149
"4394","1600-1659",2019-08-25,70,7,93,163
"4395","1600-1659",2019-08-26,79,1,89,168
"4396","1600-1659",2019-08-27,79,2,88,167
"4397","1600-1659",2019-08-28,80,3,88,168
"4398","1600-1659",2019-08-29,83,4,91,174
"4399","1600-1659",2019-08-30,81,5,89,170
"4400","1600-1659",2019-08-31,61,6,70,131
"4401","1700-1759",2019-08-01,94,4,76,170
"4402","1700-1759",2019-08-02,93,5,75,168
"4403","1700-1759",2019-08-03,78,6,60,138
"4404","1700-1759",2019-08-04,92,7,74,166
"4405","1700-1759",2019-08-05,95,1,75,170
"4406","1700-1759",2019-08-06,89,2,76,165
"4407","1700-1759",2019-08-07,89,3,76,165
"4408","1700-1759",2019-08-08,90,4,77,167
"4409","1700-1759",2019-08-09,88,5,76,164
"4410","1700-1759",2019-08-10,81,6,59,140
"4411","1700-1759",2019-08-11,93,7,73,166
"4412","1700-1759",2019-08-12,91,1,74,165
"4413","1700-1759",2019-08-13,87,2,74,161
"4414","1700-1759",2019-08-14,88,3,73,161
"4415","1700-1759",2019-08-15,90,4,72,162
"4416","1700-1759",2019-08-16,90,5,74,164
"4417","1700-1759",2019-08-17,80,6,58,138
"4418","1700-1759",2019-08-18,94,7,71,165
"4419","1700-1759",2019-08-19,91,1,75,166
"4420","1700-1759",2019-08-20,83,2,72,155
"4421","1700-1759",2019-08-21,83,3,72,155
"4422","1700-1759",2019-08-22,87,4,73,160
"4423","1700-1759",2019-08-23,86,5,73,159
"4424","1700-1759",2019-08-24,74,6,63,137
"4425","1700-1759",2019-08-25,90,7,67,157
"4426","1700-1759",2019-08-26,86,1,73,159
"4427","1700-1759",2019-08-27,83,2,72,155
"4428","1700-1759",2019-08-28,81,3,72,153
"4429","1700-1759",2019-08-29,86,4,72,158
"4430","1700-1759",2019-08-30,86,5,72,158
"4431","1700-1759",2019-08-31,60,6,57,117
"4432","1800-1859",2019-08-01,79,4,90,169
"4433","1800-1859",2019-08-02,78,5,91,169
"4434","1800-1859",2019-08-03,69,6,80,149
"4435","1800-1859",2019-08-04,75,7,91,166
"4436","1800-1859",2019-08-05,78,1,92,170
"4437","1800-1859",2019-08-06,78,2,98,176
"4438","1800-1859",2019-08-07,79,3,96,175
"4439","1800-1859",2019-08-08,80,4,95,175
"4440","1800-1859",2019-08-09,80,5,96,176
"4441","1800-1859",2019-08-10,72,6,87,159
"4442","1800-1859",2019-08-11,74,7,90,164
"4443","1800-1859",2019-08-12,77,1,96,173
"4444","1800-1859",2019-08-13,78,2,96,174
"4445","1800-1859",2019-08-14,78,3,94,172
"4446","1800-1859",2019-08-15,75,4,98,173
"4447","1800-1859",2019-08-16,77,5,97,174
"4448","1800-1859",2019-08-17,74,6,86,160
"4449","1800-1859",2019-08-18,71,7,92,163
"4450","1800-1859",2019-08-19,76,1,96,172
"4451","1800-1859",2019-08-20,74,2,92,166
"4452","1800-1859",2019-08-21,76,3,92,168
"4453","1800-1859",2019-08-22,78,4,93,171
"4454","1800-1859",2019-08-23,79,5,92,171
"4455","1800-1859",2019-08-24,73,6,78,151
"4456","1800-1859",2019-08-25,71,7,87,158
"4457","1800-1859",2019-08-26,80,1,93,173
"4458","1800-1859",2019-08-27,75,2,91,166
"4459","1800-1859",2019-08-28,77,3,92,169
"4460","1800-1859",2019-08-29,78,4,92,170
"4461","1800-1859",2019-08-30,78,5,92,170
"4462","1800-1859",2019-08-31,56,6,69,125
"4463","1900-1959",2019-08-01,94,4,85,179
"4464","1900-1959",2019-08-02,92,5,85,177
"4465","1900-1959",2019-08-03,83,6,82,165
"4466","1900-1959",2019-08-04,92,7,81,173
"4467","1900-1959",2019-08-05,93,1,87,180
"4468","1900-1959",2019-08-06,94,2,79,173
"4469","1900-1959",2019-08-07,94,3,82,176
"4470","1900-1959",2019-08-08,94,4,81,175
"4471","1900-1959",2019-08-09,94,5,81,175
"4472","1900-1959",2019-08-10,74,6,81,155
"4473","1900-1959",2019-08-11,92,7,82,174
"4474","1900-1959",2019-08-12,95,1,82,177
"4475","1900-1959",2019-08-13,92,2,81,173
"4476","1900-1959",2019-08-14,92,3,82,174
"4477","1900-1959",2019-08-15,95,4,79,174
"4478","1900-1959",2019-08-16,93,5,80,173
"4479","1900-1959",2019-08-17,72,6,76,148
"4480","1900-1959",2019-08-18,92,7,81,173
"4481","1900-1959",2019-08-19,92,1,79,171
"4482","1900-1959",2019-08-20,90,2,78,168
"4483","1900-1959",2019-08-21,87,3,77,164
"4484","1900-1959",2019-08-22,91,4,78,169
"4485","1900-1959",2019-08-23,89,5,77,166
"4486","1900-1959",2019-08-24,67,6,76,143
"4487","1900-1959",2019-08-25,88,7,80,168
"4488","1900-1959",2019-08-26,90,1,78,168
"4489","1900-1959",2019-08-27,86,2,78,164
"4490","1900-1959",2019-08-28,86,3,76,162
"4491","1900-1959",2019-08-29,88,4,77,165
"4492","1900-1959",2019-08-30,88,5,79,167
"4493","1900-1959",2019-08-31,60,6,73,133
"4494","2000-2059",2019-08-01,80,4,89,169
"4495","2000-2059",2019-08-02,82,5,90,172
"4496","2000-2059",2019-08-03,72,6,77,149
"4497","2000-2059",2019-08-04,75,7,83,158
"4498","2000-2059",2019-08-05,81,1,90,171
"4499","2000-2059",2019-08-06,78,2,93,171
"4500","2000-2059",2019-08-07,79,3,93,172
"4501","2000-2059",2019-08-08,80,4,93,173
"4502","2000-2059",2019-08-09,81,5,94,175
"4503","2000-2059",2019-08-10,66,6,82,148
"4504","2000-2059",2019-08-11,73,7,87,160
"4505","2000-2059",2019-08-12,78,1,92,170
"4506","2000-2059",2019-08-13,77,2,90,167
"4507","2000-2059",2019-08-14,77,3,89,166
"4508","2000-2059",2019-08-15,77,4,91,168
"4509","2000-2059",2019-08-16,78,5,92,170
"4510","2000-2059",2019-08-17,61,6,88,149
"4511","2000-2059",2019-08-18,70,7,86,156
"4512","2000-2059",2019-08-19,77,1,91,168
"4513","2000-2059",2019-08-20,65,2,87,152
"4514","2000-2059",2019-08-21,66,3,87,153
"4515","2000-2059",2019-08-22,66,4,91,157
"4516","2000-2059",2019-08-23,67,5,95,162
"4517","2000-2059",2019-08-24,50,6,87,137
"4518","2000-2059",2019-08-25,58,7,84,142
"4519","2000-2059",2019-08-26,67,1,94,161
"4520","2000-2059",2019-08-27,61,2,86,147
"4521","2000-2059",2019-08-28,63,3,85,148
"4522","2000-2059",2019-08-29,64,4,91,155
"4523","2000-2059",2019-08-30,63,5,87,150
"4524","2000-2059",2019-08-31,36,6,74,110
"4525","2100-2159",2019-08-01,63,4,104,167
"4526","2100-2159",2019-08-02,64,5,103,167
"4527","2100-2159",2019-08-03,51,6,94,145
"4528","2100-2159",2019-08-04,64,7,104,168
"4529","2100-2159",2019-08-05,66,1,102,168
"4530","2100-2159",2019-08-06,64,2,97,161
"4531","2100-2159",2019-08-07,67,3,100,167
"4532","2100-2159",2019-08-08,66,4,101,167
"4533","2100-2159",2019-08-09,66,5,100,166
"4534","2100-2159",2019-08-10,47,6,93,140
"4535","2100-2159",2019-08-11,61,7,101,162
"4536","2100-2159",2019-08-12,68,1,100,168
"4537","2100-2159",2019-08-13,64,2,98,162
"4538","2100-2159",2019-08-14,64,3,97,161
"4539","2100-2159",2019-08-15,68,4,99,167
"4540","2100-2159",2019-08-16,67,5,98,165
"4541","2100-2159",2019-08-17,45,6,87,132
"4542","2100-2159",2019-08-18,64,7,99,163
"4543","2100-2159",2019-08-19,65,1,96,161
"4544","2100-2159",2019-08-20,59,2,84,143
"4545","2100-2159",2019-08-21,61,3,84,145
"4546","2100-2159",2019-08-22,65,4,88,153
"4547","2100-2159",2019-08-23,67,5,88,155
"4548","2100-2159",2019-08-24,44,6,76,120
"4549","2100-2159",2019-08-25,63,7,88,151
"4550","2100-2159",2019-08-26,68,1,87,155
"4551","2100-2159",2019-08-27,62,2,86,148
"4552","2100-2159",2019-08-28,62,3,88,150
"4553","2100-2159",2019-08-29,65,4,90,155
"4554","2100-2159",2019-08-30,65,5,91,156
"4555","2100-2159",2019-08-31,37,6,69,106
"4556","2200-2259",2019-08-01,59,4,92,151
"4557","2200-2259",2019-08-02,56,5,93,149
"4558","2200-2259",2019-08-03,44,6,83,127
"4559","2200-2259",2019-08-04,61,7,93,154
"4560","2200-2259",2019-08-05,59,1,93,152
"4561","2200-2259",2019-08-06,51,2,96,147
"4562","2200-2259",2019-08-07,51,3,97,148
"4563","2200-2259",2019-08-08,53,4,98,151
"4564","2200-2259",2019-08-09,50,5,99,149
"4565","2200-2259",2019-08-10,40,6,79,119
"4566","2200-2259",2019-08-11,53,7,94,147
"4567","2200-2259",2019-08-12,48,1,95,143
"4568","2200-2259",2019-08-13,46,2,92,138
"4569","2200-2259",2019-08-14,45,3,92,137
"4570","2200-2259",2019-08-15,47,4,94,141
"4571","2200-2259",2019-08-16,44,5,97,141
"4572","2200-2259",2019-08-17,38,6,75,113
"4573","2200-2259",2019-08-18,47,7,87,134
"4574","2200-2259",2019-08-19,45,1,95,140
"4575","2200-2259",2019-08-20,42,2,89,131
"4576","2200-2259",2019-08-21,43,3,90,133
"4577","2200-2259",2019-08-22,46,4,92,138
"4578","2200-2259",2019-08-23,44,5,94,138
"4579","2200-2259",2019-08-24,32,6,71,103
"4580","2200-2259",2019-08-25,47,7,86,133
"4581","2200-2259",2019-08-26,47,1,94,141
"4582","2200-2259",2019-08-27,42,2,87,129
"4583","2200-2259",2019-08-28,44,3,88,132
"4584","2200-2259",2019-08-29,45,4,91,136
"4585","2200-2259",2019-08-30,46,5,90,136
"4586","2200-2259",2019-08-31,27,6,50,77
"4587","2300-2359",2019-08-01,35,4,81,116
"4588","2300-2359",2019-08-02,35,5,83,118
"4589","2300-2359",2019-08-03,31,6,74,105
"4590","2300-2359",2019-08-04,35,7,86,121
"4591","2300-2359",2019-08-05,36,1,85,121
"4592","2300-2359",2019-08-06,33,2,84,117
"4593","2300-2359",2019-08-07,34,3,88,122
"4594","2300-2359",2019-08-08,35,4,86,121
"4595","2300-2359",2019-08-09,35,5,87,122
"4596","2300-2359",2019-08-10,30,6,67,97
"4597","2300-2359",2019-08-11,35,7,81,116
"4598","2300-2359",2019-08-12,34,1,90,124
"4599","2300-2359",2019-08-13,30,2,85,115
"4600","2300-2359",2019-08-14,33,3,86,119
"4601","2300-2359",2019-08-15,33,4,88,121
"4602","2300-2359",2019-08-16,32,5,87,119
"4603","2300-2359",2019-08-17,29,6,65,94
"4604","2300-2359",2019-08-18,32,7,86,118
"4605","2300-2359",2019-08-19,33,1,85,118
"4606","2300-2359",2019-08-20,33,2,82,115
"4607","2300-2359",2019-08-21,33,3,85,118
"4608","2300-2359",2019-08-22,33,4,87,120
"4609","2300-2359",2019-08-23,33,5,86,119
"4610","2300-2359",2019-08-24,29,6,54,83
"4611","2300-2359",2019-08-25,32,7,84,116
"4612","2300-2359",2019-08-26,33,1,90,123
"4613","2300-2359",2019-08-27,29,2,81,110
"4614","2300-2359",2019-08-28,32,3,85,117
"4615","2300-2359",2019-08-29,30,4,85,115
"4616","2300-2359",2019-08-30,31,5,86,117
"4617","2300-2359",2019-08-31,24,6,42,66
"4618","0001-0559",2019-09-01,9,7,50,59
"4619","0001-0559",2019-09-02,19,1,68,87
"4620","0001-0559",2019-09-03,23,2,63,86
"4621","0001-0559",2019-09-04,28,3,64,92
"4622","0001-0559",2019-09-05,26,4,63,89
"4623","0001-0559",2019-09-06,26,5,64,90
"4624","0001-0559",2019-09-07,22,6,40,62
"4625","0001-0559",2019-09-08,20,7,61,81
"4626","0001-0559",2019-09-09,27,1,64,91
"4627","0001-0559",2019-09-10,27,2,60,87
"4628","0001-0559",2019-09-11,27,3,65,92
"4629","0001-0559",2019-09-12,27,4,67,94
"4630","0001-0559",2019-09-13,27,5,68,95
"4631","0001-0559",2019-09-14,21,6,39,60
"4632","0001-0559",2019-09-15,21,7,60,81
"4633","0001-0559",2019-09-16,27,1,64,91
"4634","0001-0559",2019-09-17,27,2,59,86
"4635","0001-0559",2019-09-18,27,3,64,91
"4636","0001-0559",2019-09-19,27,4,66,93
"4637","0001-0559",2019-09-20,27,5,67,94
"4638","0001-0559",2019-09-21,21,6,39,60
"4639","0001-0559",2019-09-22,19,7,60,79
"4640","0001-0559",2019-09-23,27,1,62,89
"4641","0001-0559",2019-09-24,28,2,59,87
"4642","0001-0559",2019-09-25,27,3,65,92
"4643","0001-0559",2019-09-26,27,4,66,93
"4644","0001-0559",2019-09-27,27,5,66,93
"4645","0001-0559",2019-09-28,22,6,39,61
"4646","0001-0559",2019-09-29,19,7,60,79
"4647","0001-0559",2019-09-30,27,1,63,90
"4648","0600-0659",2019-09-01,68,7,21,89
"4649","0600-0659",2019-09-02,104,1,28,132
"4650","0600-0659",2019-09-03,99,2,30,129
"4651","0600-0659",2019-09-04,92,3,34,126
"4652","0600-0659",2019-09-05,98,4,33,131
"4653","0600-0659",2019-09-06,100,5,34,134
"4654","0600-0659",2019-09-07,89,6,30,119
"4655","0600-0659",2019-09-08,91,7,29,120
"4656","0600-0659",2019-09-09,106,1,34,140
"4657","0600-0659",2019-09-10,95,2,30,125
"4658","0600-0659",2019-09-11,92,3,34,126
"4659","0600-0659",2019-09-12,101,4,34,135
"4660","0600-0659",2019-09-13,103,5,35,138
"4661","0600-0659",2019-09-14,91,6,30,121
"4662","0600-0659",2019-09-15,88,7,30,118
"4663","0600-0659",2019-09-16,104,1,33,137
"4664","0600-0659",2019-09-17,95,2,30,125
"4665","0600-0659",2019-09-18,92,3,37,129
"4666","0600-0659",2019-09-19,101,4,34,135
"4667","0600-0659",2019-09-20,103,5,35,138
"4668","0600-0659",2019-09-21,92,6,30,122
"4669","0600-0659",2019-09-22,89,7,29,118
"4670","0600-0659",2019-09-23,104,1,34,138
"4671","0600-0659",2019-09-24,95,2,31,126
"4672","0600-0659",2019-09-25,92,3,35,127
"4673","0600-0659",2019-09-26,101,4,34,135
"4674","0600-0659",2019-09-27,103,5,36,139
"4675","0600-0659",2019-09-28,92,6,32,124
"4676","0600-0659",2019-09-29,89,7,30,119
"4677","0600-0659",2019-09-30,105,1,35,140
"4678","0700-0759",2019-09-01,87,7,45,132
"4679","0700-0759",2019-09-02,109,1,63,172
"4680","0700-0759",2019-09-03,109,2,60,169
"4681","0700-0759",2019-09-04,106,3,58,164
"4682","0700-0759",2019-09-05,109,4,58,167
"4683","0700-0759",2019-09-06,110,5,57,167
"4684","0700-0759",2019-09-07,92,6,51,143
"4685","0700-0759",2019-09-08,93,7,54,147
"4686","0700-0759",2019-09-09,112,1,59,171
"4687","0700-0759",2019-09-10,106,2,58,164
"4688","0700-0759",2019-09-11,104,3,60,164
"4689","0700-0759",2019-09-12,114,4,61,175
"4690","0700-0759",2019-09-13,115,5,60,175
"4691","0700-0759",2019-09-14,93,6,51,144
"4692","0700-0759",2019-09-15,94,7,55,149
"4693","0700-0759",2019-09-16,114,1,59,173
"4694","0700-0759",2019-09-17,108,2,58,166
"4695","0700-0759",2019-09-18,104,3,59,163
"4696","0700-0759",2019-09-19,116,4,61,177
"4697","0700-0759",2019-09-20,114,5,60,174
"4698","0700-0759",2019-09-21,91,6,52,143
"4699","0700-0759",2019-09-22,94,7,54,148
"4700","0700-0759",2019-09-23,113,1,59,172
"4701","0700-0759",2019-09-24,107,2,58,165
"4702","0700-0759",2019-09-25,105,3,59,164
"4703","0700-0759",2019-09-26,114,4,62,176
"4704","0700-0759",2019-09-27,115,5,61,176
"4705","0700-0759",2019-09-28,92,6,52,144
"4706","0700-0759",2019-09-29,94,7,53,147
"4707","0700-0759",2019-09-30,113,1,59,172
"4708","0800-0859",2019-09-01,82,7,55,137
"4709","0800-0859",2019-09-02,92,1,75,167
"4710","0800-0859",2019-09-03,90,2,80,170
"4711","0800-0859",2019-09-04,95,3,77,172
"4712","0800-0859",2019-09-05,97,4,82,179
"4713","0800-0859",2019-09-06,97,5,82,179
"4714","0800-0859",2019-09-07,87,6,71,158
"4715","0800-0859",2019-09-08,99,7,65,164
"4716","0800-0859",2019-09-09,96,1,83,179
"4717","0800-0859",2019-09-10,94,2,73,167
"4718","0800-0859",2019-09-11,92,3,73,165
"4719","0800-0859",2019-09-12,96,4,83,179
"4720","0800-0859",2019-09-13,95,5,84,179
"4721","0800-0859",2019-09-14,89,6,71,160
"4722","0800-0859",2019-09-15,100,7,63,163
"4723","0800-0859",2019-09-16,96,1,82,178
"4724","0800-0859",2019-09-17,92,2,74,166
"4725","0800-0859",2019-09-18,92,3,74,166
"4726","0800-0859",2019-09-19,95,4,83,178
"4727","0800-0859",2019-09-20,96,5,83,179
"4728","0800-0859",2019-09-21,89,6,70,159
"4729","0800-0859",2019-09-22,101,7,64,165
"4730","0800-0859",2019-09-23,96,1,82,178
"4731","0800-0859",2019-09-24,93,2,74,167
"4732","0800-0859",2019-09-25,91,3,74,165
"4733","0800-0859",2019-09-26,97,4,82,179
"4734","0800-0859",2019-09-27,96,5,82,178
"4735","0800-0859",2019-09-28,89,6,70,159
"4736","0800-0859",2019-09-29,101,7,63,164
"4737","0800-0859",2019-09-30,97,1,81,178
"4738","0900-0959",2019-09-01,91,7,48,139
"4739","0900-0959",2019-09-02,93,1,67,160
"4740","0900-0959",2019-09-03,93,2,61,154
"4741","0900-0959",2019-09-04,84,3,58,142
"4742","0900-0959",2019-09-05,92,4,60,152
"4743","0900-0959",2019-09-06,91,5,62,153
"4744","0900-0959",2019-09-07,87,6,53,140
"4745","0900-0959",2019-09-08,86,7,60,146
"4746","0900-0959",2019-09-09,96,1,66,162
"4747","0900-0959",2019-09-10,86,2,62,148
"4748","0900-0959",2019-09-11,91,3,59,150
"4749","0900-0959",2019-09-12,97,4,66,163
"4750","0900-0959",2019-09-13,98,5,65,163
"4751","0900-0959",2019-09-14,85,6,55,140
"4752","0900-0959",2019-09-15,88,7,60,148
"4753","0900-0959",2019-09-16,95,1,66,161
"4754","0900-0959",2019-09-17,86,2,63,149
"4755","0900-0959",2019-09-18,91,3,58,149
"4756","0900-0959",2019-09-19,97,4,65,162
"4757","0900-0959",2019-09-20,96,5,65,161
"4758","0900-0959",2019-09-21,84,6,54,138
"4759","0900-0959",2019-09-22,86,7,60,146
"4760","0900-0959",2019-09-23,96,1,65,161
"4761","0900-0959",2019-09-24,86,2,62,148
"4762","0900-0959",2019-09-25,91,3,58,149
"4763","0900-0959",2019-09-26,96,4,64,160
"4764","0900-0959",2019-09-27,95,5,65,160
"4765","0900-0959",2019-09-28,84,6,54,138
"4766","0900-0959",2019-09-29,84,7,60,144
"4767","0900-0959",2019-09-30,95,1,65,160
"4768","1000-1059",2019-09-01,70,7,59,129
"4769","1000-1059",2019-09-02,75,1,59,134
"4770","1000-1059",2019-09-03,69,2,57,126
"4771","1000-1059",2019-09-04,70,3,59,129
"4772","1000-1059",2019-09-05,69,4,59,128
"4773","1000-1059",2019-09-06,71,5,62,133
"4774","1000-1059",2019-09-07,64,6,60,124
"4775","1000-1059",2019-09-08,73,7,57,130
"4776","1000-1059",2019-09-09,69,1,62,131
"4777","1000-1059",2019-09-10,65,2,57,122
"4778","1000-1059",2019-09-11,67,3,57,124
"4779","1000-1059",2019-09-12,72,4,59,131
"4780","1000-1059",2019-09-13,71,5,63,134
"4781","1000-1059",2019-09-14,65,6,61,126
"4782","1000-1059",2019-09-15,74,7,59,133
"4783","1000-1059",2019-09-16,71,1,61,132
"4784","1000-1059",2019-09-17,67,2,55,122
"4785","1000-1059",2019-09-18,67,3,57,124
"4786","1000-1059",2019-09-19,71,4,60,131
"4787","1000-1059",2019-09-20,71,5,62,133
"4788","1000-1059",2019-09-21,67,6,59,126
"4789","1000-1059",2019-09-22,76,7,59,135
"4790","1000-1059",2019-09-23,70,1,62,132
"4791","1000-1059",2019-09-24,69,2,56,125
"4792","1000-1059",2019-09-25,67,3,57,124
"4793","1000-1059",2019-09-26,73,4,61,134
"4794","1000-1059",2019-09-27,73,5,62,135
"4795","1000-1059",2019-09-28,65,6,59,124
"4796","1000-1059",2019-09-29,76,7,58,134
"4797","1000-1059",2019-09-30,72,1,62,134
"4798","1100-1159",2019-09-01,80,7,66,146
"4799","1100-1159",2019-09-02,80,1,76,156
"4800","1100-1159",2019-09-03,82,2,71,153
"4801","1100-1159",2019-09-04,79,3,66,145
"4802","1100-1159",2019-09-05,80,4,69,149
"4803","1100-1159",2019-09-06,79,5,67,146
"4804","1100-1159",2019-09-07,75,6,61,136
"4805","1100-1159",2019-09-08,79,7,76,155
"4806","1100-1159",2019-09-09,81,1,70,151
"4807","1100-1159",2019-09-10,78,2,69,147
"4808","1100-1159",2019-09-11,81,3,67,148
"4809","1100-1159",2019-09-12,79,4,73,152
"4810","1100-1159",2019-09-13,79,5,70,149
"4811","1100-1159",2019-09-14,76,6,61,137
"4812","1100-1159",2019-09-15,81,7,71,152
"4813","1100-1159",2019-09-16,82,1,71,153
"4814","1100-1159",2019-09-17,78,2,70,148
"4815","1100-1159",2019-09-18,81,3,67,148
"4816","1100-1159",2019-09-19,80,4,72,152
"4817","1100-1159",2019-09-20,79,5,70,149
"4818","1100-1159",2019-09-21,75,6,62,137
"4819","1100-1159",2019-09-22,80,7,72,152
"4820","1100-1159",2019-09-23,81,1,70,151
"4821","1100-1159",2019-09-24,78,2,70,148
"4822","1100-1159",2019-09-25,81,3,67,148
"4823","1100-1159",2019-09-26,81,4,71,152
"4824","1100-1159",2019-09-27,81,5,70,151
"4825","1100-1159",2019-09-28,76,6,62,138
"4826","1100-1159",2019-09-29,80,7,71,151
"4827","1100-1159",2019-09-30,82,1,70,152
"4828","1200-1259",2019-09-01,68,7,70,138
"4829","1200-1259",2019-09-02,84,1,79,163
"4830","1200-1259",2019-09-03,78,2,77,155
"4831","1200-1259",2019-09-04,74,3,71,145
"4832","1200-1259",2019-09-05,79,4,74,153
"4833","1200-1259",2019-09-06,82,5,74,156
"4834","1200-1259",2019-09-07,67,6,69,136
"4835","1200-1259",2019-09-08,79,7,73,152
"4836","1200-1259",2019-09-09,83,1,74,157
"4837","1200-1259",2019-09-10,79,2,71,150
"4838","1200-1259",2019-09-11,77,3,73,150
"4839","1200-1259",2019-09-12,82,4,74,156
"4840","1200-1259",2019-09-13,83,5,74,157
"4841","1200-1259",2019-09-14,68,6,70,138
"4842","1200-1259",2019-09-15,78,7,75,153
"4843","1200-1259",2019-09-16,83,1,74,157
"4844","1200-1259",2019-09-17,78,2,70,148
"4845","1200-1259",2019-09-18,77,3,73,150
"4846","1200-1259",2019-09-19,82,4,75,157
"4847","1200-1259",2019-09-20,82,5,73,155
"4848","1200-1259",2019-09-21,68,6,70,138
"4849","1200-1259",2019-09-22,77,7,75,152
"4850","1200-1259",2019-09-23,83,1,74,157
"4851","1200-1259",2019-09-24,78,2,70,148
"4852","1200-1259",2019-09-25,77,3,72,149
"4853","1200-1259",2019-09-26,82,4,78,160
"4854","1200-1259",2019-09-27,83,5,77,160
"4855","1200-1259",2019-09-28,68,6,71,139
"4856","1200-1259",2019-09-29,78,7,78,156
"4857","1200-1259",2019-09-30,83,1,78,161
"4858","1300-1359",2019-09-01,73,7,62,135
"4859","1300-1359",2019-09-02,72,1,61,133
"4860","1300-1359",2019-09-03,73,2,66,139
"4861","1300-1359",2019-09-04,75,3,70,145
"4862","1300-1359",2019-09-05,76,4,72,148
"4863","1300-1359",2019-09-06,76,5,74,150
"4864","1300-1359",2019-09-07,65,6,63,128
"4865","1300-1359",2019-09-08,75,7,64,139
"4866","1300-1359",2019-09-09,77,1,74,151
"4867","1300-1359",2019-09-10,76,2,68,144
"4868","1300-1359",2019-09-11,77,3,70,147
"4869","1300-1359",2019-09-12,78,4,72,150
"4870","1300-1359",2019-09-13,78,5,74,152
"4871","1300-1359",2019-09-14,66,6,63,129
"4872","1300-1359",2019-09-15,75,7,66,141
"4873","1300-1359",2019-09-16,77,1,74,151
"4874","1300-1359",2019-09-17,76,2,67,143
"4875","1300-1359",2019-09-18,77,3,70,147
"4876","1300-1359",2019-09-19,78,4,72,150
"4877","1300-1359",2019-09-20,76,5,73,149
"4878","1300-1359",2019-09-21,66,6,63,129
"4879","1300-1359",2019-09-22,76,7,66,142
"4880","1300-1359",2019-09-23,77,1,74,151
"4881","1300-1359",2019-09-24,76,2,70,146
"4882","1300-1359",2019-09-25,77,3,71,148
"4883","1300-1359",2019-09-26,79,4,72,151
"4884","1300-1359",2019-09-27,78,5,74,152
"4885","1300-1359",2019-09-28,67,6,61,128
"4886","1300-1359",2019-09-29,76,7,65,141
"4887","1300-1359",2019-09-30,78,1,74,152
"4888","1400-1459",2019-09-01,55,7,64,119
"4889","1400-1459",2019-09-02,57,1,77,134
"4890","1400-1459",2019-09-03,60,2,66,126
"4891","1400-1459",2019-09-04,62,3,64,126
"4892","1400-1459",2019-09-05,65,4,65,130
"4893","1400-1459",2019-09-06,63,5,67,130
"4894","1400-1459",2019-09-07,58,6,68,126
"4895","1400-1459",2019-09-08,64,7,71,135
"4896","1400-1459",2019-09-09,68,1,69,137
"4897","1400-1459",2019-09-10,65,2,63,128
"4898","1400-1459",2019-09-11,66,3,65,131
"4899","1400-1459",2019-09-12,67,4,67,134
"4900","1400-1459",2019-09-13,67,5,70,137
"4901","1400-1459",2019-09-14,59,6,68,127
"4902","1400-1459",2019-09-15,65,7,72,137
"4903","1400-1459",2019-09-16,68,1,69,137
"4904","1400-1459",2019-09-17,65,2,64,129
"4905","1400-1459",2019-09-18,66,3,65,131
"4906","1400-1459",2019-09-19,67,4,67,134
"4907","1400-1459",2019-09-20,67,5,69,136
"4908","1400-1459",2019-09-21,59,6,68,127
"4909","1400-1459",2019-09-22,65,7,70,135
"4910","1400-1459",2019-09-23,68,1,69,137
"4911","1400-1459",2019-09-24,65,2,63,128
"4912","1400-1459",2019-09-25,66,3,65,131
"4913","1400-1459",2019-09-26,67,4,67,134
"4914","1400-1459",2019-09-27,68,5,68,136
"4915","1400-1459",2019-09-28,57,6,68,125
"4916","1400-1459",2019-09-29,65,7,70,135
"4917","1400-1459",2019-09-30,68,1,68,136
"4918","1500-1559",2019-09-01,75,7,69,144
"4919","1500-1559",2019-09-02,88,1,78,166
"4920","1500-1559",2019-09-03,76,2,81,157
"4921","1500-1559",2019-09-04,79,3,80,159
"4922","1500-1559",2019-09-05,74,4,85,159
"4923","1500-1559",2019-09-06,74,5,83,157
"4924","1500-1559",2019-09-07,74,6,66,140
"4925","1500-1559",2019-09-08,81,7,80,161
"4926","1500-1559",2019-09-09,82,1,86,168
"4927","1500-1559",2019-09-10,74,2,82,156
"4928","1500-1559",2019-09-11,78,3,83,161
"4929","1500-1559",2019-09-12,80,4,86,166
"4930","1500-1559",2019-09-13,81,5,84,165
"4931","1500-1559",2019-09-14,78,6,68,146
"4932","1500-1559",2019-09-15,80,7,80,160
"4933","1500-1559",2019-09-16,82,1,87,169
"4934","1500-1559",2019-09-17,74,2,83,157
"4935","1500-1559",2019-09-18,78,3,84,162
"4936","1500-1559",2019-09-19,80,4,87,167
"4937","1500-1559",2019-09-20,82,5,85,167
"4938","1500-1559",2019-09-21,77,6,69,146
"4939","1500-1559",2019-09-22,82,7,82,164
"4940","1500-1559",2019-09-23,82,1,87,169
"4941","1500-1559",2019-09-24,74,2,83,157
"4942","1500-1559",2019-09-25,78,3,84,162
"4943","1500-1559",2019-09-26,80,4,88,168
"4944","1500-1559",2019-09-27,81,5,88,169
"4945","1500-1559",2019-09-28,78,6,69,147
"4946","1500-1559",2019-09-29,80,7,83,163
"4947","1500-1559",2019-09-30,82,1,89,171
"4948","1600-1659",2019-09-01,58,7,80,138
"4949","1600-1659",2019-09-02,73,1,80,153
"4950","1600-1659",2019-09-03,74,2,80,154
"4951","1600-1659",2019-09-04,68,3,81,149
"4952","1600-1659",2019-09-05,71,4,80,151
"4953","1600-1659",2019-09-06,70,5,78,148
"4954","1600-1659",2019-09-07,51,6,67,118
"4955","1600-1659",2019-09-08,66,7,76,142
"4956","1600-1659",2019-09-09,70,1,78,148
"4957","1600-1659",2019-09-10,68,2,76,144
"4958","1600-1659",2019-09-11,70,3,77,147
"4959","1600-1659",2019-09-12,72,4,80,152
"4960","1600-1659",2019-09-13,71,5,78,149
"4961","1600-1659",2019-09-14,52,6,67,119
"4962","1600-1659",2019-09-15,67,7,77,144
"4963","1600-1659",2019-09-16,71,1,78,149
"4964","1600-1659",2019-09-17,69,2,77,146
"4965","1600-1659",2019-09-18,71,3,77,148
"4966","1600-1659",2019-09-19,72,4,80,152
"4967","1600-1659",2019-09-20,72,5,79,151
"4968","1600-1659",2019-09-21,53,6,67,120
"4969","1600-1659",2019-09-22,67,7,77,144
"4970","1600-1659",2019-09-23,71,1,78,149
"4971","1600-1659",2019-09-24,69,2,76,145
"4972","1600-1659",2019-09-25,71,3,77,148
"4973","1600-1659",2019-09-26,73,4,80,153
"4974","1600-1659",2019-09-27,72,5,78,150
"4975","1600-1659",2019-09-28,52,6,67,119
"4976","1600-1659",2019-09-29,66,7,76,142
"4977","1600-1659",2019-09-30,72,1,78,150
"4978","1700-1759",2019-09-01,67,7,50,117
"4979","1700-1759",2019-09-02,79,1,70,149
"4980","1700-1759",2019-09-03,77,2,69,146
"4981","1700-1759",2019-09-04,74,3,68,142
"4982","1700-1759",2019-09-05,77,4,72,149
"4983","1700-1759",2019-09-06,76,5,69,145
"4984","1700-1759",2019-09-07,66,6,54,120
"4985","1700-1759",2019-09-08,87,7,73,160
"4986","1700-1759",2019-09-09,88,1,77,165
"4987","1700-1759",2019-09-10,87,2,74,161
"4988","1700-1759",2019-09-11,86,3,74,160
"4989","1700-1759",2019-09-12,88,4,78,166
"4990","1700-1759",2019-09-13,88,5,78,166
"4991","1700-1759",2019-09-14,68,6,58,126
"4992","1700-1759",2019-09-15,88,7,73,161
"4993","1700-1759",2019-09-16,88,1,77,165
"4994","1700-1759",2019-09-17,87,2,72,159
"4995","1700-1759",2019-09-18,86,3,74,160
"4996","1700-1759",2019-09-19,89,4,78,167
"4997","1700-1759",2019-09-20,88,5,76,164
"4998","1700-1759",2019-09-21,68,6,58,126
"4999","1700-1759",2019-09-22,88,7,72,160
"5000","1700-1759",2019-09-23,88,1,77,165
"5001","1700-1759",2019-09-24,87,2,74,161
"5002","1700-1759",2019-09-25,86,3,74,160
"5003","1700-1759",2019-09-26,89,4,78,167
"5004","1700-1759",2019-09-27,89,5,77,166
"5005","1700-1759",2019-09-28,69,6,58,127
"5006","1700-1759",2019-09-29,89,7,73,162
"5007","1700-1759",2019-09-30,88,1,77,165
"5008","1800-1859",2019-09-01,56,7,80,136
"5009","1800-1859",2019-09-02,68,1,92,160
"5010","1800-1859",2019-09-03,73,2,89,162
"5011","1800-1859",2019-09-04,73,3,90,163
"5012","1800-1859",2019-09-05,73,4,91,164
"5013","1800-1859",2019-09-06,75,5,90,165
"5014","1800-1859",2019-09-07,62,6,81,143
"5015","1800-1859",2019-09-08,71,7,92,163
"5016","1800-1859",2019-09-09,81,1,97,178
"5017","1800-1859",2019-09-10,76,2,95,171
"5018","1800-1859",2019-09-11,79,3,96,175
"5019","1800-1859",2019-09-12,80,4,98,178
"5020","1800-1859",2019-09-13,82,5,97,179
"5021","1800-1859",2019-09-14,64,6,81,145
"5022","1800-1859",2019-09-15,72,7,93,165
"5023","1800-1859",2019-09-16,82,1,97,179
"5024","1800-1859",2019-09-17,76,2,96,172
"5025","1800-1859",2019-09-18,79,3,96,175
"5026","1800-1859",2019-09-19,80,4,98,178
"5027","1800-1859",2019-09-20,82,5,97,179
"5028","1800-1859",2019-09-21,64,6,81,145
"5029","1800-1859",2019-09-22,72,7,94,166
"5030","1800-1859",2019-09-23,82,1,97,179
"5031","1800-1859",2019-09-24,76,2,95,171
"5032","1800-1859",2019-09-25,79,3,96,175
"5033","1800-1859",2019-09-26,80,4,98,178
"5034","1800-1859",2019-09-27,82,5,96,178
"5035","1800-1859",2019-09-28,65,6,81,146
"5036","1800-1859",2019-09-29,72,7,92,164
"5037","1800-1859",2019-09-30,82,1,96,178
"5038","1900-1959",2019-09-01,75,7,71,146
"5039","1900-1959",2019-09-02,90,1,72,162
"5040","1900-1959",2019-09-03,83,2,76,159
"5041","1900-1959",2019-09-04,82,3,72,154
"5042","1900-1959",2019-09-05,84,4,73,157
"5043","1900-1959",2019-09-06,84,5,72,156
"5044","1900-1959",2019-09-07,61,6,65,126
"5045","1900-1959",2019-09-08,81,7,75,156
"5046","1900-1959",2019-09-09,86,1,77,163
"5047","1900-1959",2019-09-10,81,2,80,161
"5048","1900-1959",2019-09-11,83,3,80,163
"5049","1900-1959",2019-09-12,86,4,78,164
"5050","1900-1959",2019-09-13,86,5,79,165
"5051","1900-1959",2019-09-14,62,6,70,132
"5052","1900-1959",2019-09-15,82,7,79,161
"5053","1900-1959",2019-09-16,86,1,80,166
"5054","1900-1959",2019-09-17,82,2,82,164
"5055","1900-1959",2019-09-18,84,3,80,164
"5056","1900-1959",2019-09-19,86,4,79,165
"5057","1900-1959",2019-09-20,85,5,79,164
"5058","1900-1959",2019-09-21,60,6,69,129
"5059","1900-1959",2019-09-22,81,7,79,160
"5060","1900-1959",2019-09-23,86,1,79,165
"5061","1900-1959",2019-09-24,82,2,83,165
"5062","1900-1959",2019-09-25,84,3,80,164
"5063","1900-1959",2019-09-26,85,4,80,165
"5064","1900-1959",2019-09-27,84,5,80,164
"5065","1900-1959",2019-09-28,60,6,71,131
"5066","1900-1959",2019-09-29,81,7,79,160
"5067","1900-1959",2019-09-30,85,1,80,165
"5068","2000-2059",2019-09-01,45,7,74,119
"5069","2000-2059",2019-09-02,63,1,85,148
"5070","2000-2059",2019-09-03,57,2,80,137
"5071","2000-2059",2019-09-04,54,3,81,135
"5072","2000-2059",2019-09-05,54,4,85,139
"5073","2000-2059",2019-09-06,54,5,87,141
"5074","2000-2059",2019-09-07,40,6,83,123
"5075","2000-2059",2019-09-08,53,7,85,138
"5076","2000-2059",2019-09-09,55,1,87,142
"5077","2000-2059",2019-09-10,53,2,81,134
"5078","2000-2059",2019-09-11,57,3,80,137
"5079","2000-2059",2019-09-12,58,4,87,145
"5080","2000-2059",2019-09-13,58,5,88,146
"5081","2000-2059",2019-09-14,41,6,84,125
"5082","2000-2059",2019-09-15,56,7,83,139
"5083","2000-2059",2019-09-16,57,1,88,145
"5084","2000-2059",2019-09-17,54,2,81,135
"5085","2000-2059",2019-09-18,57,3,81,138
"5086","2000-2059",2019-09-19,58,4,87,145
"5087","2000-2059",2019-09-20,59,5,89,148
"5088","2000-2059",2019-09-21,40,6,83,123
"5089","2000-2059",2019-09-22,55,7,83,138
"5090","2000-2059",2019-09-23,57,1,88,145
"5091","2000-2059",2019-09-24,54,2,80,134
"5092","2000-2059",2019-09-25,57,3,81,138
"5093","2000-2059",2019-09-26,59,4,87,146
"5094","2000-2059",2019-09-27,59,5,89,148
"5095","2000-2059",2019-09-28,41,6,84,125
"5096","2000-2059",2019-09-29,55,7,84,139
"5097","2000-2059",2019-09-30,57,1,89,146
"5098","2100-2159",2019-09-01,37,7,75,112
"5099","2100-2159",2019-09-02,65,1,91,156
"5100","2100-2159",2019-09-03,59,2,89,148
"5101","2100-2159",2019-09-04,65,3,87,152
"5102","2100-2159",2019-09-05,66,4,88,154
"5103","2100-2159",2019-09-06,66,5,89,155
"5104","2100-2159",2019-09-07,45,6,75,120
"5105","2100-2159",2019-09-08,62,7,87,149
"5106","2100-2159",2019-09-09,68,1,93,161
"5107","2100-2159",2019-09-10,64,2,90,154
"5108","2100-2159",2019-09-11,65,3,93,158
"5109","2100-2159",2019-09-12,67,4,92,159
"5110","2100-2159",2019-09-13,67,5,93,160
"5111","2100-2159",2019-09-14,44,6,74,118
"5112","2100-2159",2019-09-15,61,7,88,149
"5113","2100-2159",2019-09-16,67,1,93,160
"5114","2100-2159",2019-09-17,63,2,90,153
"5115","2100-2159",2019-09-18,64,3,93,157
"5116","2100-2159",2019-09-19,66,4,92,158
"5117","2100-2159",2019-09-20,66,5,93,159
"5118","2100-2159",2019-09-21,44,6,74,118
"5119","2100-2159",2019-09-22,61,7,88,149
"5120","2100-2159",2019-09-23,67,1,93,160
"5121","2100-2159",2019-09-24,63,2,90,153
"5122","2100-2159",2019-09-25,64,3,93,157
"5123","2100-2159",2019-09-26,66,4,91,157
"5124","2100-2159",2019-09-27,67,5,92,159
"5125","2100-2159",2019-09-28,44,6,73,117
"5126","2100-2159",2019-09-29,62,7,87,149
"5127","2100-2159",2019-09-30,68,1,92,160
"5128","2200-2259",2019-09-01,31,7,65,96
"5129","2200-2259",2019-09-02,43,1,84,127
"5130","2200-2259",2019-09-03,37,2,76,113
"5131","2200-2259",2019-09-04,37,3,81,118
"5132","2200-2259",2019-09-05,42,4,81,123
"5133","2200-2259",2019-09-06,42,5,82,124
"5134","2200-2259",2019-09-07,28,6,58,86
"5135","2200-2259",2019-09-08,46,7,81,127
"5136","2200-2259",2019-09-09,42,1,86,128
"5137","2200-2259",2019-09-10,37,2,78,115
"5138","2200-2259",2019-09-11,42,3,83,125
"5139","2200-2259",2019-09-12,45,4,86,131
"5140","2200-2259",2019-09-13,45,5,88,133
"5141","2200-2259",2019-09-14,28,6,58,86
"5142","2200-2259",2019-09-15,46,7,84,130
"5143","2200-2259",2019-09-16,42,1,87,129
"5144","2200-2259",2019-09-17,37,2,79,116
"5145","2200-2259",2019-09-18,43,3,84,127
"5146","2200-2259",2019-09-19,45,4,86,131
"5147","2200-2259",2019-09-20,45,5,87,132
"5148","2200-2259",2019-09-21,28,6,58,86
"5149","2200-2259",2019-09-22,46,7,82,128
"5150","2200-2259",2019-09-23,42,1,87,129
"5151","2200-2259",2019-09-24,37,2,79,116
"5152","2200-2259",2019-09-25,42,3,84,126
"5153","2200-2259",2019-09-26,45,4,87,132
"5154","2200-2259",2019-09-27,45,5,87,132
"5155","2200-2259",2019-09-28,28,6,59,87
"5156","2200-2259",2019-09-29,47,7,84,131
"5157","2200-2259",2019-09-30,42,1,88,130
"5158","2300-2359",2019-09-01,29,7,52,81
"5159","2300-2359",2019-09-02,31,1,80,111
"5160","2300-2359",2019-09-03,26,2,67,93
"5161","2300-2359",2019-09-04,26,3,62,88
"5162","2300-2359",2019-09-05,20,4,62,82
"5163","2300-2359",2019-09-06,21,5,64,85
"5164","2300-2359",2019-09-07,19,6,37,56
"5165","2300-2359",2019-09-08,24,7,71,95
"5166","2300-2359",2019-09-09,19,1,70,89
"5167","2300-2359",2019-09-10,19,2,63,82
"5168","2300-2359",2019-09-11,23,3,68,91
"5169","2300-2359",2019-09-12,22,4,70,92
"5170","2300-2359",2019-09-13,23,5,69,92
"5171","2300-2359",2019-09-14,19,6,40,59
"5172","2300-2359",2019-09-15,24,7,72,96
"5173","2300-2359",2019-09-16,19,1,71,90
"5174","2300-2359",2019-09-17,20,2,64,84
"5175","2300-2359",2019-09-18,25,3,68,93
"5176","2300-2359",2019-09-19,22,4,70,92
"5177","2300-2359",2019-09-20,23,5,71,94
"5178","2300-2359",2019-09-21,19,6,39,58
"5179","2300-2359",2019-09-22,24,7,73,97
"5180","2300-2359",2019-09-23,18,1,71,89
"5181","2300-2359",2019-09-24,20,2,64,84
"5182","2300-2359",2019-09-25,25,3,68,93
"5183","2300-2359",2019-09-26,22,4,70,92
"5184","2300-2359",2019-09-27,22,5,72,94
"5185","2300-2359",2019-09-28,19,6,38,57
"5186","2300-2359",2019-09-29,24,7,72,96
"5187","2300-2359",2019-09-30,19,1,71,90
"5188","0001-0559",2019-10-01,25,2,62,87
"5189","0001-0559",2019-10-02,27,3,69,96
"5190","0001-0559",2019-10-03,27,4,68,95
"5191","0001-0559",2019-10-04,28,5,70,98
"5192","0001-0559",2019-10-05,21,6,42,63
"5193","0001-0559",2019-10-06,18,7,74,92
"5194","0001-0559",2019-10-07,25,1,68,93
"5195","0001-0559",2019-10-08,25,2,66,91
"5196","0001-0559",2019-10-09,24,3,71,95
"5197","0001-0559",2019-10-10,25,4,70,95
"5198","0001-0559",2019-10-11,25,5,70,95
"5199","0001-0559",2019-10-12,19,6,43,62
"5200","0001-0559",2019-10-13,18,7,75,93
"5201","0001-0559",2019-10-14,25,1,69,94
"5202","0001-0559",2019-10-15,26,2,67,93
"5203","0001-0559",2019-10-16,24,3,72,96
"5204","0001-0559",2019-10-17,25,4,69,94
"5205","0001-0559",2019-10-18,25,5,70,95
"5206","0001-0559",2019-10-19,19,6,43,62
"5207","0001-0559",2019-10-20,18,7,75,93
"5208","0001-0559",2019-10-21,25,1,69,94
"5209","0001-0559",2019-10-22,26,2,67,93
"5210","0001-0559",2019-10-23,24,3,72,96
"5211","0001-0559",2019-10-24,25,4,70,95
"5212","0001-0559",2019-10-25,25,5,70,95
"5213","0001-0559",2019-10-26,19,6,44,63
"5214","0001-0559",2019-10-27,20,7,72,92
"5215","0001-0559",2019-10-28,25,1,64,89
"5216","0001-0559",2019-10-29,25,2,57,82
"5217","0001-0559",2019-10-30,25,3,62,87
"5218","0001-0559",2019-10-31,24,4,58,82
"5219","0600-0659",2019-10-01,96,2,29,125
"5220","0600-0659",2019-10-02,97,3,33,130
"5221","0600-0659",2019-10-03,105,4,34,139
"5222","0600-0659",2019-10-04,107,5,36,143
"5223","0600-0659",2019-10-05,88,6,25,113
"5224","0600-0659",2019-10-06,88,7,26,114
"5225","0600-0659",2019-10-07,107,1,30,137
"5226","0600-0659",2019-10-08,99,2,26,125
"5227","0600-0659",2019-10-09,96,3,29,125
"5228","0600-0659",2019-10-10,106,4,32,138
"5229","0600-0659",2019-10-11,108,5,33,141
"5230","0600-0659",2019-10-12,89,6,24,113
"5231","0600-0659",2019-10-13,89,7,27,116
"5232","0600-0659",2019-10-14,108,1,29,137
"5233","0600-0659",2019-10-15,99,2,25,124
"5234","0600-0659",2019-10-16,96,3,28,124
"5235","0600-0659",2019-10-17,106,4,32,138
"5236","0600-0659",2019-10-18,108,5,33,141
"5237","0600-0659",2019-10-19,89,6,23,112
"5238","0600-0659",2019-10-20,89,7,26,115
"5239","0600-0659",2019-10-21,108,1,29,137
"5240","0600-0659",2019-10-22,98,2,25,123
"5241","0600-0659",2019-10-23,96,3,28,124
"5242","0600-0659",2019-10-24,107,4,32,139
"5243","0600-0659",2019-10-25,108,5,33,141
"5244","0600-0659",2019-10-26,87,6,22,109
"5245","0600-0659",2019-10-27,88,7,20,108
"5246","0600-0659",2019-10-28,99,1,24,123
"5247","0600-0659",2019-10-29,93,2,24,117
"5248","0600-0659",2019-10-30,85,3,25,110
"5249","0600-0659",2019-10-31,84,4,23,107
"5250","0700-0759",2019-10-01,108,2,59,167
"5251","0700-0759",2019-10-02,102,3,62,164
"5252","0700-0759",2019-10-03,113,4,61,174
"5253","0700-0759",2019-10-04,112,5,63,175
"5254","0700-0759",2019-10-05,99,6,58,157
"5255","0700-0759",2019-10-06,96,7,56,152
"5256","0700-0759",2019-10-07,117,1,62,179
"5257","0700-0759",2019-10-08,109,2,59,168
"5258","0700-0759",2019-10-09,107,3,61,168
"5259","0700-0759",2019-10-10,116,4,61,177
"5260","0700-0759",2019-10-11,115,5,62,177
"5261","0700-0759",2019-10-12,99,6,58,157
"5262","0700-0759",2019-10-13,95,7,56,151
"5263","0700-0759",2019-10-14,116,1,60,176
"5264","0700-0759",2019-10-15,109,2,59,168
"5265","0700-0759",2019-10-16,108,3,61,169
"5266","0700-0759",2019-10-17,116,4,61,177
"5267","0700-0759",2019-10-18,116,5,61,177
"5268","0700-0759",2019-10-19,99,6,58,157
"5269","0700-0759",2019-10-20,95,7,56,151
"5270","0700-0759",2019-10-21,116,1,61,177
"5271","0700-0759",2019-10-22,110,2,59,169
"5272","0700-0759",2019-10-23,107,3,61,168
"5273","0700-0759",2019-10-24,116,4,62,178
"5274","0700-0759",2019-10-25,116,5,61,177
"5275","0700-0759",2019-10-26,96,6,59,155
"5276","0700-0759",2019-10-27,89,7,56,145
"5277","0700-0759",2019-10-28,110,1,57,167
"5278","0700-0759",2019-10-29,104,2,56,160
"5279","0700-0759",2019-10-30,95,3,56,151
"5280","0700-0759",2019-10-31,97,4,50,147
"5281","0800-0859",2019-10-01,93,2,71,164
"5282","0800-0859",2019-10-02,90,3,69,159
"5283","0800-0859",2019-10-03,94,4,77,171
"5284","0800-0859",2019-10-04,96,5,75,171
"5285","0800-0859",2019-10-05,88,6,65,153
"5286","0800-0859",2019-10-06,95,7,52,147
"5287","0800-0859",2019-10-07,91,1,74,165
"5288","0800-0859",2019-10-08,88,2,68,156
"5289","0800-0859",2019-10-09,88,3,68,156
"5290","0800-0859",2019-10-10,93,4,76,169
"5291","0800-0859",2019-10-11,93,5,76,169
"5292","0800-0859",2019-10-12,86,6,64,150
"5293","0800-0859",2019-10-13,96,7,52,148
"5294","0800-0859",2019-10-14,91,1,75,166
"5295","0800-0859",2019-10-15,88,2,69,157
"5296","0800-0859",2019-10-16,87,3,68,155
"5297","0800-0859",2019-10-17,94,4,76,170
"5298","0800-0859",2019-10-18,92,5,76,168
"5299","0800-0859",2019-10-19,86,6,64,150
"5300","0800-0859",2019-10-20,95,7,52,147
"5301","0800-0859",2019-10-21,91,1,74,165
"5302","0800-0859",2019-10-22,88,2,69,157
"5303","0800-0859",2019-10-23,88,3,68,156
"5304","0800-0859",2019-10-24,93,4,76,169
"5305","0800-0859",2019-10-25,92,5,76,168
"5306","0800-0859",2019-10-26,85,6,63,148
"5307","0800-0859",2019-10-27,103,7,47,150
"5308","0800-0859",2019-10-28,96,1,67,163
"5309","0800-0859",2019-10-29,93,2,60,153
"5310","0800-0859",2019-10-30,89,3,57,146
"5311","0800-0859",2019-10-31,92,4,65,157
"5312","0900-0959",2019-10-01,85,2,65,150
"5313","0900-0959",2019-10-02,88,3,59,147
"5314","0900-0959",2019-10-03,93,4,66,159
"5315","0900-0959",2019-10-04,92,5,67,159
"5316","0900-0959",2019-10-05,87,6,64,151
"5317","0900-0959",2019-10-06,87,7,70,157
"5318","0900-0959",2019-10-07,94,1,72,166
"5319","0900-0959",2019-10-08,89,2,66,155
"5320","0900-0959",2019-10-09,89,3,64,153
"5321","0900-0959",2019-10-10,95,4,70,165
"5322","0900-0959",2019-10-11,93,5,70,163
"5323","0900-0959",2019-10-12,87,6,64,151
"5324","0900-0959",2019-10-13,86,7,70,156
"5325","0900-0959",2019-10-14,94,1,72,166
"5326","0900-0959",2019-10-15,89,2,66,155
"5327","0900-0959",2019-10-16,89,3,64,153
"5328","0900-0959",2019-10-17,93,4,70,163
"5329","0900-0959",2019-10-18,93,5,71,164
"5330","0900-0959",2019-10-19,87,6,64,151
"5331","0900-0959",2019-10-20,87,7,70,157
"5332","0900-0959",2019-10-21,94,1,72,166
"5333","0900-0959",2019-10-22,89,2,66,155
"5334","0900-0959",2019-10-23,89,3,64,153
"5335","0900-0959",2019-10-24,95,4,70,165
"5336","0900-0959",2019-10-25,93,5,71,164
"5337","0900-0959",2019-10-26,83,6,58,141
"5338","0900-0959",2019-10-27,76,7,72,148
"5339","0900-0959",2019-10-28,84,1,73,157
"5340","0900-0959",2019-10-29,77,2,70,147
"5341","0900-0959",2019-10-30,73,3,62,135
"5342","0900-0959",2019-10-31,82,4,61,143
"5343","1000-1059",2019-10-01,71,2,56,127
"5344","1000-1059",2019-10-02,68,3,63,131
"5345","1000-1059",2019-10-03,74,4,67,141
"5346","1000-1059",2019-10-04,73,5,68,141
"5347","1000-1059",2019-10-05,69,6,55,124
"5348","1000-1059",2019-10-06,76,7,59,135
"5349","1000-1059",2019-10-07,72,1,63,135
"5350","1000-1059",2019-10-08,67,2,59,126
"5351","1000-1059",2019-10-09,69,3,57,126
"5352","1000-1059",2019-10-10,73,4,64,137
"5353","1000-1059",2019-10-11,72,5,64,136
"5354","1000-1059",2019-10-12,69,6,55,124
"5355","1000-1059",2019-10-13,76,7,59,135
"5356","1000-1059",2019-10-14,72,1,63,135
"5357","1000-1059",2019-10-15,67,2,59,126
"5358","1000-1059",2019-10-16,69,3,57,126
"5359","1000-1059",2019-10-17,74,4,64,138
"5360","1000-1059",2019-10-18,72,5,64,136
"5361","1000-1059",2019-10-19,69,6,55,124
"5362","1000-1059",2019-10-20,75,7,59,134
"5363","1000-1059",2019-10-21,72,1,63,135
"5364","1000-1059",2019-10-22,67,2,59,126
"5365","1000-1059",2019-10-23,69,3,57,126
"5366","1000-1059",2019-10-24,73,4,64,137
"5367","1000-1059",2019-10-25,71,5,64,135
"5368","1000-1059",2019-10-26,72,6,55,127
"5369","1000-1059",2019-10-27,84,7,59,143
"5370","1000-1059",2019-10-28,77,1,65,142
"5371","1000-1059",2019-10-29,72,2,59,131
"5372","1000-1059",2019-10-30,69,3,53,122
"5373","1000-1059",2019-10-31,72,4,57,129
"5374","1100-1159",2019-10-01,79,2,70,149
"5375","1100-1159",2019-10-02,80,3,63,143
"5376","1100-1159",2019-10-03,81,4,70,151
"5377","1100-1159",2019-10-04,83,5,70,153
"5378","1100-1159",2019-10-05,69,6,71,140
"5379","1100-1159",2019-10-06,79,7,74,153
"5380","1100-1159",2019-10-07,81,1,75,156
"5381","1100-1159",2019-10-08,78,2,75,153
"5382","1100-1159",2019-10-09,78,3,72,150
"5383","1100-1159",2019-10-10,81,4,77,158
"5384","1100-1159",2019-10-11,81,5,75,156
"5385","1100-1159",2019-10-12,70,6,71,141
"5386","1100-1159",2019-10-13,79,7,75,154
"5387","1100-1159",2019-10-14,81,1,76,157
"5388","1100-1159",2019-10-15,78,2,75,153
"5389","1100-1159",2019-10-16,78,3,72,150
"5390","1100-1159",2019-10-17,79,4,76,155
"5391","1100-1159",2019-10-18,80,5,76,156
"5392","1100-1159",2019-10-19,70,6,71,141
"5393","1100-1159",2019-10-20,80,7,75,155
"5394","1100-1159",2019-10-21,81,1,76,157
"5395","1100-1159",2019-10-22,78,2,75,153
"5396","1100-1159",2019-10-23,78,3,72,150
"5397","1100-1159",2019-10-24,81,4,77,158
"5398","1100-1159",2019-10-25,81,5,75,156
"5399","1100-1159",2019-10-26,70,6,71,141
"5400","1100-1159",2019-10-27,75,7,76,151
"5401","1100-1159",2019-10-28,76,1,74,150
"5402","1100-1159",2019-10-29,73,2,73,146
"5403","1100-1159",2019-10-30,76,3,68,144
"5404","1100-1159",2019-10-31,77,4,74,151
"5405","1200-1259",2019-10-01,78,2,71,149
"5406","1200-1259",2019-10-02,81,3,72,153
"5407","1200-1259",2019-10-03,88,4,74,162
"5408","1200-1259",2019-10-04,88,5,73,161
"5409","1200-1259",2019-10-05,75,6,59,134
"5410","1200-1259",2019-10-06,78,7,69,147
"5411","1200-1259",2019-10-07,88,1,67,155
"5412","1200-1259",2019-10-08,86,2,63,149
"5413","1200-1259",2019-10-09,85,3,65,150
"5414","1200-1259",2019-10-10,87,4,67,154
"5415","1200-1259",2019-10-11,88,5,66,154
"5416","1200-1259",2019-10-12,74,6,59,133
"5417","1200-1259",2019-10-13,77,7,68,145
"5418","1200-1259",2019-10-14,87,1,66,153
"5419","1200-1259",2019-10-15,85,2,63,148
"5420","1200-1259",2019-10-16,84,3,65,149
"5421","1200-1259",2019-10-17,88,4,67,155
"5422","1200-1259",2019-10-18,88,5,66,154
"5423","1200-1259",2019-10-19,74,6,59,133
"5424","1200-1259",2019-10-20,78,7,68,146
"5425","1200-1259",2019-10-21,88,1,66,154
"5426","1200-1259",2019-10-22,85,2,63,148
"5427","1200-1259",2019-10-23,84,3,65,149
"5428","1200-1259",2019-10-24,88,4,67,155
"5429","1200-1259",2019-10-25,88,5,66,154
"5430","1200-1259",2019-10-26,73,6,56,129
"5431","1200-1259",2019-10-27,73,7,65,138
"5432","1200-1259",2019-10-28,83,1,63,146
"5433","1200-1259",2019-10-29,76,2,61,137
"5434","1200-1259",2019-10-30,70,3,59,129
"5435","1200-1259",2019-10-31,73,4,60,133
"5436","1300-1359",2019-10-01,77,2,70,147
"5437","1300-1359",2019-10-02,72,3,67,139
"5438","1300-1359",2019-10-03,72,4,65,137
"5439","1300-1359",2019-10-04,72,5,68,140
"5440","1300-1359",2019-10-05,61,6,66,127
"5441","1300-1359",2019-10-06,72,7,59,131
"5442","1300-1359",2019-10-07,72,1,69,141
"5443","1300-1359",2019-10-08,69,2,65,134
"5444","1300-1359",2019-10-09,70,3,67,137
"5445","1300-1359",2019-10-10,74,4,67,141
"5446","1300-1359",2019-10-11,72,5,67,139
"5447","1300-1359",2019-10-12,62,6,64,126
"5448","1300-1359",2019-10-13,74,7,59,133
"5449","1300-1359",2019-10-14,73,1,69,142
"5450","1300-1359",2019-10-15,70,2,64,134
"5451","1300-1359",2019-10-16,72,3,65,137
"5452","1300-1359",2019-10-17,74,4,69,143
"5453","1300-1359",2019-10-18,73,5,67,140
"5454","1300-1359",2019-10-19,62,6,65,127
"5455","1300-1359",2019-10-20,72,7,59,131
"5456","1300-1359",2019-10-21,72,1,69,141
"5457","1300-1359",2019-10-22,70,2,64,134
"5458","1300-1359",2019-10-23,71,3,65,136
"5459","1300-1359",2019-10-24,73,4,68,141
"5460","1300-1359",2019-10-25,72,5,68,140
"5461","1300-1359",2019-10-26,60,6,67,127
"5462","1300-1359",2019-10-27,71,7,61,132
"5463","1300-1359",2019-10-28,68,1,65,133
"5464","1300-1359",2019-10-29,68,2,58,126
"5465","1300-1359",2019-10-30,66,3,56,122
"5466","1300-1359",2019-10-31,67,4,60,127
"5467","1400-1459",2019-10-01,63,2,64,127
"5468","1400-1459",2019-10-02,62,3,72,134
"5469","1400-1459",2019-10-03,67,4,80,147
"5470","1400-1459",2019-10-04,65,5,82,147
"5471","1400-1459",2019-10-05,60,6,65,125
"5472","1400-1459",2019-10-06,61,7,80,141
"5473","1400-1459",2019-10-07,64,1,86,150
"5474","1400-1459",2019-10-08,63,2,80,143
"5475","1400-1459",2019-10-09,64,3,80,144
"5476","1400-1459",2019-10-10,63,4,85,148
"5477","1400-1459",2019-10-11,62,5,86,148
"5478","1400-1459",2019-10-12,59,6,68,127
"5479","1400-1459",2019-10-13,60,7,81,141
"5480","1400-1459",2019-10-14,63,1,86,149
"5481","1400-1459",2019-10-15,63,2,81,144
"5482","1400-1459",2019-10-16,62,3,82,144
"5483","1400-1459",2019-10-17,64,4,84,148
"5484","1400-1459",2019-10-18,62,5,86,148
"5485","1400-1459",2019-10-19,59,6,67,126
"5486","1400-1459",2019-10-20,61,7,81,142
"5487","1400-1459",2019-10-21,64,1,87,151
"5488","1400-1459",2019-10-22,62,2,81,143
"5489","1400-1459",2019-10-23,63,3,82,145
"5490","1400-1459",2019-10-24,64,4,85,149
"5491","1400-1459",2019-10-25,62,5,86,148
"5492","1400-1459",2019-10-26,60,6,66,126
"5493","1400-1459",2019-10-27,57,7,75,132
"5494","1400-1459",2019-10-28,62,1,79,141
"5495","1400-1459",2019-10-29,61,2,73,134
"5496","1400-1459",2019-10-30,62,3,74,136
"5497","1400-1459",2019-10-31,58,4,72,130
"5498","1500-1559",2019-10-01,78,2,80,158
"5499","1500-1559",2019-10-02,83,3,77,160
"5500","1500-1559",2019-10-03,81,4,79,160
"5501","1500-1559",2019-10-04,84,5,77,161
"5502","1500-1559",2019-10-05,72,6,75,147
"5503","1500-1559",2019-10-06,80,7,75,155
"5504","1500-1559",2019-10-07,85,1,78,163
"5505","1500-1559",2019-10-08,78,2,76,154
"5506","1500-1559",2019-10-09,78,3,77,155
"5507","1500-1559",2019-10-10,84,4,78,162
"5508","1500-1559",2019-10-11,82,5,79,161
"5509","1500-1559",2019-10-12,70,6,74,144
"5510","1500-1559",2019-10-13,80,7,75,155
"5511","1500-1559",2019-10-14,85,1,78,163
"5512","1500-1559",2019-10-15,77,2,76,153
"5513","1500-1559",2019-10-16,80,3,77,157
"5514","1500-1559",2019-10-17,84,4,78,162
"5515","1500-1559",2019-10-18,85,5,80,165
"5516","1500-1559",2019-10-19,69,6,74,143
"5517","1500-1559",2019-10-20,79,7,76,155
"5518","1500-1559",2019-10-21,85,1,79,164
"5519","1500-1559",2019-10-22,78,2,76,154
"5520","1500-1559",2019-10-23,80,3,77,157
"5521","1500-1559",2019-10-24,85,4,79,164
"5522","1500-1559",2019-10-25,86,5,79,165
"5523","1500-1559",2019-10-26,66,6,75,141
"5524","1500-1559",2019-10-27,74,7,80,154
"5525","1500-1559",2019-10-28,75,1,83,158
"5526","1500-1559",2019-10-29,70,2,80,150
"5527","1500-1559",2019-10-30,70,3,78,148
"5528","1500-1559",2019-10-31,67,4,77,144
"5529","1600-1659",2019-10-01,68,2,82,150
"5530","1600-1659",2019-10-02,71,3,78,149
"5531","1600-1659",2019-10-03,76,4,79,155
"5532","1600-1659",2019-10-04,76,5,78,154
"5533","1600-1659",2019-10-05,57,6,67,124
"5534","1600-1659",2019-10-06,72,7,77,149
"5535","1600-1659",2019-10-07,76,1,75,151
"5536","1600-1659",2019-10-08,73,2,71,144
"5537","1600-1659",2019-10-09,76,3,72,148
"5538","1600-1659",2019-10-10,77,4,76,153
"5539","1600-1659",2019-10-11,78,5,74,152
"5540","1600-1659",2019-10-12,59,6,64,123
"5541","1600-1659",2019-10-13,72,7,77,149
"5542","1600-1659",2019-10-14,77,1,75,152
"5543","1600-1659",2019-10-15,74,2,70,144
"5544","1600-1659",2019-10-16,75,3,73,148
"5545","1600-1659",2019-10-17,75,4,76,151
"5546","1600-1659",2019-10-18,76,5,72,148
"5547","1600-1659",2019-10-19,60,6,66,126
"5548","1600-1659",2019-10-20,73,7,76,149
"5549","1600-1659",2019-10-21,76,1,74,150
"5550","1600-1659",2019-10-22,74,2,70,144
"5551","1600-1659",2019-10-23,75,3,73,148
"5552","1600-1659",2019-10-24,75,4,75,150
"5553","1600-1659",2019-10-25,75,5,73,148
"5554","1600-1659",2019-10-26,60,6,64,124
"5555","1600-1659",2019-10-27,73,7,72,145
"5556","1600-1659",2019-10-28,76,1,67,143
"5557","1600-1659",2019-10-29,74,2,63,137
"5558","1600-1659",2019-10-30,69,3,63,132
"5559","1600-1659",2019-10-31,62,4,62,124
"5560","1700-1759",2019-10-01,89,2,71,160
"5561","1700-1759",2019-10-02,87,3,78,165
"5562","1700-1759",2019-10-03,89,4,85,174
"5563","1700-1759",2019-10-04,87,5,83,170
"5564","1700-1759",2019-10-05,76,6,61,137
"5565","1700-1759",2019-10-06,85,7,77,162
"5566","1700-1759",2019-10-07,90,1,87,177
"5567","1700-1759",2019-10-08,88,2,83,171
"5568","1700-1759",2019-10-09,88,3,82,170
"5569","1700-1759",2019-10-10,90,4,90,180
"5570","1700-1759",2019-10-11,89,5,86,175
"5571","1700-1759",2019-10-12,75,6,64,139
"5572","1700-1759",2019-10-13,87,7,76,163
"5573","1700-1759",2019-10-14,89,1,88,177
"5574","1700-1759",2019-10-15,87,2,85,172
"5575","1700-1759",2019-10-16,90,3,84,174
"5576","1700-1759",2019-10-17,88,4,89,177
"5577","1700-1759",2019-10-18,89,5,87,176
"5578","1700-1759",2019-10-19,74,6,62,136
"5579","1700-1759",2019-10-20,86,7,77,163
"5580","1700-1759",2019-10-21,89,1,87,176
"5581","1700-1759",2019-10-22,87,2,85,172
"5582","1700-1759",2019-10-23,90,3,84,174
"5583","1700-1759",2019-10-24,90,4,89,179
"5584","1700-1759",2019-10-25,89,5,87,176
"5585","1700-1759",2019-10-26,74,6,61,135
"5586","1700-1759",2019-10-27,79,7,71,150
"5587","1700-1759",2019-10-28,81,1,80,161
"5588","1700-1759",2019-10-29,76,2,79,155
"5589","1700-1759",2019-10-30,70,3,73,143
"5590","1700-1759",2019-10-31,65,4,73,138
"5591","1800-1859",2019-10-01,76,2,95,171
"5592","1800-1859",2019-10-02,80,3,96,176
"5593","1800-1859",2019-10-03,81,4,96,177
"5594","1800-1859",2019-10-04,81,5,96,177
"5595","1800-1859",2019-10-05,60,6,72,132
"5596","1800-1859",2019-10-06,77,7,86,163
"5597","1800-1859",2019-10-07,81,1,92,173
"5598","1800-1859",2019-10-08,78,2,92,170
"5599","1800-1859",2019-10-09,80,3,91,171
"5600","1800-1859",2019-10-10,83,4,91,174
"5601","1800-1859",2019-10-11,84,5,90,174
"5602","1800-1859",2019-10-12,62,6,70,132
"5603","1800-1859",2019-10-13,76,7,86,162
"5604","1800-1859",2019-10-14,82,1,91,173
"5605","1800-1859",2019-10-15,79,2,90,169
"5606","1800-1859",2019-10-16,79,3,90,169
"5607","1800-1859",2019-10-17,84,4,89,173
"5608","1800-1859",2019-10-18,84,5,91,175
"5609","1800-1859",2019-10-19,63,6,70,133
"5610","1800-1859",2019-10-20,77,7,84,161
"5611","1800-1859",2019-10-21,82,1,91,173
"5612","1800-1859",2019-10-22,79,2,90,169
"5613","1800-1859",2019-10-23,79,3,90,169
"5614","1800-1859",2019-10-24,83,4,91,174
"5615","1800-1859",2019-10-25,84,5,91,175
"5616","1800-1859",2019-10-26,62,6,68,130
"5617","1800-1859",2019-10-27,73,7,82,155
"5618","1800-1859",2019-10-28,80,1,86,166
"5619","1800-1859",2019-10-29,76,2,82,158
"5620","1800-1859",2019-10-30,71,3,79,150
"5621","1800-1859",2019-10-31,66,4,75,141
"5622","1900-1959",2019-10-01,79,2,85,164
"5623","1900-1959",2019-10-02,78,3,78,156
"5624","1900-1959",2019-10-03,79,4,78,157
"5625","1900-1959",2019-10-04,79,5,78,157
"5626","1900-1959",2019-10-05,56,6,74,130
"5627","1900-1959",2019-10-06,73,7,79,152
"5628","1900-1959",2019-10-07,79,1,83,162
"5629","1900-1959",2019-10-08,69,2,82,151
"5630","1900-1959",2019-10-09,73,3,83,156
"5631","1900-1959",2019-10-10,78,4,83,161
"5632","1900-1959",2019-10-11,77,5,82,159
"5633","1900-1959",2019-10-12,56,6,75,131
"5634","1900-1959",2019-10-13,75,7,77,152
"5635","1900-1959",2019-10-14,80,1,83,163
"5636","1900-1959",2019-10-15,70,2,83,153
"5637","1900-1959",2019-10-16,74,3,82,156
"5638","1900-1959",2019-10-17,77,4,82,159
"5639","1900-1959",2019-10-18,78,5,84,162
"5640","1900-1959",2019-10-19,56,6,75,131
"5641","1900-1959",2019-10-20,73,7,80,153
"5642","1900-1959",2019-10-21,80,1,83,163
"5643","1900-1959",2019-10-22,70,2,84,154
"5644","1900-1959",2019-10-23,74,3,82,156
"5645","1900-1959",2019-10-24,78,4,83,161
"5646","1900-1959",2019-10-25,78,5,83,161
"5647","1900-1959",2019-10-26,54,6,77,131
"5648","1900-1959",2019-10-27,72,7,71,143
"5649","1900-1959",2019-10-28,75,1,77,152
"5650","1900-1959",2019-10-29,71,2,78,149
"5651","1900-1959",2019-10-30,74,3,73,147
"5652","1900-1959",2019-10-31,57,4,69,126
"5653","2000-2059",2019-10-01,55,2,80,135
"5654","2000-2059",2019-10-02,58,3,80,138
"5655","2000-2059",2019-10-03,57,4,87,144
"5656","2000-2059",2019-10-04,58,5,86,144
"5657","2000-2059",2019-10-05,37,6,75,112
"5658","2000-2059",2019-10-06,52,7,75,127
"5659","2000-2059",2019-10-07,57,1,79,136
"5660","2000-2059",2019-10-08,52,2,76,128
"5661","2000-2059",2019-10-09,56,3,76,132
"5662","2000-2059",2019-10-10,57,4,81,138
"5663","2000-2059",2019-10-11,55,5,83,138
"5664","2000-2059",2019-10-12,37,6,74,111
"5665","2000-2059",2019-10-13,52,7,77,129
"5666","2000-2059",2019-10-14,56,1,79,135
"5667","2000-2059",2019-10-15,51,2,77,128
"5668","2000-2059",2019-10-16,53,3,77,130
"5669","2000-2059",2019-10-17,57,4,83,140
"5670","2000-2059",2019-10-18,55,5,81,136
"5671","2000-2059",2019-10-19,37,6,75,112
"5672","2000-2059",2019-10-20,52,7,75,127
"5673","2000-2059",2019-10-21,56,1,79,135
"5674","2000-2059",2019-10-22,51,2,76,127
"5675","2000-2059",2019-10-23,53,3,77,130
"5676","2000-2059",2019-10-24,57,4,81,138
"5677","2000-2059",2019-10-25,55,5,82,137
"5678","2000-2059",2019-10-26,35,6,75,110
"5679","2000-2059",2019-10-27,53,7,79,132
"5680","2000-2059",2019-10-28,55,1,82,137
"5681","2000-2059",2019-10-29,51,2,83,134
"5682","2000-2059",2019-10-30,49,3,78,127
"5683","2000-2059",2019-10-31,44,4,67,111
"5684","2100-2159",2019-10-01,63,2,89,152
"5685","2100-2159",2019-10-02,61,3,85,146
"5686","2100-2159",2019-10-03,68,4,86,154
"5687","2100-2159",2019-10-04,65,5,87,152
"5688","2100-2159",2019-10-05,38,6,73,111
"5689","2100-2159",2019-10-06,67,7,89,156
"5690","2100-2159",2019-10-07,66,1,91,157
"5691","2100-2159",2019-10-08,57,2,85,142
"5692","2100-2159",2019-10-09,59,3,88,147
"5693","2100-2159",2019-10-10,65,4,90,155
"5694","2100-2159",2019-10-11,63,5,89,152
"5695","2100-2159",2019-10-12,37,6,74,111
"5696","2100-2159",2019-10-13,67,7,91,158
"5697","2100-2159",2019-10-14,66,1,91,157
"5698","2100-2159",2019-10-15,57,2,84,141
"5699","2100-2159",2019-10-16,60,3,86,146
"5700","2100-2159",2019-10-17,65,4,89,154
"5701","2100-2159",2019-10-18,64,5,89,153
"5702","2100-2159",2019-10-19,37,6,73,110
"5703","2100-2159",2019-10-20,67,7,89,156
"5704","2100-2159",2019-10-21,66,1,91,157
"5705","2100-2159",2019-10-22,57,2,84,141
"5706","2100-2159",2019-10-23,60,3,86,146
"5707","2100-2159",2019-10-24,65,4,90,155
"5708","2100-2159",2019-10-25,63,5,89,152
"5709","2100-2159",2019-10-26,37,6,70,107
"5710","2100-2159",2019-10-27,63,7,84,147
"5711","2100-2159",2019-10-28,63,1,84,147
"5712","2100-2159",2019-10-29,56,2,78,134
"5713","2100-2159",2019-10-30,57,3,73,130
"5714","2100-2159",2019-10-31,55,4,71,126
"5715","2200-2259",2019-10-01,41,2,80,121
"5716","2200-2259",2019-10-02,48,3,87,135
"5717","2200-2259",2019-10-03,49,4,94,143
"5718","2200-2259",2019-10-04,50,5,91,141
"5719","2200-2259",2019-10-05,32,6,61,93
"5720","2200-2259",2019-10-06,57,7,79,136
"5721","2200-2259",2019-10-07,52,1,90,142
"5722","2200-2259",2019-10-08,48,2,75,123
"5723","2200-2259",2019-10-09,51,3,81,132
"5724","2200-2259",2019-10-10,53,4,88,141
"5725","2200-2259",2019-10-11,52,5,86,138
"5726","2200-2259",2019-10-12,31,6,61,92
"5727","2200-2259",2019-10-13,58,7,81,139
"5728","2200-2259",2019-10-14,51,1,88,139
"5729","2200-2259",2019-10-15,48,2,75,123
"5730","2200-2259",2019-10-16,51,3,81,132
"5731","2200-2259",2019-10-17,52,4,88,140
"5732","2200-2259",2019-10-18,51,5,87,138
"5733","2200-2259",2019-10-19,31,6,61,92
"5734","2200-2259",2019-10-20,57,7,79,136
"5735","2200-2259",2019-10-21,51,1,88,139
"5736","2200-2259",2019-10-22,48,2,75,123
"5737","2200-2259",2019-10-23,51,3,81,132
"5738","2200-2259",2019-10-24,53,4,88,141
"5739","2200-2259",2019-10-25,51,5,86,137
"5740","2200-2259",2019-10-26,32,6,59,91
"5741","2200-2259",2019-10-27,53,7,77,130
"5742","2200-2259",2019-10-28,46,1,82,128
"5743","2200-2259",2019-10-29,41,2,75,116
"5744","2200-2259",2019-10-30,41,3,75,116
"5745","2200-2259",2019-10-31,38,4,64,102
"5746","2300-2359",2019-10-01,20,2,65,85
"5747","2300-2359",2019-10-02,26,3,71,97
"5748","2300-2359",2019-10-03,23,4,71,94
"5749","2300-2359",2019-10-04,25,5,73,98
"5750","2300-2359",2019-10-05,19,6,36,55
"5751","2300-2359",2019-10-06,23,7,80,103
"5752","2300-2359",2019-10-07,18,1,74,92
"5753","2300-2359",2019-10-08,18,2,67,85
"5754","2300-2359",2019-10-09,24,3,71,95
"5755","2300-2359",2019-10-10,21,4,75,96
"5756","2300-2359",2019-10-11,23,5,74,97
"5757","2300-2359",2019-10-12,21,6,36,57
"5758","2300-2359",2019-10-13,23,7,78,101
"5759","2300-2359",2019-10-14,18,1,76,94
"5760","2300-2359",2019-10-15,18,2,67,85
"5761","2300-2359",2019-10-16,24,3,71,95
"5762","2300-2359",2019-10-17,22,4,75,97
"5763","2300-2359",2019-10-18,24,5,74,98
"5764","2300-2359",2019-10-19,20,6,36,56
"5765","2300-2359",2019-10-20,23,7,80,103
"5766","2300-2359",2019-10-21,18,1,76,94
"5767","2300-2359",2019-10-22,18,2,67,85
"5768","2300-2359",2019-10-23,24,3,71,95
"5769","2300-2359",2019-10-24,21,4,75,96
"5770","2300-2359",2019-10-25,24,5,73,97
"5771","2300-2359",2019-10-26,20,6,35,55
"5772","2300-2359",2019-10-27,18,7,75,93
"5773","2300-2359",2019-10-28,15,1,74,89
"5774","2300-2359",2019-10-29,14,2,62,76
"5775","2300-2359",2019-10-30,19,3,66,85
"5776","2300-2359",2019-10-31,15,4,57,72
"5777","0001-0559",2019-11-01,27,5,64,91
"5778","0001-0559",2019-11-02,19,6,54,73
"5779","0001-0559",2019-11-03,18,7,75,93
"5780","0001-0559",2019-11-04,31,1,64,95
"5781","0001-0559",2019-11-05,31,2,56,87
"5782","0001-0559",2019-11-06,31,3,62,93
"5783","0001-0559",2019-11-07,31,4,70,101
"5784","0001-0559",2019-11-08,31,5,72,103
"5785","0001-0559",2019-11-09,15,6,44,59
"5786","0001-0559",2019-11-10,20,7,80,100
"5787","0001-0559",2019-11-11,30,1,69,99
"5788","0001-0559",2019-11-12,30,2,59,89
"5789","0001-0559",2019-11-13,30,3,65,95
"5790","0001-0559",2019-11-14,30,4,67,97
"5791","0001-0559",2019-11-15,30,5,67,97
"5792","0001-0559",2019-11-16,15,6,39,54
"5793","0001-0559",2019-11-17,20,7,76,96
"5794","0001-0559",2019-11-18,30,1,65,95
"5795","0001-0559",2019-11-19,30,2,56,86
"5796","0001-0559",2019-11-20,30,3,60,90
"5797","0001-0559",2019-11-21,32,4,75,107
"5798","0001-0559",2019-11-22,32,5,78,110
"5799","0001-0559",2019-11-23,28,6,64,92
"5800","0001-0559",2019-11-24,23,7,85,108
"5801","0001-0559",2019-11-25,31,1,70,101
"5802","0001-0559",2019-11-26,31,2,76,107
"5803","0001-0559",2019-11-27,31,3,74,105
"5804","0001-0559",2019-11-28,21,4,30,51
"5805","0001-0559",2019-11-29,11,5,53,64
"5806","0001-0559",2019-11-30,29,6,78,107
"5807","0600-0659",2019-11-01,89,5,26,115
"5808","0600-0659",2019-11-02,89,6,25,114
"5809","0600-0659",2019-11-03,84,7,25,109
"5810","0600-0659",2019-11-04,99,1,30,129
"5811","0600-0659",2019-11-05,91,2,31,122
"5812","0600-0659",2019-11-06,88,3,32,120
"5813","0600-0659",2019-11-07,94,4,33,127
"5814","0600-0659",2019-11-08,97,5,35,132
"5815","0600-0659",2019-11-09,79,6,27,106
"5816","0600-0659",2019-11-10,82,7,24,106
"5817","0600-0659",2019-11-11,97,1,33,130
"5818","0600-0659",2019-11-12,92,2,31,123
"5819","0600-0659",2019-11-13,91,3,31,122
"5820","0600-0659",2019-11-14,94,4,33,127
"5821","0600-0659",2019-11-15,96,5,35,131
"5822","0600-0659",2019-11-16,78,6,27,105
"5823","0600-0659",2019-11-17,82,7,25,107
"5824","0600-0659",2019-11-18,96,1,33,129
"5825","0600-0659",2019-11-19,93,2,31,124
"5826","0600-0659",2019-11-20,91,3,32,123
"5827","0600-0659",2019-11-21,96,4,34,130
"5828","0600-0659",2019-11-22,96,5,34,130
"5829","0600-0659",2019-11-23,86,6,30,116
"5830","0600-0659",2019-11-24,87,7,21,108
"5831","0600-0659",2019-11-25,93,1,30,123
"5832","0600-0659",2019-11-26,92,2,29,121
"5833","0600-0659",2019-11-27,98,3,31,129
"5834","0600-0659",2019-11-28,82,4,23,105
"5835","0600-0659",2019-11-29,46,5,22,68
"5836","0600-0659",2019-11-30,94,6,34,128
"5837","0700-0759",2019-11-01,102,5,54,156
"5838","0700-0759",2019-11-02,90,6,45,135
"5839","0700-0759",2019-11-03,95,7,59,154
"5840","0700-0759",2019-11-04,109,1,56,165
"5841","0700-0759",2019-11-05,100,2,53,153
"5842","0700-0759",2019-11-06,101,3,55,156
"5843","0700-0759",2019-11-07,111,4,55,166
"5844","0700-0759",2019-11-08,111,5,55,166
"5845","0700-0759",2019-11-09,101,6,41,142
"5846","0700-0759",2019-11-10,94,7,57,151
"5847","0700-0759",2019-11-11,112,1,53,165
"5848","0700-0759",2019-11-12,104,2,52,156
"5849","0700-0759",2019-11-13,104,3,54,158
"5850","0700-0759",2019-11-14,112,4,56,168
"5851","0700-0759",2019-11-15,115,5,56,171
"5852","0700-0759",2019-11-16,102,6,43,145
"5853","0700-0759",2019-11-17,94,7,59,153
"5854","0700-0759",2019-11-18,113,1,55,168
"5855","0700-0759",2019-11-19,105,2,54,159
"5856","0700-0759",2019-11-20,106,3,57,163
"5857","0700-0759",2019-11-21,106,4,58,164
"5858","0700-0759",2019-11-22,112,5,60,172
"5859","0700-0759",2019-11-23,102,6,53,155
"5860","0700-0759",2019-11-24,93,7,61,154
"5861","0700-0759",2019-11-25,104,1,55,159
"5862","0700-0759",2019-11-26,105,2,57,162
"5863","0700-0759",2019-11-27,112,3,58,170
"5864","0700-0759",2019-11-28,106,4,52,158
"5865","0700-0759",2019-11-29,65,5,36,101
"5866","0700-0759",2019-11-30,109,6,61,170
"5867","0800-0859",2019-11-01,94,5,63,157
"5868","0800-0859",2019-11-02,89,6,59,148
"5869","0800-0859",2019-11-03,104,7,50,154
"5870","0800-0859",2019-11-04,107,1,70,177
"5871","0800-0859",2019-11-05,105,2,65,170
"5872","0800-0859",2019-11-06,104,3,64,168
"5873","0800-0859",2019-11-07,109,4,72,181
"5874","0800-0859",2019-11-08,109,5,72,181
"5875","0800-0859",2019-11-09,94,6,68,162
"5876","0800-0859",2019-11-10,108,7,55,163
"5877","0800-0859",2019-11-11,107,1,73,180
"5878","0800-0859",2019-11-12,104,2,67,171
"5879","0800-0859",2019-11-13,103,3,68,171
"5880","0800-0859",2019-11-14,111,4,70,181
"5881","0800-0859",2019-11-15,109,5,71,180
"5882","0800-0859",2019-11-16,96,6,67,163
"5883","0800-0859",2019-11-17,110,7,53,163
"5884","0800-0859",2019-11-18,109,1,71,180
"5885","0800-0859",2019-11-19,108,2,67,175
"5886","0800-0859",2019-11-20,105,3,67,172
"5887","0800-0859",2019-11-21,109,4,64,173
"5888","0800-0859",2019-11-22,109,5,66,175
"5889","0800-0859",2019-11-23,93,6,56,149
"5890","0800-0859",2019-11-24,109,7,50,159
"5891","0800-0859",2019-11-25,107,1,61,168
"5892","0800-0859",2019-11-26,110,2,62,172
"5893","0800-0859",2019-11-27,103,3,66,169
"5894","0800-0859",2019-11-28,99,4,53,152
"5895","0800-0859",2019-11-29,97,5,35,132
"5896","0800-0859",2019-11-30,96,6,60,156
"5897","0900-0959",2019-11-01,81,5,66,147
"5898","0900-0959",2019-11-02,77,6,63,140
"5899","0900-0959",2019-11-03,78,7,67,145
"5900","0900-0959",2019-11-04,77,1,68,145
"5901","0900-0959",2019-11-05,75,2,60,135
"5902","0900-0959",2019-11-06,75,3,59,134
"5903","0900-0959",2019-11-07,80,4,65,145
"5904","0900-0959",2019-11-08,78,5,65,143
"5905","0900-0959",2019-11-09,74,6,55,129
"5906","0900-0959",2019-11-10,77,7,64,141
"5907","0900-0959",2019-11-11,79,1,66,145
"5908","0900-0959",2019-11-12,75,2,63,138
"5909","0900-0959",2019-11-13,76,3,61,137
"5910","0900-0959",2019-11-14,78,4,66,144
"5911","0900-0959",2019-11-15,77,5,66,143
"5912","0900-0959",2019-11-16,72,6,55,127
"5913","0900-0959",2019-11-17,75,7,63,138
"5914","0900-0959",2019-11-18,78,1,66,144
"5915","0900-0959",2019-11-19,75,2,62,137
"5916","0900-0959",2019-11-20,76,3,61,137
"5917","0900-0959",2019-11-21,80,4,68,148
"5918","0900-0959",2019-11-22,80,5,67,147
"5919","0900-0959",2019-11-23,78,6,65,143
"5920","0900-0959",2019-11-24,80,7,69,149
"5921","0900-0959",2019-11-25,74,1,64,138
"5922","0900-0959",2019-11-26,78,2,62,140
"5923","0900-0959",2019-11-27,86,3,67,153
"5924","0900-0959",2019-11-28,76,4,67,143
"5925","0900-0959",2019-11-29,76,5,38,114
"5926","0900-0959",2019-11-30,82,6,67,149
"5927","1000-1059",2019-11-01,72,5,61,133
"5928","1000-1059",2019-11-02,75,6,56,131
"5929","1000-1059",2019-11-03,86,7,55,141
"5930","1000-1059",2019-11-04,85,1,68,153
"5931","1000-1059",2019-11-05,75,2,66,141
"5932","1000-1059",2019-11-06,75,3,67,142
"5933","1000-1059",2019-11-07,83,4,71,154
"5934","1000-1059",2019-11-08,83,5,72,155
"5935","1000-1059",2019-11-09,70,6,63,133
"5936","1000-1059",2019-11-10,80,7,60,140
"5937","1000-1059",2019-11-11,81,1,70,151
"5938","1000-1059",2019-11-12,75,2,66,141
"5939","1000-1059",2019-11-13,75,3,67,142
"5940","1000-1059",2019-11-14,81,4,72,153
"5941","1000-1059",2019-11-15,81,5,73,154
"5942","1000-1059",2019-11-16,70,6,64,134
"5943","1000-1059",2019-11-17,80,7,62,142
"5944","1000-1059",2019-11-18,80,1,72,152
"5945","1000-1059",2019-11-19,74,2,69,143
"5946","1000-1059",2019-11-20,75,3,69,144
"5947","1000-1059",2019-11-21,83,4,67,150
"5948","1000-1059",2019-11-22,82,5,71,153
"5949","1000-1059",2019-11-23,72,6,59,131
"5950","1000-1059",2019-11-24,79,7,61,140
"5951","1000-1059",2019-11-25,79,1,69,148
"5952","1000-1059",2019-11-26,80,2,70,150
"5953","1000-1059",2019-11-27,82,3,72,154
"5954","1000-1059",2019-11-28,76,4,63,139
"5955","1000-1059",2019-11-29,66,5,53,119
"5956","1000-1059",2019-11-30,71,6,64,135
"5957","1100-1159",2019-11-01,76,5,73,149
"5958","1100-1159",2019-11-02,69,6,69,138
"5959","1100-1159",2019-11-03,71,7,68,139
"5960","1100-1159",2019-11-04,78,1,64,142
"5961","1100-1159",2019-11-05,76,2,65,141
"5962","1100-1159",2019-11-06,76,3,61,137
"5963","1100-1159",2019-11-07,79,4,65,144
"5964","1100-1159",2019-11-08,79,5,65,144
"5965","1100-1159",2019-11-09,73,6,55,128
"5966","1100-1159",2019-11-10,74,7,61,135
"5967","1100-1159",2019-11-11,78,1,65,143
"5968","1100-1159",2019-11-12,76,2,64,140
"5969","1100-1159",2019-11-13,77,3,60,137
"5970","1100-1159",2019-11-14,79,4,63,142
"5971","1100-1159",2019-11-15,79,5,61,140
"5972","1100-1159",2019-11-16,73,6,54,127
"5973","1100-1159",2019-11-17,76,7,60,136
"5974","1100-1159",2019-11-18,80,1,63,143
"5975","1100-1159",2019-11-19,77,2,64,141
"5976","1100-1159",2019-11-20,78,3,60,138
"5977","1100-1159",2019-11-21,77,4,65,142
"5978","1100-1159",2019-11-22,78,5,64,142
"5979","1100-1159",2019-11-23,67,6,61,128
"5980","1100-1159",2019-11-24,76,7,61,137
"5981","1100-1159",2019-11-25,77,1,64,141
"5982","1100-1159",2019-11-26,75,2,66,141
"5983","1100-1159",2019-11-27,81,3,61,142
"5984","1100-1159",2019-11-28,72,4,69,141
"5985","1100-1159",2019-11-29,71,5,59,130
"5986","1100-1159",2019-11-30,73,6,60,133
"5987","1200-1259",2019-11-01,78,5,60,138
"5988","1200-1259",2019-11-02,68,6,54,122
"5989","1200-1259",2019-11-03,76,7,78,154
"5990","1200-1259",2019-11-04,78,1,86,164
"5991","1200-1259",2019-11-05,72,2,82,154
"5992","1200-1259",2019-11-06,73,3,82,155
"5993","1200-1259",2019-11-07,80,4,86,166
"5994","1200-1259",2019-11-08,81,5,86,167
"5995","1200-1259",2019-11-09,60,6,71,131
"5996","1200-1259",2019-11-10,74,7,83,157
"5997","1200-1259",2019-11-11,81,1,86,167
"5998","1200-1259",2019-11-12,74,2,83,157
"5999","1200-1259",2019-11-13,74,3,83,157
"6000","1200-1259",2019-11-14,80,4,87,167
"6001","1200-1259",2019-11-15,78,5,87,165
"6002","1200-1259",2019-11-16,59,6,70,129
"6003","1200-1259",2019-11-17,73,7,85,158
"6004","1200-1259",2019-11-18,79,1,87,166
"6005","1200-1259",2019-11-19,74,2,83,157
"6006","1200-1259",2019-11-20,74,3,83,157
"6007","1200-1259",2019-11-21,76,4,87,163
"6008","1200-1259",2019-11-22,77,5,89,166
"6009","1200-1259",2019-11-23,64,6,78,142
"6010","1200-1259",2019-11-24,68,7,85,153
"6011","1200-1259",2019-11-25,73,1,84,157
"6012","1200-1259",2019-11-26,76,2,87,163
"6013","1200-1259",2019-11-27,76,3,93,169
"6014","1200-1259",2019-11-28,62,4,74,136
"6015","1200-1259",2019-11-29,71,5,80,151
"6016","1200-1259",2019-11-30,76,6,87,163
"6017","1300-1359",2019-11-01,67,5,65,132
"6018","1300-1359",2019-11-02,61,6,64,125
"6019","1300-1359",2019-11-03,70,7,58,128
"6020","1300-1359",2019-11-04,72,1,59,131
"6021","1300-1359",2019-11-05,71,2,47,118
"6022","1300-1359",2019-11-06,71,3,49,120
"6023","1300-1359",2019-11-07,76,4,57,133
"6024","1300-1359",2019-11-08,76,5,58,134
"6025","1300-1359",2019-11-09,68,6,56,124
"6026","1300-1359",2019-11-10,73,7,52,125
"6027","1300-1359",2019-11-11,76,1,55,131
"6028","1300-1359",2019-11-12,74,2,47,121
"6029","1300-1359",2019-11-13,75,3,50,125
"6030","1300-1359",2019-11-14,75,4,57,132
"6031","1300-1359",2019-11-15,76,5,56,132
"6032","1300-1359",2019-11-16,66,6,56,122
"6033","1300-1359",2019-11-17,73,7,54,127
"6034","1300-1359",2019-11-18,74,1,56,130
"6035","1300-1359",2019-11-19,74,2,49,123
"6036","1300-1359",2019-11-20,74,3,51,125
"6037","1300-1359",2019-11-21,76,4,56,132
"6038","1300-1359",2019-11-22,75,5,55,130
"6039","1300-1359",2019-11-23,67,6,55,122
"6040","1300-1359",2019-11-24,73,7,52,125
"6041","1300-1359",2019-11-25,73,1,48,121
"6042","1300-1359",2019-11-26,74,2,50,124
"6043","1300-1359",2019-11-27,76,3,54,130
"6044","1300-1359",2019-11-28,54,4,53,107
"6045","1300-1359",2019-11-29,71,5,47,118
"6046","1300-1359",2019-11-30,71,6,59,130
"6047","1400-1459",2019-11-01,60,5,73,133
"6048","1400-1459",2019-11-02,65,6,64,129
"6049","1400-1459",2019-11-03,61,7,72,133
"6050","1400-1459",2019-11-04,71,1,79,150
"6051","1400-1459",2019-11-05,69,2,77,146
"6052","1400-1459",2019-11-06,70,3,78,148
"6053","1400-1459",2019-11-07,71,4,81,152
"6054","1400-1459",2019-11-08,71,5,81,152
"6055","1400-1459",2019-11-09,66,6,70,136
"6056","1400-1459",2019-11-10,64,7,74,138
"6057","1400-1459",2019-11-11,70,1,82,152
"6058","1400-1459",2019-11-12,69,2,78,147
"6059","1400-1459",2019-11-13,70,3,79,149
"6060","1400-1459",2019-11-14,72,4,81,153
"6061","1400-1459",2019-11-15,71,5,83,154
"6062","1400-1459",2019-11-16,66,6,71,137
"6063","1400-1459",2019-11-17,66,7,75,141
"6064","1400-1459",2019-11-18,72,1,83,155
"6065","1400-1459",2019-11-19,69,2,79,148
"6066","1400-1459",2019-11-20,68,3,81,149
"6067","1400-1459",2019-11-21,72,4,88,160
"6068","1400-1459",2019-11-22,72,5,89,161
"6069","1400-1459",2019-11-23,71,6,72,143
"6070","1400-1459",2019-11-24,65,7,79,144
"6071","1400-1459",2019-11-25,71,1,89,160
"6072","1400-1459",2019-11-26,73,2,86,159
"6073","1400-1459",2019-11-27,72,3,90,162
"6074","1400-1459",2019-11-28,49,4,76,125
"6075","1400-1459",2019-11-29,65,5,85,150
"6076","1400-1459",2019-11-30,73,6,78,151
"6077","1500-1559",2019-11-01,72,5,80,152
"6078","1500-1559",2019-11-02,64,6,82,146
"6079","1500-1559",2019-11-03,76,7,88,164
"6080","1500-1559",2019-11-04,72,1,89,161
"6081","1500-1559",2019-11-05,64,2,83,147
"6082","1500-1559",2019-11-06,67,3,86,153
"6083","1500-1559",2019-11-07,75,4,89,164
"6084","1500-1559",2019-11-08,76,5,89,165
"6085","1500-1559",2019-11-09,67,6,79,146
"6086","1500-1559",2019-11-10,73,7,82,155
"6087","1500-1559",2019-11-11,75,1,90,165
"6088","1500-1559",2019-11-12,67,2,84,151
"6089","1500-1559",2019-11-13,70,3,88,158
"6090","1500-1559",2019-11-14,75,4,86,161
"6091","1500-1559",2019-11-15,75,5,84,159
"6092","1500-1559",2019-11-16,68,6,74,142
"6093","1500-1559",2019-11-17,75,7,80,155
"6094","1500-1559",2019-11-18,76,1,85,161
"6095","1500-1559",2019-11-19,69,2,83,152
"6096","1500-1559",2019-11-20,73,3,84,157
"6097","1500-1559",2019-11-21,76,4,78,154
"6098","1500-1559",2019-11-22,76,5,78,154
"6099","1500-1559",2019-11-23,69,6,72,141
"6100","1500-1559",2019-11-24,74,7,75,149
"6101","1500-1559",2019-11-25,71,1,76,147
"6102","1500-1559",2019-11-26,71,2,80,151
"6103","1500-1559",2019-11-27,75,3,76,151
"6104","1500-1559",2019-11-28,48,4,60,108
"6105","1500-1559",2019-11-29,69,5,62,131
"6106","1500-1559",2019-11-30,76,6,72,148
"6107","1600-1659",2019-11-01,69,5,64,133
"6108","1600-1659",2019-11-02,62,6,62,124
"6109","1600-1659",2019-11-03,77,7,64,141
"6110","1600-1659",2019-11-04,82,1,69,151
"6111","1600-1659",2019-11-05,76,2,65,141
"6112","1600-1659",2019-11-06,77,3,66,143
"6113","1600-1659",2019-11-07,80,4,74,154
"6114","1600-1659",2019-11-08,80,5,74,154
"6115","1600-1659",2019-11-09,69,6,65,134
"6116","1600-1659",2019-11-10,77,7,73,150
"6117","1600-1659",2019-11-11,80,1,73,153
"6118","1600-1659",2019-11-12,76,2,70,146
"6119","1600-1659",2019-11-13,76,3,71,147
"6120","1600-1659",2019-11-14,79,4,76,155
"6121","1600-1659",2019-11-15,77,5,78,155
"6122","1600-1659",2019-11-16,67,6,68,135
"6123","1600-1659",2019-11-17,77,7,74,151
"6124","1600-1659",2019-11-18,78,1,76,154
"6125","1600-1659",2019-11-19,75,2,72,147
"6126","1600-1659",2019-11-20,75,3,74,149
"6127","1600-1659",2019-11-21,75,4,78,153
"6128","1600-1659",2019-11-22,75,5,81,156
"6129","1600-1659",2019-11-23,68,6,72,140
"6130","1600-1659",2019-11-24,70,7,74,144
"6131","1600-1659",2019-11-25,71,1,76,147
"6132","1600-1659",2019-11-26,75,2,77,152
"6133","1600-1659",2019-11-27,73,3,78,151
"6134","1600-1659",2019-11-28,35,4,62,97
"6135","1600-1659",2019-11-29,58,5,67,125
"6136","1600-1659",2019-11-30,75,6,80,155
"6137","1700-1759",2019-11-01,74,5,74,148
"6138","1700-1759",2019-11-02,73,6,65,138
"6139","1700-1759",2019-11-03,79,7,73,152
"6140","1700-1759",2019-11-04,73,1,75,148
"6141","1700-1759",2019-11-05,67,2,76,143
"6142","1700-1759",2019-11-06,67,3,75,142
"6143","1700-1759",2019-11-07,79,4,82,161
"6144","1700-1759",2019-11-08,78,5,80,158
"6145","1700-1759",2019-11-09,67,6,74,141
"6146","1700-1759",2019-11-10,81,7,78,159
"6147","1700-1759",2019-11-11,77,1,78,155
"6148","1700-1759",2019-11-12,72,2,77,149
"6149","1700-1759",2019-11-13,73,3,76,149
"6150","1700-1759",2019-11-14,78,4,83,161
"6151","1700-1759",2019-11-15,78,5,79,157
"6152","1700-1759",2019-11-16,66,6,77,143
"6153","1700-1759",2019-11-17,80,7,80,160
"6154","1700-1759",2019-11-18,76,1,81,157
"6155","1700-1759",2019-11-19,71,2,80,151
"6156","1700-1759",2019-11-20,72,3,80,152
"6157","1700-1759",2019-11-21,75,4,77,152
"6158","1700-1759",2019-11-22,75,5,74,149
"6159","1700-1759",2019-11-23,69,6,72,141
"6160","1700-1759",2019-11-24,73,7,73,146
"6161","1700-1759",2019-11-25,68,1,69,137
"6162","1700-1759",2019-11-26,72,2,71,143
"6163","1700-1759",2019-11-27,75,3,79,154
"6164","1700-1759",2019-11-28,33,4,58,91
"6165","1700-1759",2019-11-29,62,5,70,132
"6166","1700-1759",2019-11-30,83,6,80,163
"6167","1800-1859",2019-11-01,75,5,83,158
"6168","1800-1859",2019-11-02,62,6,64,126
"6169","1800-1859",2019-11-03,73,7,87,160
"6170","1800-1859",2019-11-04,77,1,87,164
"6171","1800-1859",2019-11-05,73,2,78,151
"6172","1800-1859",2019-11-06,75,3,81,156
"6173","1800-1859",2019-11-07,80,4,85,165
"6174","1800-1859",2019-11-08,81,5,85,166
"6175","1800-1859",2019-11-09,64,6,65,129
"6176","1800-1859",2019-11-10,77,7,83,160
"6177","1800-1859",2019-11-11,79,1,86,165
"6178","1800-1859",2019-11-12,76,2,80,156
"6179","1800-1859",2019-11-13,77,3,81,158
"6180","1800-1859",2019-11-14,79,4,82,161
"6181","1800-1859",2019-11-15,78,5,81,159
"6182","1800-1859",2019-11-16,64,6,61,125
"6183","1800-1859",2019-11-17,76,7,81,157
"6184","1800-1859",2019-11-18,78,1,82,160
"6185","1800-1859",2019-11-19,78,2,77,155
"6186","1800-1859",2019-11-20,78,3,78,156
"6187","1800-1859",2019-11-21,82,4,88,170
"6188","1800-1859",2019-11-22,81,5,88,169
"6189","1800-1859",2019-11-23,63,6,75,138
"6190","1800-1859",2019-11-24,73,7,84,157
"6191","1800-1859",2019-11-25,73,1,86,159
"6192","1800-1859",2019-11-26,75,2,86,161
"6193","1800-1859",2019-11-27,81,3,86,167
"6194","1800-1859",2019-11-28,30,4,36,66
"6195","1800-1859",2019-11-29,66,5,73,139
"6196","1800-1859",2019-11-30,76,6,75,151
"6197","1900-1959",2019-11-01,75,5,72,147
"6198","1900-1959",2019-11-02,61,6,71,132
"6199","1900-1959",2019-11-03,84,7,81,165
"6200","1900-1959",2019-11-04,85,1,78,163
"6201","1900-1959",2019-11-05,81,2,74,155
"6202","1900-1959",2019-11-06,83,3,73,156
"6203","1900-1959",2019-11-07,87,4,77,164
"6204","1900-1959",2019-11-08,87,5,76,163
"6205","1900-1959",2019-11-09,65,6,69,134
"6206","1900-1959",2019-11-10,84,7,75,159
"6207","1900-1959",2019-11-11,88,1,75,163
"6208","1900-1959",2019-11-12,82,2,73,155
"6209","1900-1959",2019-11-13,83,3,74,157
"6210","1900-1959",2019-11-14,85,4,77,162
"6211","1900-1959",2019-11-15,84,5,77,161
"6212","1900-1959",2019-11-16,62,6,70,132
"6213","1900-1959",2019-11-17,82,7,75,157
"6214","1900-1959",2019-11-18,86,1,77,163
"6215","1900-1959",2019-11-19,80,2,74,154
"6216","1900-1959",2019-11-20,82,3,76,158
"6217","1900-1959",2019-11-21,88,4,75,163
"6218","1900-1959",2019-11-22,89,5,73,162
"6219","1900-1959",2019-11-23,73,6,62,135
"6220","1900-1959",2019-11-24,84,7,70,154
"6221","1900-1959",2019-11-25,84,1,68,152
"6222","1900-1959",2019-11-26,85,2,71,156
"6223","1900-1959",2019-11-27,85,3,75,160
"6224","1900-1959",2019-11-28,27,4,35,62
"6225","1900-1959",2019-11-29,65,5,56,121
"6226","1900-1959",2019-11-30,87,6,73,160
"6227","2000-2059",2019-11-01,49,5,78,127
"6228","2000-2059",2019-11-02,33,6,80,113
"6229","2000-2059",2019-11-03,58,7,80,138
"6230","2000-2059",2019-11-04,53,1,84,137
"6231","2000-2059",2019-11-05,46,2,89,135
"6232","2000-2059",2019-11-06,50,3,84,134
"6233","2000-2059",2019-11-07,52,4,86,138
"6234","2000-2059",2019-11-08,51,5,89,140
"6235","2000-2059",2019-11-09,36,6,73,109
"6236","2000-2059",2019-11-10,57,7,84,141
"6237","2000-2059",2019-11-11,51,1,87,138
"6238","2000-2059",2019-11-12,48,2,89,137
"6239","2000-2059",2019-11-13,51,3,86,137
"6240","2000-2059",2019-11-14,54,4,84,138
"6241","2000-2059",2019-11-15,54,5,83,137
"6242","2000-2059",2019-11-16,40,6,69,109
"6243","2000-2059",2019-11-17,59,7,82,141
"6244","2000-2059",2019-11-18,54,1,83,137
"6245","2000-2059",2019-11-19,51,2,87,138
"6246","2000-2059",2019-11-20,53,3,83,136
"6247","2000-2059",2019-11-21,52,4,86,138
"6248","2000-2059",2019-11-22,51,5,90,141
"6249","2000-2059",2019-11-23,39,6,76,115
"6250","2000-2059",2019-11-24,54,7,82,136
"6251","2000-2059",2019-11-25,44,1,77,121
"6252","2000-2059",2019-11-26,50,2,82,132
"6253","2000-2059",2019-11-27,54,3,86,140
"6254","2000-2059",2019-11-28,15,4,55,70
"6255","2000-2059",2019-11-29,45,5,76,121
"6256","2000-2059",2019-11-30,50,6,88,138
"6257","2100-2159",2019-11-01,59,5,80,139
"6258","2100-2159",2019-11-02,34,6,67,101
"6259","2100-2159",2019-11-03,65,7,88,153
"6260","2100-2159",2019-11-04,62,1,87,149
"6261","2100-2159",2019-11-05,56,2,82,138
"6262","2100-2159",2019-11-06,57,3,84,141
"6263","2100-2159",2019-11-07,61,4,92,153
"6264","2100-2159",2019-11-08,63,5,90,153
"6265","2100-2159",2019-11-09,40,6,73,113
"6266","2100-2159",2019-11-10,64,7,89,153
"6267","2100-2159",2019-11-11,62,1,90,152
"6268","2100-2159",2019-11-12,57,2,86,143
"6269","2100-2159",2019-11-13,60,3,84,144
"6270","2100-2159",2019-11-14,60,4,93,153
"6271","2100-2159",2019-11-15,60,5,92,152
"6272","2100-2159",2019-11-16,36,6,74,110
"6273","2100-2159",2019-11-17,63,7,90,153
"6274","2100-2159",2019-11-18,60,1,91,151
"6275","2100-2159",2019-11-19,57,2,88,145
"6276","2100-2159",2019-11-20,59,3,86,145
"6277","2100-2159",2019-11-21,63,4,89,152
"6278","2100-2159",2019-11-22,65,5,87,152
"6279","2100-2159",2019-11-23,54,6,65,119
"6280","2100-2159",2019-11-24,63,7,83,146
"6281","2100-2159",2019-11-25,60,1,86,146
"6282","2100-2159",2019-11-26,60,2,87,147
"6283","2100-2159",2019-11-27,60,3,86,146
"6284","2100-2159",2019-11-28,24,4,34,58
"6285","2100-2159",2019-11-29,57,5,73,130
"6286","2100-2159",2019-11-30,65,6,80,145
"6287","2200-2259",2019-11-01,40,5,71,111
"6288","2200-2259",2019-11-02,31,6,63,94
"6289","2200-2259",2019-11-03,47,7,76,123
"6290","2200-2259",2019-11-04,49,1,82,131
"6291","2200-2259",2019-11-05,44,2,73,117
"6292","2200-2259",2019-11-06,46,3,77,123
"6293","2200-2259",2019-11-07,52,4,79,131
"6294","2200-2259",2019-11-08,53,5,80,133
"6295","2200-2259",2019-11-09,31,6,68,99
"6296","2200-2259",2019-11-10,50,7,78,128
"6297","2200-2259",2019-11-11,52,1,80,132
"6298","2200-2259",2019-11-12,46,2,72,118
"6299","2200-2259",2019-11-13,45,3,75,120
"6300","2200-2259",2019-11-14,51,4,78,129
"6301","2200-2259",2019-11-15,51,5,79,130
"6302","2200-2259",2019-11-16,30,6,66,96
"6303","2200-2259",2019-11-17,49,7,77,126
"6304","2200-2259",2019-11-18,51,1,79,130
"6305","2200-2259",2019-11-19,45,2,72,117
"6306","2200-2259",2019-11-20,44,3,73,117
"6307","2200-2259",2019-11-21,48,4,82,130
"6308","2200-2259",2019-11-22,49,5,84,133
"6309","2200-2259",2019-11-23,36,6,74,110
"6310","2200-2259",2019-11-24,44,7,81,125
"6311","2200-2259",2019-11-25,41,1,79,120
"6312","2200-2259",2019-11-26,45,2,80,125
"6313","2200-2259",2019-11-27,48,3,84,132
"6314","2200-2259",2019-11-28,16,4,24,40
"6315","2200-2259",2019-11-29,35,5,67,102
"6316","2200-2259",2019-11-30,46,6,89,135
"6317","2300-2359",2019-11-01,20,5,72,92
"6318","2300-2359",2019-11-02,28,6,43,71
"6319","2300-2359",2019-11-03,26,7,84,110
"6320","2300-2359",2019-11-04,20,1,85,105
"6321","2300-2359",2019-11-05,21,2,71,92
"6322","2300-2359",2019-11-06,25,3,76,101
"6323","2300-2359",2019-11-07,25,4,86,111
"6324","2300-2359",2019-11-08,26,5,87,113
"6325","2300-2359",2019-11-09,25,6,48,73
"6326","2300-2359",2019-11-10,27,7,84,111
"6327","2300-2359",2019-11-11,23,1,87,110
"6328","2300-2359",2019-11-12,21,2,77,98
"6329","2300-2359",2019-11-13,25,3,82,107
"6330","2300-2359",2019-11-14,24,4,86,110
"6331","2300-2359",2019-11-15,25,5,86,111
"6332","2300-2359",2019-11-16,24,6,49,73
"6333","2300-2359",2019-11-17,26,7,85,111
"6334","2300-2359",2019-11-18,21,1,86,107
"6335","2300-2359",2019-11-19,20,2,78,98
"6336","2300-2359",2019-11-20,26,3,84,110
"6337","2300-2359",2019-11-21,30,4,81,111
"6338","2300-2359",2019-11-22,33,5,79,112
"6339","2300-2359",2019-11-23,27,6,65,92
"6340","2300-2359",2019-11-24,29,7,71,100
"6341","2300-2359",2019-11-25,27,1,70,97
"6342","2300-2359",2019-11-26,26,2,74,100
"6343","2300-2359",2019-11-27,28,3,80,108
"6344","2300-2359",2019-11-28,19,4,20,39
"6345","2300-2359",2019-11-29,26,5,70,96
"6346","2300-2359",2019-11-30,34,6,81,115
"6347","0001-0559",2019-12-01,35,7,96,131
"6348","0001-0559",2019-12-02,38,1,78,116
"6349","0001-0559",2019-12-03,32,2,66,98
"6350","0001-0559",2019-12-04,29,3,62,91
"6351","0001-0559",2019-12-05,28,4,65,93
"6352","0001-0559",2019-12-06,28,5,66,94
"6353","0001-0559",2019-12-07,13,6,43,56
"6354","0001-0559",2019-12-08,18,7,74,92
"6355","0001-0559",2019-12-09,28,1,65,93
"6356","0001-0559",2019-12-10,28,2,61,89
"6357","0001-0559",2019-12-11,28,3,63,91
"6358","0001-0559",2019-12-12,27,4,65,92
"6359","0001-0559",2019-12-13,27,5,66,93
"6360","0001-0559",2019-12-14,13,6,43,56
"6361","0001-0559",2019-12-15,18,7,74,92
"6362","0001-0559",2019-12-16,29,1,65,94
"6363","0001-0559",2019-12-17,28,2,62,90
"6364","0001-0559",2019-12-18,29,3,74,103
"6365","0001-0559",2019-12-19,34,4,89,123
"6366","0001-0559",2019-12-20,33,5,88,121
"6367","0001-0559",2019-12-21,30,6,86,116
"6368","0001-0559",2019-12-22,33,7,97,130
"6369","0001-0559",2019-12-23,33,1,87,120
"6370","0001-0559",2019-12-24,23,2,73,96
"6371","0001-0559",2019-12-25,16,3,72,88
"6372","0001-0559",2019-12-26,33,4,87,120
"6373","0001-0559",2019-12-27,34,5,88,122
"6374","0001-0559",2019-12-28,29,6,85,114
"6375","0001-0559",2019-12-29,32,7,96,128
"6376","0001-0559",2019-12-30,32,1,86,118
"6377","0001-0559",2019-12-31,24,2,63,87
"6378","0600-0659",2019-12-01,105,7,36,141
"6379","0600-0659",2019-12-02,103,1,34,137
"6380","0600-0659",2019-12-03,100,2,29,129
"6381","0600-0659",2019-12-04,95,3,33,128
"6382","0600-0659",2019-12-05,101,4,35,136
"6383","0600-0659",2019-12-06,103,5,34,137
"6384","0600-0659",2019-12-07,85,6,26,111
"6385","0600-0659",2019-12-08,88,7,25,113
"6386","0600-0659",2019-12-09,103,1,34,137
"6387","0600-0659",2019-12-10,98,2,28,126
"6388","0600-0659",2019-12-11,94,3,32,126
"6389","0600-0659",2019-12-12,102,4,34,136
"6390","0600-0659",2019-12-13,104,5,34,138
"6391","0600-0659",2019-12-14,85,6,27,112
"6392","0600-0659",2019-12-15,88,7,25,113
"6393","0600-0659",2019-12-16,103,1,35,138
"6394","0600-0659",2019-12-17,98,2,28,126
"6395","0600-0659",2019-12-18,103,3,35,138
"6396","0600-0659",2019-12-19,117,4,40,157
"6397","0600-0659",2019-12-20,116,5,40,156
"6398","0600-0659",2019-12-21,108,6,36,144
"6399","0600-0659",2019-12-22,111,7,39,150
"6400","0600-0659",2019-12-23,114,1,41,155
"6401","0600-0659",2019-12-24,105,2,30,135
"6402","0600-0659",2019-12-25,84,3,26,110
"6403","0600-0659",2019-12-26,109,4,42,151
"6404","0600-0659",2019-12-27,113,5,41,154
"6405","0600-0659",2019-12-28,106,6,36,142
"6406","0600-0659",2019-12-29,110,7,39,149
"6407","0600-0659",2019-12-30,113,1,41,154
"6408","0600-0659",2019-12-31,104,2,30,134
"6409","0700-0759",2019-12-01,99,7,58,157
"6410","0700-0759",2019-12-02,110,1,58,168
"6411","0700-0759",2019-12-03,102,2,56,158
"6412","0700-0759",2019-12-04,91,3,54,145
"6413","0700-0759",2019-12-05,100,4,56,156
"6414","0700-0759",2019-12-06,102,5,56,158
"6415","0700-0759",2019-12-07,88,6,43,131
"6416","0700-0759",2019-12-08,84,7,58,142
"6417","0700-0759",2019-12-09,101,1,55,156
"6418","0700-0759",2019-12-10,92,2,54,146
"6419","0700-0759",2019-12-11,93,3,55,148
"6420","0700-0759",2019-12-12,100,4,55,155
"6421","0700-0759",2019-12-13,102,5,55,157
"6422","0700-0759",2019-12-14,88,6,43,131
"6423","0700-0759",2019-12-15,84,7,58,142
"6424","0700-0759",2019-12-16,101,1,55,156
"6425","0700-0759",2019-12-17,92,2,54,146
"6426","0700-0759",2019-12-18,91,3,54,145
"6427","0700-0759",2019-12-19,97,4,58,155
"6428","0700-0759",2019-12-20,101,5,53,154
"6429","0700-0759",2019-12-21,100,6,58,158
"6430","0700-0759",2019-12-22,100,7,57,157
"6431","0700-0759",2019-12-23,102,1,56,158
"6432","0700-0759",2019-12-24,99,2,56,155
"6433","0700-0759",2019-12-25,86,3,43,129
"6434","0700-0759",2019-12-26,101,4,55,156
"6435","0700-0759",2019-12-27,102,5,56,158
"6436","0700-0759",2019-12-28,100,6,58,158
"6437","0700-0759",2019-12-29,99,7,57,156
"6438","0700-0759",2019-12-30,102,1,56,158
"6439","0700-0759",2019-12-31,100,2,55,155
"6440","0800-0859",2019-12-01,106,7,67,173
"6441","0800-0859",2019-12-02,106,1,72,178
"6442","0800-0859",2019-12-03,102,2,68,170
"6443","0800-0859",2019-12-04,109,3,66,175
"6444","0800-0859",2019-12-05,116,4,67,183
"6445","0800-0859",2019-12-06,115,5,67,182
"6446","0800-0859",2019-12-07,104,6,63,167
"6447","0800-0859",2019-12-08,114,7,49,163
"6448","0800-0859",2019-12-09,114,1,68,182
"6449","0800-0859",2019-12-10,112,2,65,177
"6450","0800-0859",2019-12-11,110,3,66,176
"6451","0800-0859",2019-12-12,115,4,68,183
"6452","0800-0859",2019-12-13,114,5,68,182
"6453","0800-0859",2019-12-14,104,6,63,167
"6454","0800-0859",2019-12-15,114,7,49,163
"6455","0800-0859",2019-12-16,114,1,68,182
"6456","0800-0859",2019-12-17,112,2,65,177
"6457","0800-0859",2019-12-18,113,3,69,182
"6458","0800-0859",2019-12-19,110,4,73,183
"6459","0800-0859",2019-12-20,111,5,76,187
"6460","0800-0859",2019-12-21,100,6,61,161
"6461","0800-0859",2019-12-22,110,7,67,177
"6462","0800-0859",2019-12-23,113,1,73,186
"6463","0800-0859",2019-12-24,109,2,65,174
"6464","0800-0859",2019-12-25,96,3,57,153
"6465","0800-0859",2019-12-26,117,4,73,190
"6466","0800-0859",2019-12-27,114,5,73,187
"6467","0800-0859",2019-12-28,102,6,61,163
"6468","0800-0859",2019-12-29,110,7,66,176
"6469","0800-0859",2019-12-30,113,1,72,185
"6470","0800-0859",2019-12-31,109,2,67,176
"6471","0900-0959",2019-12-01,84,7,68,152
"6472","0900-0959",2019-12-02,84,1,70,154
"6473","0900-0959",2019-12-03,77,2,65,142
"6474","0900-0959",2019-12-04,72,3,56,128
"6475","0900-0959",2019-12-05,73,4,67,140
"6476","0900-0959",2019-12-06,74,5,68,142
"6477","0900-0959",2019-12-07,73,6,55,128
"6478","0900-0959",2019-12-08,73,7,65,138
"6479","0900-0959",2019-12-09,75,1,67,142
"6480","0900-0959",2019-12-10,73,2,61,134
"6481","0900-0959",2019-12-11,72,3,58,130
"6482","0900-0959",2019-12-12,74,4,67,141
"6483","0900-0959",2019-12-13,75,5,68,143
"6484","0900-0959",2019-12-14,73,6,55,128
"6485","0900-0959",2019-12-15,73,7,65,138
"6486","0900-0959",2019-12-16,75,1,67,142
"6487","0900-0959",2019-12-17,73,2,61,134
"6488","0900-0959",2019-12-18,76,3,63,139
"6489","0900-0959",2019-12-19,86,4,60,146
"6490","0900-0959",2019-12-20,86,5,61,147
"6491","0900-0959",2019-12-21,82,6,64,146
"6492","0900-0959",2019-12-22,84,7,64,148
"6493","0900-0959",2019-12-23,83,1,60,143
"6494","0900-0959",2019-12-24,84,2,58,142
"6495","0900-0959",2019-12-25,77,3,47,124
"6496","0900-0959",2019-12-26,82,4,59,141
"6497","0900-0959",2019-12-27,82,5,61,143
"6498","0900-0959",2019-12-28,81,6,62,143
"6499","0900-0959",2019-12-29,83,7,63,146
"6500","0900-0959",2019-12-30,82,1,59,141
"6501","0900-0959",2019-12-31,85,2,53,138
"6502","1000-1059",2019-12-01,83,7,68,151
"6503","1000-1059",2019-12-02,82,1,69,151
"6504","1000-1059",2019-12-03,76,2,61,137
"6505","1000-1059",2019-12-04,74,3,69,143
"6506","1000-1059",2019-12-05,83,4,69,152
"6507","1000-1059",2019-12-06,81,5,69,150
"6508","1000-1059",2019-12-07,64,6,66,130
"6509","1000-1059",2019-12-08,78,7,60,138
"6510","1000-1059",2019-12-09,79,1,68,147
"6511","1000-1059",2019-12-10,75,2,66,141
"6512","1000-1059",2019-12-11,76,3,67,143
"6513","1000-1059",2019-12-12,83,4,69,152
"6514","1000-1059",2019-12-13,81,5,69,150
"6515","1000-1059",2019-12-14,64,6,66,130
"6516","1000-1059",2019-12-15,78,7,60,138
"6517","1000-1059",2019-12-16,80,1,69,149
"6518","1000-1059",2019-12-17,75,2,66,141
"6519","1000-1059",2019-12-18,80,3,63,143
"6520","1000-1059",2019-12-19,78,4,74,152
"6521","1000-1059",2019-12-20,76,5,73,149
"6522","1000-1059",2019-12-21,70,6,60,130
"6523","1000-1059",2019-12-22,76,7,69,145
"6524","1000-1059",2019-12-23,78,1,71,149
"6525","1000-1059",2019-12-24,74,2,69,143
"6526","1000-1059",2019-12-25,66,3,63,129
"6527","1000-1059",2019-12-26,79,4,69,148
"6528","1000-1059",2019-12-27,79,5,71,150
"6529","1000-1059",2019-12-28,70,6,60,130
"6530","1000-1059",2019-12-29,78,7,69,147
"6531","1000-1059",2019-12-30,79,1,71,150
"6532","1000-1059",2019-12-31,71,2,73,144
"6533","1100-1159",2019-12-01,80,7,67,147
"6534","1100-1159",2019-12-02,79,1,66,145
"6535","1100-1159",2019-12-03,73,2,66,139
"6536","1100-1159",2019-12-04,78,3,57,135
"6537","1100-1159",2019-12-05,77,4,64,141
"6538","1100-1159",2019-12-06,77,5,64,141
"6539","1100-1159",2019-12-07,70,6,52,122
"6540","1100-1159",2019-12-08,72,7,59,131
"6541","1100-1159",2019-12-09,76,1,64,140
"6542","1100-1159",2019-12-10,76,2,62,138
"6543","1100-1159",2019-12-11,77,3,58,135
"6544","1100-1159",2019-12-12,77,4,63,140
"6545","1100-1159",2019-12-13,77,5,63,140
"6546","1100-1159",2019-12-14,70,6,52,122
"6547","1100-1159",2019-12-15,72,7,59,131
"6548","1100-1159",2019-12-16,77,1,64,141
"6549","1100-1159",2019-12-17,76,2,61,137
"6550","1100-1159",2019-12-18,79,3,66,145
"6551","1100-1159",2019-12-19,85,4,67,152
"6552","1100-1159",2019-12-20,87,5,68,155
"6553","1100-1159",2019-12-21,75,6,71,146
"6554","1100-1159",2019-12-22,86,7,72,158
"6555","1100-1159",2019-12-23,86,1,73,159
"6556","1100-1159",2019-12-24,84,2,68,152
"6557","1100-1159",2019-12-25,88,3,60,148
"6558","1100-1159",2019-12-26,85,4,73,158
"6559","1100-1159",2019-12-27,86,5,73,159
"6560","1100-1159",2019-12-28,75,6,72,147
"6561","1100-1159",2019-12-29,85,7,72,157
"6562","1100-1159",2019-12-30,86,1,73,159
"6563","1100-1159",2019-12-31,85,2,68,153
"6564","1200-1259",2019-12-01,75,7,83,158
"6565","1200-1259",2019-12-02,74,1,88,162
"6566","1200-1259",2019-12-03,67,2,81,148
"6567","1200-1259",2019-12-04,74,3,79,153
"6568","1200-1259",2019-12-05,77,4,81,158
"6569","1200-1259",2019-12-06,79,5,81,160
"6570","1200-1259",2019-12-07,63,6,68,131
"6571","1200-1259",2019-12-08,72,7,79,151
"6572","1200-1259",2019-12-09,77,1,81,158
"6573","1200-1259",2019-12-10,77,2,78,155
"6574","1200-1259",2019-12-11,76,3,79,155
"6575","1200-1259",2019-12-12,78,4,82,160
"6576","1200-1259",2019-12-13,79,5,82,161
"6577","1200-1259",2019-12-14,63,6,68,131
"6578","1200-1259",2019-12-15,73,7,79,152
"6579","1200-1259",2019-12-16,79,1,81,160
"6580","1200-1259",2019-12-17,76,2,79,155
"6581","1200-1259",2019-12-18,73,3,80,153
"6582","1200-1259",2019-12-19,74,4,89,163
"6583","1200-1259",2019-12-20,75,5,89,164
"6584","1200-1259",2019-12-21,72,6,81,153
"6585","1200-1259",2019-12-22,76,7,83,159
"6586","1200-1259",2019-12-23,78,1,86,164
"6587","1200-1259",2019-12-24,74,2,84,158
"6588","1200-1259",2019-12-25,75,3,76,151
"6589","1200-1259",2019-12-26,77,4,89,166
"6590","1200-1259",2019-12-27,78,5,88,166
"6591","1200-1259",2019-12-28,73,6,80,153
"6592","1200-1259",2019-12-29,76,7,83,159
"6593","1200-1259",2019-12-30,78,1,87,165
"6594","1200-1259",2019-12-31,75,2,82,157
"6595","1300-1359",2019-12-01,80,7,61,141
"6596","1300-1359",2019-12-02,78,1,55,133
"6597","1300-1359",2019-12-03,72,2,46,118
"6598","1300-1359",2019-12-04,68,3,57,125
"6599","1300-1359",2019-12-05,70,4,60,130
"6600","1300-1359",2019-12-06,69,5,60,129
"6601","1300-1359",2019-12-07,63,6,58,121
"6602","1300-1359",2019-12-08,68,7,58,126
"6603","1300-1359",2019-12-09,69,1,59,128
"6604","1300-1359",2019-12-10,70,2,57,127
"6605","1300-1359",2019-12-11,69,3,57,126
"6606","1300-1359",2019-12-12,70,4,61,131
"6607","1300-1359",2019-12-13,69,5,61,130
"6608","1300-1359",2019-12-14,63,6,59,122
"6609","1300-1359",2019-12-15,68,7,59,127
"6610","1300-1359",2019-12-16,68,1,60,128
"6611","1300-1359",2019-12-17,70,2,57,127
"6612","1300-1359",2019-12-18,72,3,63,135
"6613","1300-1359",2019-12-19,74,4,64,138
"6614","1300-1359",2019-12-20,73,5,64,137
"6615","1300-1359",2019-12-21,70,6,64,134
"6616","1300-1359",2019-12-22,79,7,70,149
"6617","1300-1359",2019-12-23,74,1,66,140
"6618","1300-1359",2019-12-24,70,2,64,134
"6619","1300-1359",2019-12-25,70,3,65,135
"6620","1300-1359",2019-12-26,76,4,66,142
"6621","1300-1359",2019-12-27,74,5,65,139
"6622","1300-1359",2019-12-28,69,6,66,135
"6623","1300-1359",2019-12-29,79,7,70,149
"6624","1300-1359",2019-12-30,73,1,66,139
"6625","1300-1359",2019-12-31,70,2,70,140
"6626","1400-1459",2019-12-01,73,7,87,160
"6627","1400-1459",2019-12-02,72,1,90,162
"6628","1400-1459",2019-12-03,71,2,87,158
"6629","1400-1459",2019-12-04,66,3,79,145
"6630","1400-1459",2019-12-05,72,4,80,152
"6631","1400-1459",2019-12-06,71,5,82,153
"6632","1400-1459",2019-12-07,65,6,71,136
"6633","1400-1459",2019-12-08,67,7,71,138
"6634","1400-1459",2019-12-09,71,1,81,152
"6635","1400-1459",2019-12-10,65,2,78,143
"6636","1400-1459",2019-12-11,67,3,80,147
"6637","1400-1459",2019-12-12,71,4,79,150
"6638","1400-1459",2019-12-13,71,5,81,152
"6639","1400-1459",2019-12-14,65,6,70,135
"6640","1400-1459",2019-12-15,67,7,70,137
"6641","1400-1459",2019-12-16,71,1,81,152
"6642","1400-1459",2019-12-17,63,2,78,141
"6643","1400-1459",2019-12-18,69,3,87,156
"6644","1400-1459",2019-12-19,73,4,87,160
"6645","1400-1459",2019-12-20,73,5,91,164
"6646","1400-1459",2019-12-21,72,6,82,154
"6647","1400-1459",2019-12-22,76,7,87,163
"6648","1400-1459",2019-12-23,78,1,95,173
"6649","1400-1459",2019-12-24,76,2,86,162
"6650","1400-1459",2019-12-25,76,3,85,161
"6651","1400-1459",2019-12-26,79,4,92,171
"6652","1400-1459",2019-12-27,79,5,96,175
"6653","1400-1459",2019-12-28,73,6,81,154
"6654","1400-1459",2019-12-29,75,7,88,163
"6655","1400-1459",2019-12-30,78,1,95,173
"6656","1400-1459",2019-12-31,75,2,89,164
"6657","1500-1559",2019-12-01,76,7,74,150
"6658","1500-1559",2019-12-02,77,1,79,156
"6659","1500-1559",2019-12-03,70,2,71,141
"6660","1500-1559",2019-12-04,71,3,78,149
"6661","1500-1559",2019-12-05,72,4,84,156
"6662","1500-1559",2019-12-06,73,5,83,156
"6663","1500-1559",2019-12-07,66,6,75,141
"6664","1500-1559",2019-12-08,70,7,81,151
"6665","1500-1559",2019-12-09,72,1,83,155
"6666","1500-1559",2019-12-10,68,2,79,147
"6667","1500-1559",2019-12-11,70,3,80,150
"6668","1500-1559",2019-12-12,72,4,84,156
"6669","1500-1559",2019-12-13,72,5,83,155
"6670","1500-1559",2019-12-14,66,6,75,141
"6671","1500-1559",2019-12-15,70,7,82,152
"6672","1500-1559",2019-12-16,73,1,83,156
"6673","1500-1559",2019-12-17,66,2,77,143
"6674","1500-1559",2019-12-18,79,3,70,149
"6675","1500-1559",2019-12-19,80,4,80,160
"6676","1500-1559",2019-12-20,82,5,79,161
"6677","1500-1559",2019-12-21,80,6,73,153
"6678","1500-1559",2019-12-22,81,7,82,163
"6679","1500-1559",2019-12-23,86,1,80,166
"6680","1500-1559",2019-12-24,71,2,77,148
"6681","1500-1559",2019-12-25,76,3,76,152
"6682","1500-1559",2019-12-26,83,4,82,165
"6683","1500-1559",2019-12-27,86,5,79,165
"6684","1500-1559",2019-12-28,81,6,74,155
"6685","1500-1559",2019-12-29,81,7,80,161
"6686","1500-1559",2019-12-30,86,1,79,165
"6687","1500-1559",2019-12-31,75,2,76,151
"6688","1600-1659",2019-12-01,75,7,90,165
"6689","1600-1659",2019-12-02,76,1,82,158
"6690","1600-1659",2019-12-03,68,2,74,142
"6691","1600-1659",2019-12-04,74,3,71,145
"6692","1600-1659",2019-12-05,80,4,75,155
"6693","1600-1659",2019-12-06,78,5,74,152
"6694","1600-1659",2019-12-07,70,6,72,142
"6695","1600-1659",2019-12-08,78,7,72,150
"6696","1600-1659",2019-12-09,78,1,73,151
"6697","1600-1659",2019-12-10,73,2,70,143
"6698","1600-1659",2019-12-11,76,3,71,147
"6699","1600-1659",2019-12-12,80,4,74,154
"6700","1600-1659",2019-12-13,79,5,74,153
"6701","1600-1659",2019-12-14,69,6,72,141
"6702","1600-1659",2019-12-15,78,7,72,150
"6703","1600-1659",2019-12-16,78,1,74,152
"6704","1600-1659",2019-12-17,73,2,70,143
"6705","1600-1659",2019-12-18,72,3,74,146
"6706","1600-1659",2019-12-19,82,4,81,163
"6707","1600-1659",2019-12-20,80,5,84,164
"6708","1600-1659",2019-12-21,79,6,76,155
"6709","1600-1659",2019-12-22,79,7,84,163
"6710","1600-1659",2019-12-23,80,1,85,165
"6711","1600-1659",2019-12-24,81,2,77,158
"6712","1600-1659",2019-12-25,82,3,73,155
"6713","1600-1659",2019-12-26,80,4,81,161
"6714","1600-1659",2019-12-27,79,5,84,163
"6715","1600-1659",2019-12-28,79,6,77,156
"6716","1600-1659",2019-12-29,79,7,84,163
"6717","1600-1659",2019-12-30,79,1,85,164
"6718","1600-1659",2019-12-31,71,2,76,147
"6719","1700-1759",2019-12-01,80,7,71,151
"6720","1700-1759",2019-12-02,74,1,75,149
"6721","1700-1759",2019-12-03,73,2,68,141
"6722","1700-1759",2019-12-04,73,3,71,144
"6723","1700-1759",2019-12-05,75,4,75,150
"6724","1700-1759",2019-12-06,75,5,73,148
"6725","1700-1759",2019-12-07,64,6,63,127
"6726","1700-1759",2019-12-08,74,7,73,147
"6727","1700-1759",2019-12-09,75,1,72,147
"6728","1700-1759",2019-12-10,72,2,72,144
"6729","1700-1759",2019-12-11,73,3,72,145
"6730","1700-1759",2019-12-12,75,4,75,150
"6731","1700-1759",2019-12-13,75,5,73,148
"6732","1700-1759",2019-12-14,64,6,63,127
"6733","1700-1759",2019-12-15,74,7,73,147
"6734","1700-1759",2019-12-16,75,1,73,148
"6735","1700-1759",2019-12-17,73,2,72,145
"6736","1700-1759",2019-12-18,79,3,76,155
"6737","1700-1759",2019-12-19,79,4,74,153
"6738","1700-1759",2019-12-20,81,5,70,151
"6739","1700-1759",2019-12-21,86,6,81,167
"6740","1700-1759",2019-12-22,88,7,74,162
"6741","1700-1759",2019-12-23,83,1,75,158
"6742","1700-1759",2019-12-24,69,2,73,142
"6743","1700-1759",2019-12-25,67,3,71,138
"6744","1700-1759",2019-12-26,83,4,77,160
"6745","1700-1759",2019-12-27,84,5,75,159
"6746","1700-1759",2019-12-28,86,6,80,166
"6747","1700-1759",2019-12-29,88,7,74,162
"6748","1700-1759",2019-12-30,83,1,75,158
"6749","1700-1759",2019-12-31,71,2,72,143
"6750","1800-1859",2019-12-01,79,7,89,168
"6751","1800-1859",2019-12-02,85,1,88,173
"6752","1800-1859",2019-12-03,75,2,88,163
"6753","1800-1859",2019-12-04,72,3,82,154
"6754","1800-1859",2019-12-05,73,4,87,160
"6755","1800-1859",2019-12-06,72,5,87,159
"6756","1800-1859",2019-12-07,57,6,69,126
"6757","1800-1859",2019-12-08,71,7,81,152
"6758","1800-1859",2019-12-09,72,1,86,158
"6759","1800-1859",2019-12-10,71,2,83,154
"6760","1800-1859",2019-12-11,72,3,83,155
"6761","1800-1859",2019-12-12,73,4,87,160
"6762","1800-1859",2019-12-13,72,5,87,159
"6763","1800-1859",2019-12-14,58,6,69,127
"6764","1800-1859",2019-12-15,71,7,81,152
"6765","1800-1859",2019-12-16,72,1,86,158
"6766","1800-1859",2019-12-17,72,2,83,155
"6767","1800-1859",2019-12-18,80,3,83,163
"6768","1800-1859",2019-12-19,86,4,83,169
"6769","1800-1859",2019-12-20,85,5,83,168
"6770","1800-1859",2019-12-21,76,6,75,151
"6771","1800-1859",2019-12-22,84,7,85,169
"6772","1800-1859",2019-12-23,87,1,85,172
"6773","1800-1859",2019-12-24,68,2,79,147
"6774","1800-1859",2019-12-25,78,3,79,157
"6775","1800-1859",2019-12-26,87,4,84,171
"6776","1800-1859",2019-12-27,86,5,84,170
"6777","1800-1859",2019-12-28,75,6,78,153
"6778","1800-1859",2019-12-29,84,7,85,169
"6779","1800-1859",2019-12-30,87,1,84,171
"6780","1800-1859",2019-12-31,66,2,74,140
"6781","1900-1959",2019-12-01,86,7,79,165
"6782","1900-1959",2019-12-02,85,1,77,162
"6783","1900-1959",2019-12-03,84,2,72,156
"6784","1900-1959",2019-12-04,84,3,73,157
"6785","1900-1959",2019-12-05,85,4,71,156
"6786","1900-1959",2019-12-06,86,5,72,158
"6787","1900-1959",2019-12-07,65,6,62,127
"6788","1900-1959",2019-12-08,85,7,71,156
"6789","1900-1959",2019-12-09,86,1,73,159
"6790","1900-1959",2019-12-10,79,2,73,152
"6791","1900-1959",2019-12-11,84,3,72,156
"6792","1900-1959",2019-12-12,85,4,72,157
"6793","1900-1959",2019-12-13,87,5,72,159
"6794","1900-1959",2019-12-14,65,6,61,126
"6795","1900-1959",2019-12-15,85,7,70,155
"6796","1900-1959",2019-12-16,86,1,73,159
"6797","1900-1959",2019-12-17,80,2,73,153
"6798","1900-1959",2019-12-18,85,3,81,166
"6799","1900-1959",2019-12-19,81,4,79,160
"6800","1900-1959",2019-12-20,82,5,80,162
"6801","1900-1959",2019-12-21,78,6,77,155
"6802","1900-1959",2019-12-22,75,7,83,158
"6803","1900-1959",2019-12-23,80,1,80,160
"6804","1900-1959",2019-12-24,67,2,71,138
"6805","1900-1959",2019-12-25,68,3,74,142
"6806","1900-1959",2019-12-26,79,4,80,159
"6807","1900-1959",2019-12-27,82,5,80,162
"6808","1900-1959",2019-12-28,80,6,77,157
"6809","1900-1959",2019-12-29,75,7,83,158
"6810","1900-1959",2019-12-30,82,1,80,162
"6811","1900-1959",2019-12-31,67,2,70,137
"6812","2000-2059",2019-12-01,65,7,92,157
"6813","2000-2059",2019-12-02,52,1,87,139
"6814","2000-2059",2019-12-03,48,2,85,133
"6815","2000-2059",2019-12-04,51,3,82,133
"6816","2000-2059",2019-12-05,52,4,83,135
"6817","2000-2059",2019-12-06,52,5,84,136
"6818","2000-2059",2019-12-07,36,6,73,109
"6819","2000-2059",2019-12-08,55,7,82,137
"6820","2000-2059",2019-12-09,52,1,83,135
"6821","2000-2059",2019-12-10,49,2,82,131
"6822","2000-2059",2019-12-11,51,3,81,132
"6823","2000-2059",2019-12-12,52,4,83,135
"6824","2000-2059",2019-12-13,52,5,86,138
"6825","2000-2059",2019-12-14,36,6,73,109
"6826","2000-2059",2019-12-15,55,7,83,138
"6827","2000-2059",2019-12-16,52,1,83,135
"6828","2000-2059",2019-12-17,48,2,82,130
"6829","2000-2059",2019-12-18,54,3,83,137
"6830","2000-2059",2019-12-19,59,4,97,156
"6831","2000-2059",2019-12-20,59,5,96,155
"6832","2000-2059",2019-12-21,56,6,88,144
"6833","2000-2059",2019-12-22,69,7,98,167
"6834","2000-2059",2019-12-23,58,1,96,154
"6835","2000-2059",2019-12-24,45,2,82,127
"6836","2000-2059",2019-12-25,55,3,89,144
"6837","2000-2059",2019-12-26,58,4,94,152
"6838","2000-2059",2019-12-27,56,5,96,152
"6839","2000-2059",2019-12-28,56,6,87,143
"6840","2000-2059",2019-12-29,69,7,98,167
"6841","2000-2059",2019-12-30,56,1,96,152
"6842","2000-2059",2019-12-31,41,2,90,131
"6843","2100-2159",2019-12-01,63,7,83,146
"6844","2100-2159",2019-12-02,61,1,87,148
"6845","2100-2159",2019-12-03,57,2,83,140
"6846","2100-2159",2019-12-04,55,3,86,141
"6847","2100-2159",2019-12-05,57,4,87,144
"6848","2100-2159",2019-12-06,57,5,88,145
"6849","2100-2159",2019-12-07,34,6,67,101
"6850","2100-2159",2019-12-08,58,7,86,144
"6851","2100-2159",2019-12-09,57,1,88,145
"6852","2100-2159",2019-12-10,53,2,86,139
"6853","2100-2159",2019-12-11,55,3,88,143
"6854","2100-2159",2019-12-12,57,4,87,144
"6855","2100-2159",2019-12-13,57,5,87,144
"6856","2100-2159",2019-12-14,35,6,68,103
"6857","2100-2159",2019-12-15,58,7,86,144
"6858","2100-2159",2019-12-16,57,1,88,145
"6859","2100-2159",2019-12-17,55,2,83,138
"6860","2100-2159",2019-12-18,59,3,93,152
"6861","2100-2159",2019-12-19,65,4,90,155
"6862","2100-2159",2019-12-20,63,5,92,155
"6863","2100-2159",2019-12-21,66,6,80,146
"6864","2100-2159",2019-12-22,63,7,89,152
"6865","2100-2159",2019-12-23,66,1,95,161
"6866","2100-2159",2019-12-24,45,2,83,128
"6867","2100-2159",2019-12-25,47,3,84,131
"6868","2100-2159",2019-12-26,65,4,96,161
"6869","2100-2159",2019-12-27,67,5,95,162
"6870","2100-2159",2019-12-28,65,6,83,148
"6871","2100-2159",2019-12-29,63,7,88,151
"6872","2100-2159",2019-12-30,65,1,94,159
"6873","2100-2159",2019-12-31,37,2,71,108
"6874","2200-2259",2019-12-01,58,7,91,149
"6875","2200-2259",2019-12-02,48,1,82,130
"6876","2200-2259",2019-12-03,45,2,81,126
"6877","2200-2259",2019-12-04,50,3,81,131
"6878","2200-2259",2019-12-05,53,4,84,137
"6879","2200-2259",2019-12-06,52,5,84,136
"6880","2200-2259",2019-12-07,36,6,65,101
"6881","2200-2259",2019-12-08,52,7,81,133
"6882","2200-2259",2019-12-09,53,1,84,137
"6883","2200-2259",2019-12-10,49,2,74,123
"6884","2200-2259",2019-12-11,50,3,81,131
"6885","2200-2259",2019-12-12,53,4,84,137
"6886","2200-2259",2019-12-13,52,5,84,136
"6887","2200-2259",2019-12-14,36,6,65,101
"6888","2200-2259",2019-12-15,52,7,81,133
"6889","2200-2259",2019-12-16,53,1,84,137
"6890","2200-2259",2019-12-17,48,2,77,125
"6891","2200-2259",2019-12-18,51,3,83,134
"6892","2200-2259",2019-12-19,58,4,84,142
"6893","2200-2259",2019-12-20,58,5,83,141
"6894","2200-2259",2019-12-21,53,6,83,136
"6895","2200-2259",2019-12-22,64,7,81,145
"6896","2200-2259",2019-12-23,60,1,78,138
"6897","2200-2259",2019-12-24,40,2,59,99
"6898","2200-2259",2019-12-25,46,3,69,115
"6899","2200-2259",2019-12-26,60,4,78,138
"6900","2200-2259",2019-12-27,60,5,79,139
"6901","2200-2259",2019-12-28,54,6,82,136
"6902","2200-2259",2019-12-29,63,7,81,144
"6903","2200-2259",2019-12-30,60,1,78,138
"6904","2200-2259",2019-12-31,37,2,55,92
"6905","2300-2359",2019-12-01,35,7,77,112
"6906","2300-2359",2019-12-02,30,1,77,107
"6907","2300-2359",2019-12-03,25,2,70,95
"6908","2300-2359",2019-12-04,20,3,70,90
"6909","2300-2359",2019-12-05,22,4,76,98
"6910","2300-2359",2019-12-06,22,5,74,96
"6911","2300-2359",2019-12-07,20,6,45,65
"6912","2300-2359",2019-12-08,22,7,74,96
"6913","2300-2359",2019-12-09,20,1,74,94
"6914","2300-2359",2019-12-10,16,2,67,83
"6915","2300-2359",2019-12-11,20,3,70,90
"6916","2300-2359",2019-12-12,21,4,76,97
"6917","2300-2359",2019-12-13,22,5,74,96
"6918","2300-2359",2019-12-14,20,6,45,65
"6919","2300-2359",2019-12-15,22,7,74,96
"6920","2300-2359",2019-12-16,20,1,74,94
"6921","2300-2359",2019-12-17,16,2,66,82
"6922","2300-2359",2019-12-18,24,3,71,95
"6923","2300-2359",2019-12-19,29,4,78,107
"6924","2300-2359",2019-12-20,29,5,80,109
"6925","2300-2359",2019-12-21,32,6,89,121
"6926","2300-2359",2019-12-22,32,7,85,117
"6927","2300-2359",2019-12-23,31,1,88,119
"6928","2300-2359",2019-12-24,25,2,55,80
"6929","2300-2359",2019-12-25,26,3,70,96
"6930","2300-2359",2019-12-26,32,4,88,120
"6931","2300-2359",2019-12-27,32,5,89,121
"6932","2300-2359",2019-12-28,32,6,87,119
"6933","2300-2359",2019-12-29,32,7,85,117
"6934","2300-2359",2019-12-30,31,1,88,119
"6935","2300-2359",2019-12-31,26,2,55,81
"6936","0001-0559",2018-12-01,21,6,49,70
"6937","0001-0559",2018-12-02,22,7,70,92
"6938","0001-0559",2018-12-03,28,1,67,95
"6939","0001-0559",2018-12-04,27,2,62,89
"6940","0001-0559",2018-12-05,27,3,69,96
"6941","0001-0559",2018-12-06,29,4,70,99
"6942","0001-0559",2018-12-07,28,5,72,100
"6943","0001-0559",2018-12-08,21,6,51,72
"6944","0001-0559",2018-12-09,22,7,70,92
"6945","0001-0559",2018-12-10,28,1,68,96
"6946","0001-0559",2018-12-11,27,2,63,90
"6947","0001-0559",2018-12-12,28,3,68,96
"6948","0001-0559",2018-12-13,28,4,71,99
"6949","0001-0559",2018-12-14,28,5,71,99
"6950","0001-0559",2018-12-15,21,6,51,72
"6951","0001-0559",2018-12-16,23,7,70,93
"6952","0001-0559",2018-12-17,28,1,67,95
"6953","0001-0559",2018-12-18,27,2,68,95
"6954","0001-0559",2018-12-19,31,3,82,113
"6955","0001-0559",2018-12-20,31,4,95,126
"6956","0001-0559",2018-12-21,36,5,97,133
"6957","0001-0559",2018-12-22,33,6,85,118
"6958","0001-0559",2018-12-23,32,7,97,129
"6959","0001-0559",2018-12-24,27,1,53,80
"6960","0001-0559",2018-12-25,19,2,60,79
"6961","0001-0559",2018-12-26,38,3,98,136
"6962","0001-0559",2018-12-27,38,4,98,136
"6963","0001-0559",2018-12-28,38,5,98,136
"6964","0001-0559",2018-12-29,33,6,85,118
"6965","0001-0559",2018-12-30,31,7,97,128
"6966","0001-0559",2018-12-31,29,1,56,85
"6967","0600-0659",2018-12-01,85,6,18,103
"6968","0600-0659",2018-12-02,85,7,23,108
"6969","0600-0659",2018-12-03,112,1,24,136
"6970","0600-0659",2018-12-04,107,2,20,127
"6971","0600-0659",2018-12-05,103,3,23,126
"6972","0600-0659",2018-12-06,113,4,24,137
"6973","0600-0659",2018-12-07,112,5,23,135
"6974","0600-0659",2018-12-08,83,6,17,100
"6975","0600-0659",2018-12-09,85,7,23,108
"6976","0600-0659",2018-12-10,112,1,24,136
"6977","0600-0659",2018-12-11,107,2,20,127
"6978","0600-0659",2018-12-12,102,3,24,126
"6979","0600-0659",2018-12-13,113,4,24,137
"6980","0600-0659",2018-12-14,112,5,24,136
"6981","0600-0659",2018-12-15,82,6,18,100
"6982","0600-0659",2018-12-16,85,7,24,109
"6983","0600-0659",2018-12-17,112,1,24,136
"6984","0600-0659",2018-12-18,108,2,22,130
"6985","0600-0659",2018-12-19,117,3,33,150
"6986","0600-0659",2018-12-20,114,4,32,146
"6987","0600-0659",2018-12-21,115,5,36,151
"6988","0600-0659",2018-12-22,108,6,36,144
"6989","0600-0659",2018-12-23,111,7,34,145
"6990","0600-0659",2018-12-24,100,1,28,128
"6991","0600-0659",2018-12-25,84,2,27,111
"6992","0600-0659",2018-12-26,115,3,39,154
"6993","0600-0659",2018-12-27,114,4,39,153
"6994","0600-0659",2018-12-28,115,5,38,153
"6995","0600-0659",2018-12-29,108,6,35,143
"6996","0600-0659",2018-12-30,112,7,34,146
"6997","0600-0659",2018-12-31,110,1,29,139
"6998","0700-0759",2018-12-01,76,6,52,128
"6999","0700-0759",2018-12-02,83,7,52,135
"7000","0700-0759",2018-12-03,92,1,64,156
"7001","0700-0759",2018-12-04,87,2,62,149
"7002","0700-0759",2018-12-05,89,3,59,148
"7003","0700-0759",2018-12-06,96,4,64,160
"7004","0700-0759",2018-12-07,94,5,64,158
"7005","0700-0759",2018-12-08,77,6,52,129
"7006","0700-0759",2018-12-09,83,7,52,135
"7007","0700-0759",2018-12-10,92,1,64,156
"7008","0700-0759",2018-12-11,88,2,62,150
"7009","0700-0759",2018-12-12,90,3,59,149
"7010","0700-0759",2018-12-13,96,4,64,160
"7011","0700-0759",2018-12-14,94,5,64,158
"7012","0700-0759",2018-12-15,77,6,52,129
"7013","0700-0759",2018-12-16,84,7,52,136
"7014","0700-0759",2018-12-17,93,1,64,157
"7015","0700-0759",2018-12-18,88,2,63,151
"7016","0700-0759",2018-12-19,103,3,61,164
"7017","0700-0759",2018-12-20,107,4,61,168
"7018","0700-0759",2018-12-21,104,5,64,168
"7019","0700-0759",2018-12-22,98,6,58,156
"7020","0700-0759",2018-12-23,109,7,64,173
"7021","0700-0759",2018-12-24,96,1,57,153
"7022","0700-0759",2018-12-25,90,2,45,135
"7023","0700-0759",2018-12-26,102,3,67,169
"7024","0700-0759",2018-12-27,106,4,67,173
"7025","0700-0759",2018-12-28,104,5,67,171
"7026","0700-0759",2018-12-29,98,6,58,156
"7027","0700-0759",2018-12-30,109,7,64,173
"7028","0700-0759",2018-12-31,97,1,65,162
"7029","0800-0859",2018-12-01,105,6,58,163
"7030","0800-0859",2018-12-02,105,7,61,166
"7031","0800-0859",2018-12-03,110,1,76,186
"7032","0800-0859",2018-12-04,106,2,72,178
"7033","0800-0859",2018-12-05,107,3,74,181
"7034","0800-0859",2018-12-06,109,4,78,187
"7035","0800-0859",2018-12-07,110,5,77,187
"7036","0800-0859",2018-12-08,104,6,56,160
"7037","0800-0859",2018-12-09,104,7,60,164
"7038","0800-0859",2018-12-10,110,1,76,186
"7039","0800-0859",2018-12-11,106,2,72,178
"7040","0800-0859",2018-12-12,107,3,74,181
"7041","0800-0859",2018-12-13,108,4,78,186
"7042","0800-0859",2018-12-14,111,5,77,188
"7043","0800-0859",2018-12-15,104,6,55,159
"7044","0800-0859",2018-12-16,103,7,60,163
"7045","0800-0859",2018-12-17,109,1,76,185
"7046","0800-0859",2018-12-18,106,2,72,178
"7047","0800-0859",2018-12-19,112,3,76,188
"7048","0800-0859",2018-12-20,112,4,71,183
"7049","0800-0859",2018-12-21,114,5,71,185
"7050","0800-0859",2018-12-22,104,6,66,170
"7051","0800-0859",2018-12-23,108,7,67,175
"7052","0800-0859",2018-12-24,106,1,59,165
"7053","0800-0859",2018-12-25,98,2,50,148
"7054","0800-0859",2018-12-26,115,3,67,182
"7055","0800-0859",2018-12-27,115,4,67,182
"7056","0800-0859",2018-12-28,114,5,67,181
"7057","0800-0859",2018-12-29,105,6,66,171
"7058","0800-0859",2018-12-30,109,7,67,176
"7059","0800-0859",2018-12-31,107,1,59,166
"7060","0900-0959",2018-12-01,71,6,47,118
"7061","0900-0959",2018-12-02,83,7,48,131
"7062","0900-0959",2018-12-03,86,1,55,141
"7063","0900-0959",2018-12-04,83,2,52,135
"7064","0900-0959",2018-12-05,83,3,50,133
"7065","0900-0959",2018-12-06,88,4,55,143
"7066","0900-0959",2018-12-07,87,5,54,141
"7067","0900-0959",2018-12-08,71,6,48,119
"7068","0900-0959",2018-12-09,83,7,48,131
"7069","0900-0959",2018-12-10,86,1,55,141
"7070","0900-0959",2018-12-11,83,2,53,136
"7071","0900-0959",2018-12-12,82,3,50,132
"7072","0900-0959",2018-12-13,89,4,55,144
"7073","0900-0959",2018-12-14,86,5,54,140
"7074","0900-0959",2018-12-15,71,6,48,119
"7075","0900-0959",2018-12-16,82,7,49,131
"7076","0900-0959",2018-12-17,87,1,55,142
"7077","0900-0959",2018-12-18,85,2,54,139
"7078","0900-0959",2018-12-19,89,3,63,152
"7079","0900-0959",2018-12-20,87,4,68,155
"7080","0900-0959",2018-12-21,85,5,66,151
"7081","0900-0959",2018-12-22,81,6,57,138
"7082","0900-0959",2018-12-23,87,7,65,152
"7083","0900-0959",2018-12-24,82,1,60,142
"7084","0900-0959",2018-12-25,78,2,54,132
"7085","0900-0959",2018-12-26,86,3,65,151
"7086","0900-0959",2018-12-27,88,4,68,156
"7087","0900-0959",2018-12-28,85,5,66,151
"7088","0900-0959",2018-12-29,81,6,57,138
"7089","0900-0959",2018-12-30,88,7,65,153
"7090","0900-0959",2018-12-31,81,1,61,142
"7091","1000-1059",2018-12-01,59,6,56,115
"7092","1000-1059",2018-12-02,68,7,65,133
"7093","1000-1059",2018-12-03,76,1,70,146
"7094","1000-1059",2018-12-04,72,2,63,135
"7095","1000-1059",2018-12-05,72,3,64,136
"7096","1000-1059",2018-12-06,75,4,69,144
"7097","1000-1059",2018-12-07,76,5,70,146
"7098","1000-1059",2018-12-08,59,6,53,112
"7099","1000-1059",2018-12-09,68,7,64,132
"7100","1000-1059",2018-12-10,76,1,70,146
"7101","1000-1059",2018-12-11,72,2,63,135
"7102","1000-1059",2018-12-12,72,3,63,135
"7103","1000-1059",2018-12-13,75,4,68,143
"7104","1000-1059",2018-12-14,76,5,71,147
"7105","1000-1059",2018-12-15,59,6,53,112
"7106","1000-1059",2018-12-16,68,7,63,131
"7107","1000-1059",2018-12-17,76,1,70,146
"7108","1000-1059",2018-12-18,73,2,63,136
"7109","1000-1059",2018-12-19,76,3,74,150
"7110","1000-1059",2018-12-20,76,4,73,149
"7111","1000-1059",2018-12-21,76,5,72,148
"7112","1000-1059",2018-12-22,61,6,71,132
"7113","1000-1059",2018-12-23,71,7,74,145
"7114","1000-1059",2018-12-24,73,1,70,143
"7115","1000-1059",2018-12-25,69,2,61,130
"7116","1000-1059",2018-12-26,75,3,75,150
"7117","1000-1059",2018-12-27,77,4,75,152
"7118","1000-1059",2018-12-28,77,5,75,152
"7119","1000-1059",2018-12-29,63,6,71,134
"7120","1000-1059",2018-12-30,71,7,74,145
"7121","1000-1059",2018-12-31,76,1,70,146
"7122","1100-1159",2018-12-01,68,6,61,129
"7123","1100-1159",2018-12-02,78,7,67,145
"7124","1100-1159",2018-12-03,83,1,76,159
"7125","1100-1159",2018-12-04,80,2,75,155
"7126","1100-1159",2018-12-05,80,3,76,156
"7127","1100-1159",2018-12-06,82,4,78,160
"7128","1100-1159",2018-12-07,83,5,78,161
"7129","1100-1159",2018-12-08,67,6,63,130
"7130","1100-1159",2018-12-09,77,7,68,145
"7131","1100-1159",2018-12-10,82,1,76,158
"7132","1100-1159",2018-12-11,79,2,75,154
"7133","1100-1159",2018-12-12,79,3,76,155
"7134","1100-1159",2018-12-13,82,4,79,161
"7135","1100-1159",2018-12-14,82,5,77,159
"7136","1100-1159",2018-12-15,67,6,64,131
"7137","1100-1159",2018-12-16,76,7,67,143
"7138","1100-1159",2018-12-17,82,1,77,159
"7139","1100-1159",2018-12-18,79,2,76,155
"7140","1100-1159",2018-12-19,88,3,79,167
"7141","1100-1159",2018-12-20,85,4,71,156
"7142","1100-1159",2018-12-21,83,5,72,155
"7143","1100-1159",2018-12-22,88,6,71,159
"7144","1100-1159",2018-12-23,91,7,68,159
"7145","1100-1159",2018-12-24,90,1,75,165
"7146","1100-1159",2018-12-25,86,2,73,159
"7147","1100-1159",2018-12-26,92,3,70,162
"7148","1100-1159",2018-12-27,91,4,71,162
"7149","1100-1159",2018-12-28,90,5,71,161
"7150","1100-1159",2018-12-29,89,6,71,160
"7151","1100-1159",2018-12-30,93,7,69,162
"7152","1100-1159",2018-12-31,89,1,75,164
"7153","1200-1259",2018-12-01,57,6,67,124
"7154","1200-1259",2018-12-02,72,7,76,148
"7155","1200-1259",2018-12-03,64,1,74,138
"7156","1200-1259",2018-12-04,65,2,71,136
"7157","1200-1259",2018-12-05,64,3,72,136
"7158","1200-1259",2018-12-06,67,4,75,142
"7159","1200-1259",2018-12-07,66,5,77,143
"7160","1200-1259",2018-12-08,58,6,67,125
"7161","1200-1259",2018-12-09,73,7,75,148
"7162","1200-1259",2018-12-10,65,1,74,139
"7163","1200-1259",2018-12-11,66,2,71,137
"7164","1200-1259",2018-12-12,65,3,72,137
"7165","1200-1259",2018-12-13,68,4,75,143
"7166","1200-1259",2018-12-14,65,5,76,141
"7167","1200-1259",2018-12-15,59,6,67,126
"7168","1200-1259",2018-12-16,72,7,74,146
"7169","1200-1259",2018-12-17,66,1,74,140
"7170","1200-1259",2018-12-18,67,2,72,139
"7171","1200-1259",2018-12-19,76,3,77,153
"7172","1200-1259",2018-12-20,75,4,84,159
"7173","1200-1259",2018-12-21,73,5,83,156
"7174","1200-1259",2018-12-22,75,6,73,148
"7175","1200-1259",2018-12-23,77,7,82,159
"7176","1200-1259",2018-12-24,67,1,77,144
"7177","1200-1259",2018-12-25,68,2,81,149
"7178","1200-1259",2018-12-26,76,3,83,159
"7179","1200-1259",2018-12-27,79,4,84,163
"7180","1200-1259",2018-12-28,78,5,82,160
"7181","1200-1259",2018-12-29,75,6,73,148
"7182","1200-1259",2018-12-30,77,7,82,159
"7183","1200-1259",2018-12-31,69,1,81,150
"7184","1300-1359",2018-12-01,64,6,48,112
"7185","1300-1359",2018-12-02,71,7,57,128
"7186","1300-1359",2018-12-03,78,1,62,140
"7187","1300-1359",2018-12-04,75,2,61,136
"7188","1300-1359",2018-12-05,76,3,62,138
"7189","1300-1359",2018-12-06,76,4,63,139
"7190","1300-1359",2018-12-07,78,5,61,139
"7191","1300-1359",2018-12-08,64,6,47,111
"7192","1300-1359",2018-12-09,70,7,56,126
"7193","1300-1359",2018-12-10,77,1,61,138
"7194","1300-1359",2018-12-11,75,2,60,135
"7195","1300-1359",2018-12-12,76,3,61,137
"7196","1300-1359",2018-12-13,76,4,63,139
"7197","1300-1359",2018-12-14,77,5,61,138
"7198","1300-1359",2018-12-15,64,6,47,111
"7199","1300-1359",2018-12-16,69,7,56,125
"7200","1300-1359",2018-12-17,77,1,61,138
"7201","1300-1359",2018-12-18,75,2,60,135
"7202","1300-1359",2018-12-19,79,3,67,146
"7203","1300-1359",2018-12-20,71,4,65,136
"7204","1300-1359",2018-12-21,73,5,65,138
"7205","1300-1359",2018-12-22,68,6,74,142
"7206","1300-1359",2018-12-23,72,7,71,143
"7207","1300-1359",2018-12-24,78,1,73,151
"7208","1300-1359",2018-12-25,76,2,67,143
"7209","1300-1359",2018-12-26,74,3,76,150
"7210","1300-1359",2018-12-27,73,4,74,147
"7211","1300-1359",2018-12-28,72,5,74,146
"7212","1300-1359",2018-12-29,69,6,75,144
"7213","1300-1359",2018-12-30,73,7,74,147
"7214","1300-1359",2018-12-31,81,1,73,154
"7215","1400-1459",2018-12-01,64,6,79,143
"7216","1400-1459",2018-12-02,68,7,78,146
"7217","1400-1459",2018-12-03,71,1,83,154
"7218","1400-1459",2018-12-04,69,2,82,151
"7219","1400-1459",2018-12-05,70,3,81,151
"7220","1400-1459",2018-12-06,72,4,83,155
"7221","1400-1459",2018-12-07,71,5,83,154
"7222","1400-1459",2018-12-08,64,6,81,145
"7223","1400-1459",2018-12-09,68,7,80,148
"7224","1400-1459",2018-12-10,71,1,84,155
"7225","1400-1459",2018-12-11,69,2,83,152
"7226","1400-1459",2018-12-12,71,3,82,153
"7227","1400-1459",2018-12-13,72,4,83,155
"7228","1400-1459",2018-12-14,71,5,83,154
"7229","1400-1459",2018-12-15,64,6,80,144
"7230","1400-1459",2018-12-16,68,7,80,148
"7231","1400-1459",2018-12-17,71,1,84,155
"7232","1400-1459",2018-12-18,69,2,83,152
"7233","1400-1459",2018-12-19,70,3,93,163
"7234","1400-1459",2018-12-20,75,4,89,164
"7235","1400-1459",2018-12-21,75,5,88,163
"7236","1400-1459",2018-12-22,77,6,76,153
"7237","1400-1459",2018-12-23,81,7,90,171
"7238","1400-1459",2018-12-24,68,1,81,149
"7239","1400-1459",2018-12-25,67,2,80,147
"7240","1400-1459",2018-12-26,83,3,90,173
"7241","1400-1459",2018-12-27,82,4,92,174
"7242","1400-1459",2018-12-28,83,5,91,174
"7243","1400-1459",2018-12-29,76,6,77,153
"7244","1400-1459",2018-12-30,80,7,91,171
"7245","1400-1459",2018-12-31,68,1,85,153
"7246","1500-1559",2018-12-01,76,6,62,138
"7247","1500-1559",2018-12-02,83,7,70,153
"7248","1500-1559",2018-12-03,81,1,74,155
"7249","1500-1559",2018-12-04,79,2,72,151
"7250","1500-1559",2018-12-05,79,3,72,151
"7251","1500-1559",2018-12-06,82,4,74,156
"7252","1500-1559",2018-12-07,82,5,73,155
"7253","1500-1559",2018-12-08,75,6,62,137
"7254","1500-1559",2018-12-09,84,7,68,152
"7255","1500-1559",2018-12-10,82,1,73,155
"7256","1500-1559",2018-12-11,79,2,72,151
"7257","1500-1559",2018-12-12,79,3,73,152
"7258","1500-1559",2018-12-13,83,4,74,157
"7259","1500-1559",2018-12-14,82,5,73,155
"7260","1500-1559",2018-12-15,76,6,62,138
"7261","1500-1559",2018-12-16,84,7,68,152
"7262","1500-1559",2018-12-17,82,1,73,155
"7263","1500-1559",2018-12-18,80,2,73,153
"7264","1500-1559",2018-12-19,92,3,74,166
"7265","1500-1559",2018-12-20,89,4,74,163
"7266","1500-1559",2018-12-21,88,5,73,161
"7267","1500-1559",2018-12-22,87,6,71,158
"7268","1500-1559",2018-12-23,89,7,76,165
"7269","1500-1559",2018-12-24,84,1,73,157
"7270","1500-1559",2018-12-25,85,2,69,154
"7271","1500-1559",2018-12-26,91,3,74,165
"7272","1500-1559",2018-12-27,91,4,76,167
"7273","1500-1559",2018-12-28,90,5,76,166
"7274","1500-1559",2018-12-29,87,6,71,158
"7275","1500-1559",2018-12-30,89,7,76,165
"7276","1500-1559",2018-12-31,89,1,74,163
"7277","1600-1659",2018-12-01,65,6,69,134
"7278","1600-1659",2018-12-02,77,7,83,160
"7279","1600-1659",2018-12-03,77,1,79,156
"7280","1600-1659",2018-12-04,76,2,79,155
"7281","1600-1659",2018-12-05,78,3,79,157
"7282","1600-1659",2018-12-06,78,4,80,158
"7283","1600-1659",2018-12-07,80,5,79,159
"7284","1600-1659",2018-12-08,62,6,69,131
"7285","1600-1659",2018-12-09,75,7,84,159
"7286","1600-1659",2018-12-10,77,1,79,156
"7287","1600-1659",2018-12-11,75,2,79,154
"7288","1600-1659",2018-12-12,77,3,79,156
"7289","1600-1659",2018-12-13,78,4,81,159
"7290","1600-1659",2018-12-14,80,5,79,159
"7291","1600-1659",2018-12-15,61,6,69,130
"7292","1600-1659",2018-12-16,75,7,84,159
"7293","1600-1659",2018-12-17,77,1,80,157
"7294","1600-1659",2018-12-18,77,2,79,156
"7295","1600-1659",2018-12-19,82,3,86,168
"7296","1600-1659",2018-12-20,83,4,84,167
"7297","1600-1659",2018-12-21,84,5,82,166
"7298","1600-1659",2018-12-22,87,6,80,167
"7299","1600-1659",2018-12-23,88,7,82,170
"7300","1600-1659",2018-12-24,79,1,75,154
"7301","1600-1659",2018-12-25,77,2,76,153
"7302","1600-1659",2018-12-26,87,3,85,172
"7303","1600-1659",2018-12-27,87,4,83,170
"7304","1600-1659",2018-12-28,87,5,83,170
"7305","1600-1659",2018-12-29,88,6,81,169
"7306","1600-1659",2018-12-30,89,7,82,171
"7307","1600-1659",2018-12-31,75,1,74,149
"7308","1700-1759",2018-12-01,62,6,66,128
"7309","1700-1759",2018-12-02,79,7,71,150
"7310","1700-1759",2018-12-03,74,1,76,150
"7311","1700-1759",2018-12-04,73,2,72,145
"7312","1700-1759",2018-12-05,73,3,72,145
"7313","1700-1759",2018-12-06,78,4,75,153
"7314","1700-1759",2018-12-07,76,5,76,152
"7315","1700-1759",2018-12-08,61,6,63,124
"7316","1700-1759",2018-12-09,81,7,70,151
"7317","1700-1759",2018-12-10,75,1,76,151
"7318","1700-1759",2018-12-11,74,2,71,145
"7319","1700-1759",2018-12-12,74,3,70,144
"7320","1700-1759",2018-12-13,78,4,76,154
"7321","1700-1759",2018-12-14,76,5,75,151
"7322","1700-1759",2018-12-15,62,6,64,126
"7323","1700-1759",2018-12-16,81,7,69,150
"7324","1700-1759",2018-12-17,75,1,76,151
"7325","1700-1759",2018-12-18,71,2,72,143
"7326","1700-1759",2018-12-19,86,3,82,168
"7327","1700-1759",2018-12-20,86,4,85,171
"7328","1700-1759",2018-12-21,85,5,85,170
"7329","1700-1759",2018-12-22,78,6,87,165
"7330","1700-1759",2018-12-23,86,7,91,177
"7331","1700-1759",2018-12-24,69,1,85,154
"7332","1700-1759",2018-12-25,73,2,81,154
"7333","1700-1759",2018-12-26,85,3,94,179
"7334","1700-1759",2018-12-27,84,4,93,177
"7335","1700-1759",2018-12-28,85,5,93,178
"7336","1700-1759",2018-12-29,78,6,88,166
"7337","1700-1759",2018-12-30,85,7,90,175
"7338","1700-1759",2018-12-31,71,1,84,155
"7339","1800-1859",2018-12-01,71,6,72,143
"7340","1800-1859",2018-12-02,78,7,87,165
"7341","1800-1859",2018-12-03,79,1,83,162
"7342","1800-1859",2018-12-04,72,2,81,153
"7343","1800-1859",2018-12-05,74,3,81,155
"7344","1800-1859",2018-12-06,81,4,87,168
"7345","1800-1859",2018-12-07,82,5,88,170
"7346","1800-1859",2018-12-08,70,6,71,141
"7347","1800-1859",2018-12-09,77,7,87,164
"7348","1800-1859",2018-12-10,80,1,84,164
"7349","1800-1859",2018-12-11,72,2,82,154
"7350","1800-1859",2018-12-12,72,3,83,155
"7351","1800-1859",2018-12-13,82,4,87,169
"7352","1800-1859",2018-12-14,83,5,87,170
"7353","1800-1859",2018-12-15,72,6,71,143
"7354","1800-1859",2018-12-16,76,7,86,162
"7355","1800-1859",2018-12-17,80,1,84,164
"7356","1800-1859",2018-12-18,73,2,83,156
"7357","1800-1859",2018-12-19,73,3,92,165
"7358","1800-1859",2018-12-20,73,4,87,160
"7359","1800-1859",2018-12-21,73,5,84,157
"7360","1800-1859",2018-12-22,87,6,83,170
"7361","1800-1859",2018-12-23,82,7,87,169
"7362","1800-1859",2018-12-24,67,1,73,140
"7363","1800-1859",2018-12-25,71,2,73,144
"7364","1800-1859",2018-12-26,83,3,86,169
"7365","1800-1859",2018-12-27,82,4,86,168
"7366","1800-1859",2018-12-28,83,5,84,167
"7367","1800-1859",2018-12-29,86,6,85,171
"7368","1800-1859",2018-12-30,82,7,88,170
"7369","1800-1859",2018-12-31,70,1,78,148
"7370","1900-1959",2018-12-01,52,6,66,118
"7371","1900-1959",2018-12-02,74,7,70,144
"7372","1900-1959",2018-12-03,73,1,71,144
"7373","1900-1959",2018-12-04,69,2,73,142
"7374","1900-1959",2018-12-05,71,3,72,143
"7375","1900-1959",2018-12-06,75,4,72,147
"7376","1900-1959",2018-12-07,75,5,71,146
"7377","1900-1959",2018-12-08,51,6,64,115
"7378","1900-1959",2018-12-09,74,7,69,143
"7379","1900-1959",2018-12-10,74,1,71,145
"7380","1900-1959",2018-12-11,70,2,71,141
"7381","1900-1959",2018-12-12,71,3,70,141
"7382","1900-1959",2018-12-13,75,4,72,147
"7383","1900-1959",2018-12-14,75,5,71,146
"7384","1900-1959",2018-12-15,51,6,65,116
"7385","1900-1959",2018-12-16,74,7,68,142
"7386","1900-1959",2018-12-17,74,1,71,145
"7387","1900-1959",2018-12-18,69,2,67,136
"7388","1900-1959",2018-12-19,89,3,66,155
"7389","1900-1959",2018-12-20,84,4,66,150
"7390","1900-1959",2018-12-21,83,5,66,149
"7391","1900-1959",2018-12-22,74,6,72,146
"7392","1900-1959",2018-12-23,79,7,68,147
"7393","1900-1959",2018-12-24,60,1,58,118
"7394","1900-1959",2018-12-25,68,2,61,129
"7395","1900-1959",2018-12-26,83,3,69,152
"7396","1900-1959",2018-12-27,82,4,70,152
"7397","1900-1959",2018-12-28,80,5,70,150
"7398","1900-1959",2018-12-29,75,6,71,146
"7399","1900-1959",2018-12-30,80,7,67,147
"7400","1900-1959",2018-12-31,62,1,62,124
"7401","2000-2059",2018-12-01,47,6,74,121
"7402","2000-2059",2018-12-02,57,7,87,144
"7403","2000-2059",2018-12-03,56,1,87,143
"7404","2000-2059",2018-12-04,53,2,84,137
"7405","2000-2059",2018-12-05,57,3,85,142
"7406","2000-2059",2018-12-06,60,4,88,148
"7407","2000-2059",2018-12-07,59,5,89,148
"7408","2000-2059",2018-12-08,46,6,75,121
"7409","2000-2059",2018-12-09,57,7,88,145
"7410","2000-2059",2018-12-10,54,1,90,144
"7411","2000-2059",2018-12-11,51,2,86,137
"7412","2000-2059",2018-12-12,54,3,86,140
"7413","2000-2059",2018-12-13,59,4,88,147
"7414","2000-2059",2018-12-14,58,5,89,147
"7415","2000-2059",2018-12-15,46,6,76,122
"7416","2000-2059",2018-12-16,56,7,88,144
"7417","2000-2059",2018-12-17,54,1,90,144
"7418","2000-2059",2018-12-18,53,2,86,139
"7419","2000-2059",2018-12-19,57,3,94,151
"7420","2000-2059",2018-12-20,61,4,92,153
"7421","2000-2059",2018-12-21,60,5,93,153
"7422","2000-2059",2018-12-22,59,6,88,147
"7423","2000-2059",2018-12-23,63,7,97,160
"7424","2000-2059",2018-12-24,39,1,88,127
"7425","2000-2059",2018-12-25,50,2,89,139
"7426","2000-2059",2018-12-26,62,3,98,160
"7427","2000-2059",2018-12-27,63,4,97,160
"7428","2000-2059",2018-12-28,63,5,98,161
"7429","2000-2059",2018-12-29,58,6,88,146
"7430","2000-2059",2018-12-30,62,7,100,162
"7431","2000-2059",2018-12-31,44,1,85,129
"7432","2100-2159",2018-12-01,35,6,69,104
"7433","2100-2159",2018-12-02,59,7,93,152
"7434","2100-2159",2018-12-03,56,1,88,144
"7435","2100-2159",2018-12-04,54,2,78,132
"7436","2100-2159",2018-12-05,57,3,82,139
"7437","2100-2159",2018-12-06,59,4,90,149
"7438","2100-2159",2018-12-07,58,5,91,149
"7439","2100-2159",2018-12-08,34,6,67,101
"7440","2100-2159",2018-12-09,59,7,92,151
"7441","2100-2159",2018-12-10,56,1,88,144
"7442","2100-2159",2018-12-11,55,2,80,135
"7443","2100-2159",2018-12-12,54,3,81,135
"7444","2100-2159",2018-12-13,58,4,90,148
"7445","2100-2159",2018-12-14,57,5,91,148
"7446","2100-2159",2018-12-15,34,6,68,102
"7447","2100-2159",2018-12-16,60,7,91,151
"7448","2100-2159",2018-12-17,56,1,88,144
"7449","2100-2159",2018-12-18,57,2,81,138
"7450","2100-2159",2018-12-19,65,3,98,163
"7451","2100-2159",2018-12-20,65,4,95,160
"7452","2100-2159",2018-12-21,66,5,95,161
"7453","2100-2159",2018-12-22,59,6,94,153
"7454","2100-2159",2018-12-23,64,7,96,160
"7455","2100-2159",2018-12-24,40,1,78,118
"7456","2100-2159",2018-12-25,52,2,83,135
"7457","2100-2159",2018-12-26,65,3,97,162
"7458","2100-2159",2018-12-27,64,4,97,161
"7459","2100-2159",2018-12-28,63,5,97,160
"7460","2100-2159",2018-12-29,59,6,93,152
"7461","2100-2159",2018-12-30,64,7,95,159
"7462","2100-2159",2018-12-31,44,1,77,121
"7463","2200-2259",2018-12-01,22,6,56,78
"7464","2200-2259",2018-12-02,39,7,71,110
"7465","2200-2259",2018-12-03,35,1,75,110
"7466","2200-2259",2018-12-04,28,2,76,104
"7467","2200-2259",2018-12-05,35,3,78,113
"7468","2200-2259",2018-12-06,39,4,79,118
"7469","2200-2259",2018-12-07,39,5,79,118
"7470","2200-2259",2018-12-08,21,6,56,77
"7471","2200-2259",2018-12-09,38,7,73,111
"7472","2200-2259",2018-12-10,36,1,74,110
"7473","2200-2259",2018-12-11,29,2,72,101
"7474","2200-2259",2018-12-12,33,3,74,107
"7475","2200-2259",2018-12-13,39,4,78,117
"7476","2200-2259",2018-12-14,39,5,78,117
"7477","2200-2259",2018-12-15,22,6,56,78
"7478","2200-2259",2018-12-16,38,7,73,111
"7479","2200-2259",2018-12-17,36,1,74,110
"7480","2200-2259",2018-12-18,33,2,73,106
"7481","2200-2259",2018-12-19,43,3,85,128
"7482","2200-2259",2018-12-20,52,4,81,133
"7483","2200-2259",2018-12-21,52,5,80,132
"7484","2200-2259",2018-12-22,48,6,77,125
"7485","2200-2259",2018-12-23,58,7,83,141
"7486","2200-2259",2018-12-24,25,1,58,83
"7487","2200-2259",2018-12-25,32,2,69,101
"7488","2200-2259",2018-12-26,57,3,81,138
"7489","2200-2259",2018-12-27,57,4,81,138
"7490","2200-2259",2018-12-28,58,5,80,138
"7491","2200-2259",2018-12-29,47,6,77,124
"7492","2200-2259",2018-12-30,59,7,83,142
"7493","2200-2259",2018-12-31,25,1,62,87
"7494","2300-2359",2018-12-01,21,6,52,73
"7495","2300-2359",2018-12-02,27,7,79,106
"7496","2300-2359",2018-12-03,25,1,72,97
"7497","2300-2359",2018-12-04,22,2,62,84
"7498","2300-2359",2018-12-05,25,3,69,94
"7499","2300-2359",2018-12-06,23,4,78,101
"7500","2300-2359",2018-12-07,26,5,77,103
"7501","2300-2359",2018-12-08,22,6,48,70
"7502","2300-2359",2018-12-09,27,7,78,105
"7503","2300-2359",2018-12-10,25,1,71,96
"7504","2300-2359",2018-12-11,22,2,64,86
"7505","2300-2359",2018-12-12,25,3,66,91
"7506","2300-2359",2018-12-13,25,4,78,103
"7507","2300-2359",2018-12-14,26,5,77,103
"7508","2300-2359",2018-12-15,22,6,48,70
"7509","2300-2359",2018-12-16,26,7,78,104
"7510","2300-2359",2018-12-17,24,1,71,95
"7511","2300-2359",2018-12-18,22,2,65,87
"7512","2300-2359",2018-12-19,30,3,76,106
"7513","2300-2359",2018-12-20,34,4,87,121
"7514","2300-2359",2018-12-21,37,5,90,127
"7515","2300-2359",2018-12-22,30,6,83,113
"7516","2300-2359",2018-12-23,33,7,89,122
"7517","2300-2359",2018-12-24,26,1,55,81
"7518","2300-2359",2018-12-25,27,2,71,98
"7519","2300-2359",2018-12-26,37,3,92,129
"7520","2300-2359",2018-12-27,37,4,92,129
"7521","2300-2359",2018-12-28,36,5,91,127
"7522","2300-2359",2018-12-29,30,6,83,113
"7523","2300-2359",2018-12-30,33,7,88,121
"7524","2300-2359",2018-12-31,25,1,62,87
"7525","0001-0559",2018-11-01,27,4,66,93
"7526","0001-0559",2018-11-02,31,5,68,99
"7527","0001-0559",2018-11-03,17,6,60,77
"7528","0001-0559",2018-11-04,29,7,79,108
"7529","0001-0559",2018-11-05,32,1,71,103
"7530","0001-0559",2018-11-06,31,2,68,99
"7531","0001-0559",2018-11-07,31,3,73,104
"7532","0001-0559",2018-11-08,31,4,74,105
"7533","0001-0559",2018-11-09,32,5,77,109
"7534","0001-0559",2018-11-10,21,6,51,72
"7535","0001-0559",2018-11-11,29,7,78,107
"7536","0001-0559",2018-11-12,32,1,75,107
"7537","0001-0559",2018-11-13,32,2,72,104
"7538","0001-0559",2018-11-14,32,3,74,106
"7539","0001-0559",2018-11-15,32,4,77,109
"7540","0001-0559",2018-11-16,31,5,91,122
"7541","0001-0559",2018-11-17,31,6,66,97
"7542","0001-0559",2018-11-18,28,7,74,102
"7543","0001-0559",2018-11-19,31,1,71,102
"7544","0001-0559",2018-11-20,30,2,91,121
"7545","0001-0559",2018-11-21,36,3,94,130
"7546","0001-0559",2018-11-22,29,4,38,67
"7547","0001-0559",2018-11-23,16,5,61,77
"7548","0001-0559",2018-11-24,32,6,83,115
"7549","0001-0559",2018-11-25,40,7,106,146
"7550","0001-0559",2018-11-26,39,1,91,130
"7551","0001-0559",2018-11-27,32,2,67,99
"7552","0001-0559",2018-11-28,28,3,67,95
"7553","0001-0559",2018-11-29,28,4,69,97
"7554","0001-0559",2018-11-30,28,5,70,98
"7555","0600-0659",2018-11-01,102,4,32,134
"7556","0600-0659",2018-11-02,104,5,35,139
"7557","0600-0659",2018-11-03,93,6,15,108
"7558","0600-0659",2018-11-04,93,7,29,122
"7559","0600-0659",2018-11-05,106,1,30,136
"7560","0600-0659",2018-11-06,101,2,23,124
"7561","0600-0659",2018-11-07,98,3,27,125
"7562","0600-0659",2018-11-08,106,4,31,137
"7563","0600-0659",2018-11-09,107,5,32,139
"7564","0600-0659",2018-11-10,90,6,21,111
"7565","0600-0659",2018-11-11,95,7,31,126
"7566","0600-0659",2018-11-12,108,1,31,139
"7567","0600-0659",2018-11-13,105,2,24,129
"7568","0600-0659",2018-11-14,103,3,27,130
"7569","0600-0659",2018-11-15,107,4,32,139
"7570","0600-0659",2018-11-16,105,5,29,134
"7571","0600-0659",2018-11-17,97,6,27,124
"7572","0600-0659",2018-11-18,94,7,28,122
"7573","0600-0659",2018-11-19,103,1,29,132
"7574","0600-0659",2018-11-20,102,2,24,126
"7575","0600-0659",2018-11-21,105,3,31,136
"7576","0600-0659",2018-11-22,102,4,23,125
"7577","0600-0659",2018-11-23,64,5,23,87
"7578","0600-0659",2018-11-24,100,6,31,131
"7579","0600-0659",2018-11-25,107,7,34,141
"7580","0600-0659",2018-11-26,106,1,33,139
"7581","0600-0659",2018-11-27,109,2,28,137
"7582","0600-0659",2018-11-28,106,3,24,130
"7583","0600-0659",2018-11-29,113,4,24,137
"7584","0600-0659",2018-11-30,112,5,25,137
"7585","0700-0759",2018-11-01,98,4,56,154
"7586","0700-0759",2018-11-02,101,5,57,158
"7587","0700-0759",2018-11-03,83,6,46,129
"7588","0700-0759",2018-11-04,84,7,58,142
"7589","0700-0759",2018-11-05,99,1,59,158
"7590","0700-0759",2018-11-06,93,2,54,147
"7591","0700-0759",2018-11-07,94,3,52,146
"7592","0700-0759",2018-11-08,99,4,58,157
"7593","0700-0759",2018-11-09,100,5,61,161
"7594","0700-0759",2018-11-10,78,6,53,131
"7595","0700-0759",2018-11-11,86,7,59,145
"7596","0700-0759",2018-11-12,101,1,62,163
"7597","0700-0759",2018-11-13,96,2,59,155
"7598","0700-0759",2018-11-14,96,3,57,153
"7599","0700-0759",2018-11-15,102,4,61,163
"7600","0700-0759",2018-11-16,102,5,64,166
"7601","0700-0759",2018-11-17,84,6,54,138
"7602","0700-0759",2018-11-18,84,7,59,143
"7603","0700-0759",2018-11-19,93,1,60,153
"7604","0700-0759",2018-11-20,93,2,63,156
"7605","0700-0759",2018-11-21,100,3,66,166
"7606","0700-0759",2018-11-22,84,4,57,141
"7607","0700-0759",2018-11-23,56,5,36,92
"7608","0700-0759",2018-11-24,97,6,58,155
"7609","0700-0759",2018-11-25,100,7,68,168
"7610","0700-0759",2018-11-26,101,1,66,167
"7611","0700-0759",2018-11-27,99,2,60,159
"7612","0700-0759",2018-11-28,90,3,59,149
"7613","0700-0759",2018-11-29,94,4,63,157
"7614","0700-0759",2018-11-30,93,5,63,156
"7615","0800-0859",2018-11-01,112,4,76,188
"7616","0800-0859",2018-11-02,114,5,80,194
"7617","0800-0859",2018-11-03,108,6,62,170
"7618","0800-0859",2018-11-04,111,7,64,175
"7619","0800-0859",2018-11-05,110,1,82,192
"7620","0800-0859",2018-11-06,110,2,78,188
"7621","0800-0859",2018-11-07,108,3,79,187
"7622","0800-0859",2018-11-08,111,4,81,192
"7623","0800-0859",2018-11-09,111,5,81,192
"7624","0800-0859",2018-11-10,107,6,62,169
"7625","0800-0859",2018-11-11,110,7,65,175
"7626","0800-0859",2018-11-12,111,1,81,192
"7627","0800-0859",2018-11-13,110,2,79,189
"7628","0800-0859",2018-11-14,110,3,81,191
"7629","0800-0859",2018-11-15,111,4,81,192
"7630","0800-0859",2018-11-16,109,5,77,186
"7631","0800-0859",2018-11-17,101,6,68,169
"7632","0800-0859",2018-11-18,111,7,62,173
"7633","0800-0859",2018-11-19,108,1,75,183
"7634","0800-0859",2018-11-20,111,2,70,181
"7635","0800-0859",2018-11-21,113,3,75,188
"7636","0800-0859",2018-11-22,112,4,70,182
"7637","0800-0859",2018-11-23,91,5,44,135
"7638","0800-0859",2018-11-24,100,6,75,175
"7639","0800-0859",2018-11-25,112,7,73,185
"7640","0800-0859",2018-11-26,112,1,76,188
"7641","0800-0859",2018-11-27,108,2,78,186
"7642","0800-0859",2018-11-28,107,3,75,182
"7643","0800-0859",2018-11-29,111,4,79,190
"7644","0800-0859",2018-11-30,113,5,78,191
"7645","0900-0959",2018-11-01,77,4,54,131
"7646","0900-0959",2018-11-02,76,5,56,132
"7647","0900-0959",2018-11-03,68,6,51,119
"7648","0900-0959",2018-11-04,83,7,48,131
"7649","0900-0959",2018-11-05,88,1,59,147
"7650","0900-0959",2018-11-06,86,2,57,143
"7651","0900-0959",2018-11-07,84,3,54,138
"7652","0900-0959",2018-11-08,87,4,60,147
"7653","0900-0959",2018-11-09,86,5,61,147
"7654","0900-0959",2018-11-10,75,6,46,121
"7655","0900-0959",2018-11-11,84,7,51,135
"7656","0900-0959",2018-11-12,89,1,62,151
"7657","0900-0959",2018-11-13,88,2,58,146
"7658","0900-0959",2018-11-14,86,3,56,142
"7659","0900-0959",2018-11-15,89,4,61,150
"7660","0900-0959",2018-11-16,87,5,60,147
"7661","0900-0959",2018-11-17,77,6,46,123
"7662","0900-0959",2018-11-18,78,7,51,129
"7663","0900-0959",2018-11-19,78,1,55,133
"7664","0900-0959",2018-11-20,85,2,55,140
"7665","0900-0959",2018-11-21,87,3,59,146
"7666","0900-0959",2018-11-22,75,4,53,128
"7667","0900-0959",2018-11-23,64,5,37,101
"7668","0900-0959",2018-11-24,88,6,50,138
"7669","0900-0959",2018-11-25,88,7,64,152
"7670","0900-0959",2018-11-26,87,1,60,147
"7671","0900-0959",2018-11-27,88,2,61,149
"7672","0900-0959",2018-11-28,84,3,51,135
"7673","0900-0959",2018-11-29,88,4,56,144
"7674","0900-0959",2018-11-30,87,5,54,141
"7675","1000-1059",2018-11-01,82,4,72,154
"7676","1000-1059",2018-11-02,84,5,73,157
"7677","1000-1059",2018-11-03,72,6,62,134
"7678","1000-1059",2018-11-04,71,7,67,138
"7679","1000-1059",2018-11-05,83,1,73,156
"7680","1000-1059",2018-11-06,78,2,71,149
"7681","1000-1059",2018-11-07,82,3,70,152
"7682","1000-1059",2018-11-08,81,4,73,154
"7683","1000-1059",2018-11-09,84,5,72,156
"7684","1000-1059",2018-11-10,68,6,64,132
"7685","1000-1059",2018-11-11,73,7,67,140
"7686","1000-1059",2018-11-12,83,1,73,156
"7687","1000-1059",2018-11-13,80,2,72,152
"7688","1000-1059",2018-11-14,84,3,71,155
"7689","1000-1059",2018-11-15,83,4,73,156
"7690","1000-1059",2018-11-16,79,5,75,154
"7691","1000-1059",2018-11-17,69,6,71,140
"7692","1000-1059",2018-11-18,75,7,72,147
"7693","1000-1059",2018-11-19,79,1,75,154
"7694","1000-1059",2018-11-20,76,2,76,152
"7695","1000-1059",2018-11-21,76,3,76,152
"7696","1000-1059",2018-11-22,72,4,71,143
"7697","1000-1059",2018-11-23,62,5,51,113
"7698","1000-1059",2018-11-24,66,6,73,139
"7699","1000-1059",2018-11-25,77,7,72,149
"7700","1000-1059",2018-11-26,77,1,74,151
"7701","1000-1059",2018-11-27,76,2,74,150
"7702","1000-1059",2018-11-28,72,3,68,140
"7703","1000-1059",2018-11-29,75,4,71,146
"7704","1000-1059",2018-11-30,76,5,75,151
"7705","1100-1159",2018-11-01,79,4,81,160
"7706","1100-1159",2018-11-02,78,5,82,160
"7707","1100-1159",2018-11-03,62,6,74,136
"7708","1100-1159",2018-11-04,79,7,70,149
"7709","1100-1159",2018-11-05,82,1,73,155
"7710","1100-1159",2018-11-06,82,2,71,153
"7711","1100-1159",2018-11-07,79,3,70,149
"7712","1100-1159",2018-11-08,84,4,71,155
"7713","1100-1159",2018-11-09,81,5,72,153
"7714","1100-1159",2018-11-10,62,6,61,123
"7715","1100-1159",2018-11-11,77,7,68,145
"7716","1100-1159",2018-11-12,83,1,71,154
"7717","1100-1159",2018-11-13,82,2,71,153
"7718","1100-1159",2018-11-14,79,3,70,149
"7719","1100-1159",2018-11-15,84,4,72,156
"7720","1100-1159",2018-11-16,79,5,63,142
"7721","1100-1159",2018-11-17,66,6,60,126
"7722","1100-1159",2018-11-18,77,7,64,141
"7723","1100-1159",2018-11-19,83,1,65,148
"7724","1100-1159",2018-11-20,79,2,62,141
"7725","1100-1159",2018-11-21,80,3,66,146
"7726","1100-1159",2018-11-22,69,4,67,136
"7727","1100-1159",2018-11-23,70,5,54,124
"7728","1100-1159",2018-11-24,76,6,63,139
"7729","1100-1159",2018-11-25,78,7,63,141
"7730","1100-1159",2018-11-26,81,1,63,144
"7731","1100-1159",2018-11-27,84,2,69,153
"7732","1100-1159",2018-11-28,80,3,72,152
"7733","1100-1159",2018-11-29,84,4,73,157
"7734","1100-1159",2018-11-30,83,5,74,157
"7735","1200-1259",2018-11-01,83,4,71,154
"7736","1200-1259",2018-11-02,83,5,73,156
"7737","1200-1259",2018-11-03,73,6,61,134
"7738","1200-1259",2018-11-04,72,7,83,155
"7739","1200-1259",2018-11-05,76,1,72,148
"7740","1200-1259",2018-11-06,69,2,69,138
"7741","1200-1259",2018-11-07,72,3,71,143
"7742","1200-1259",2018-11-08,74,4,75,149
"7743","1200-1259",2018-11-09,75,5,75,150
"7744","1200-1259",2018-11-10,65,6,70,135
"7745","1200-1259",2018-11-11,72,7,84,156
"7746","1200-1259",2018-11-12,74,1,75,149
"7747","1200-1259",2018-11-13,70,2,71,141
"7748","1200-1259",2018-11-14,72,3,73,145
"7749","1200-1259",2018-11-15,75,4,78,153
"7750","1200-1259",2018-11-16,73,5,79,152
"7751","1200-1259",2018-11-17,67,6,70,137
"7752","1200-1259",2018-11-18,71,7,85,156
"7753","1200-1259",2018-11-19,72,1,74,146
"7754","1200-1259",2018-11-20,70,2,79,149
"7755","1200-1259",2018-11-21,69,3,76,145
"7756","1200-1259",2018-11-22,53,4,70,123
"7757","1200-1259",2018-11-23,64,5,69,133
"7758","1200-1259",2018-11-24,68,6,74,142
"7759","1200-1259",2018-11-25,75,7,81,156
"7760","1200-1259",2018-11-26,73,1,80,153
"7761","1200-1259",2018-11-27,69,2,69,138
"7762","1200-1259",2018-11-28,64,3,72,136
"7763","1200-1259",2018-11-29,65,4,77,142
"7764","1200-1259",2018-11-30,66,5,77,143
"7765","1300-1359",2018-11-01,77,4,63,140
"7766","1300-1359",2018-11-02,76,5,61,137
"7767","1300-1359",2018-11-03,60,6,60,120
"7768","1300-1359",2018-11-04,74,7,58,132
"7769","1300-1359",2018-11-05,75,1,70,145
"7770","1300-1359",2018-11-06,73,2,69,142
"7771","1300-1359",2018-11-07,70,3,68,138
"7772","1300-1359",2018-11-08,76,4,70,146
"7773","1300-1359",2018-11-09,76,5,70,146
"7774","1300-1359",2018-11-10,62,6,54,116
"7775","1300-1359",2018-11-11,73,7,57,130
"7776","1300-1359",2018-11-12,78,1,70,148
"7777","1300-1359",2018-11-13,75,2,69,144
"7778","1300-1359",2018-11-14,74,3,68,142
"7779","1300-1359",2018-11-15,80,4,69,149
"7780","1300-1359",2018-11-16,71,5,67,138
"7781","1300-1359",2018-11-17,67,6,67,134
"7782","1300-1359",2018-11-18,75,7,56,131
"7783","1300-1359",2018-11-19,72,1,65,137
"7784","1300-1359",2018-11-20,73,2,66,139
"7785","1300-1359",2018-11-21,72,3,68,140
"7786","1300-1359",2018-11-22,54,4,59,113
"7787","1300-1359",2018-11-23,65,5,57,122
"7788","1300-1359",2018-11-24,76,6,71,147
"7789","1300-1359",2018-11-25,73,7,65,138
"7790","1300-1359",2018-11-26,71,1,67,138
"7791","1300-1359",2018-11-27,73,2,67,140
"7792","1300-1359",2018-11-28,76,3,64,140
"7793","1300-1359",2018-11-29,78,4,65,143
"7794","1300-1359",2018-11-30,78,5,63,141
"7795","1400-1459",2018-11-01,67,4,89,156
"7796","1400-1459",2018-11-02,66,5,90,156
"7797","1400-1459",2018-11-03,64,6,67,131
"7798","1400-1459",2018-11-04,64,7,81,145
"7799","1400-1459",2018-11-05,69,1,90,159
"7800","1400-1459",2018-11-06,68,2,86,154
"7801","1400-1459",2018-11-07,69,3,89,158
"7802","1400-1459",2018-11-08,71,4,87,158
"7803","1400-1459",2018-11-09,70,5,89,159
"7804","1400-1459",2018-11-10,60,6,78,138
"7805","1400-1459",2018-11-11,66,7,82,148
"7806","1400-1459",2018-11-12,71,1,91,162
"7807","1400-1459",2018-11-13,68,2,88,156
"7808","1400-1459",2018-11-14,69,3,91,160
"7809","1400-1459",2018-11-15,72,4,89,161
"7810","1400-1459",2018-11-16,75,5,88,163
"7811","1400-1459",2018-11-17,65,6,72,137
"7812","1400-1459",2018-11-18,64,7,79,143
"7813","1400-1459",2018-11-19,66,1,82,148
"7814","1400-1459",2018-11-20,70,2,85,155
"7815","1400-1459",2018-11-21,74,3,87,161
"7816","1400-1459",2018-11-22,48,4,68,116
"7817","1400-1459",2018-11-23,61,5,68,129
"7818","1400-1459",2018-11-24,69,6,75,144
"7819","1400-1459",2018-11-25,73,7,89,162
"7820","1400-1459",2018-11-26,73,1,89,162
"7821","1400-1459",2018-11-27,71,2,87,158
"7822","1400-1459",2018-11-28,68,3,81,149
"7823","1400-1459",2018-11-29,71,4,81,152
"7824","1400-1459",2018-11-30,70,5,82,152
"7825","1500-1559",2018-11-01,78,4,77,155
"7826","1500-1559",2018-11-02,79,5,76,155
"7827","1500-1559",2018-11-03,60,6,71,131
"7828","1500-1559",2018-11-04,80,7,69,149
"7829","1500-1559",2018-11-05,84,1,74,158
"7830","1500-1559",2018-11-06,81,2,72,153
"7831","1500-1559",2018-11-07,82,3,73,155
"7832","1500-1559",2018-11-08,85,4,77,162
"7833","1500-1559",2018-11-09,83,5,76,159
"7834","1500-1559",2018-11-10,75,6,63,138
"7835","1500-1559",2018-11-11,83,7,71,154
"7836","1500-1559",2018-11-12,88,1,76,164
"7837","1500-1559",2018-11-13,86,2,75,161
"7838","1500-1559",2018-11-14,86,3,75,161
"7839","1500-1559",2018-11-15,89,4,78,167
"7840","1500-1559",2018-11-16,83,5,74,157
"7841","1500-1559",2018-11-17,75,6,64,139
"7842","1500-1559",2018-11-18,81,7,72,153
"7843","1500-1559",2018-11-19,84,1,74,158
"7844","1500-1559",2018-11-20,82,2,76,158
"7845","1500-1559",2018-11-21,86,3,73,159
"7846","1500-1559",2018-11-22,49,4,62,111
"7847","1500-1559",2018-11-23,75,5,63,138
"7848","1500-1559",2018-11-24,86,6,69,155
"7849","1500-1559",2018-11-25,85,7,76,161
"7850","1500-1559",2018-11-26,88,1,74,162
"7851","1500-1559",2018-11-27,85,2,75,160
"7852","1500-1559",2018-11-28,81,3,72,153
"7853","1500-1559",2018-11-29,83,4,76,159
"7854","1500-1559",2018-11-30,82,5,73,155
"7855","1600-1659",2018-11-01,73,4,73,146
"7856","1600-1659",2018-11-02,71,5,73,144
"7857","1600-1659",2018-11-03,75,6,62,137
"7858","1600-1659",2018-11-04,80,7,73,153
"7859","1600-1659",2018-11-05,77,1,73,150
"7860","1600-1659",2018-11-06,77,2,74,151
"7861","1600-1659",2018-11-07,78,3,72,150
"7862","1600-1659",2018-11-08,79,4,75,154
"7863","1600-1659",2018-11-09,79,5,74,153
"7864","1600-1659",2018-11-10,74,6,63,137
"7865","1600-1659",2018-11-11,78,7,75,153
"7866","1600-1659",2018-11-12,78,1,77,155
"7867","1600-1659",2018-11-13,80,2,75,155
"7868","1600-1659",2018-11-14,79,3,74,153
"7869","1600-1659",2018-11-15,81,4,77,158
"7870","1600-1659",2018-11-16,84,5,75,159
"7871","1600-1659",2018-11-17,75,6,67,142
"7872","1600-1659",2018-11-18,74,7,72,146
"7873","1600-1659",2018-11-19,68,1,72,140
"7874","1600-1659",2018-11-20,82,2,72,154
"7875","1600-1659",2018-11-21,82,3,73,155
"7876","1600-1659",2018-11-22,38,4,47,85
"7877","1600-1659",2018-11-23,67,5,63,130
"7878","1600-1659",2018-11-24,80,6,75,155
"7879","1600-1659",2018-11-25,84,7,75,159
"7880","1600-1659",2018-11-26,82,1,74,156
"7881","1600-1659",2018-11-27,76,2,78,154
"7882","1600-1659",2018-11-28,78,3,77,155
"7883","1600-1659",2018-11-29,77,4,78,155
"7884","1600-1659",2018-11-30,80,5,77,157
"7885","1700-1759",2018-11-01,87,4,73,160
"7886","1700-1759",2018-11-02,87,5,69,156
"7887","1700-1759",2018-11-03,71,6,62,133
"7888","1700-1759",2018-11-04,78,7,68,146
"7889","1700-1759",2018-11-05,76,1,77,153
"7890","1700-1759",2018-11-06,77,2,72,149
"7891","1700-1759",2018-11-07,75,3,72,147
"7892","1700-1759",2018-11-08,75,4,80,155
"7893","1700-1759",2018-11-09,75,5,78,153
"7894","1700-1759",2018-11-10,64,6,68,132
"7895","1700-1759",2018-11-11,78,7,74,152
"7896","1700-1759",2018-11-12,77,1,81,158
"7897","1700-1759",2018-11-13,77,2,77,154
"7898","1700-1759",2018-11-14,75,3,77,152
"7899","1700-1759",2018-11-15,79,4,83,162
"7900","1700-1759",2018-11-16,76,5,82,158
"7901","1700-1759",2018-11-17,64,6,65,129
"7902","1700-1759",2018-11-18,78,7,70,148
"7903","1700-1759",2018-11-19,77,1,76,153
"7904","1700-1759",2018-11-20,74,2,79,153
"7905","1700-1759",2018-11-21,75,3,82,157
"7906","1700-1759",2018-11-22,26,4,52,78
"7907","1700-1759",2018-11-23,68,5,62,130
"7908","1700-1759",2018-11-24,75,6,76,151
"7909","1700-1759",2018-11-25,78,7,80,158
"7910","1700-1759",2018-11-26,75,1,83,158
"7911","1700-1759",2018-11-27,82,2,76,158
"7912","1700-1759",2018-11-28,75,3,73,148
"7913","1700-1759",2018-11-29,77,4,76,153
"7914","1700-1759",2018-11-30,74,5,75,149
"7915","1800-1859",2018-11-01,64,4,87,151
"7916","1800-1859",2018-11-02,63,5,86,149
"7917","1800-1859",2018-11-03,64,6,73,137
"7918","1800-1859",2018-11-04,81,7,86,167
"7919","1800-1859",2018-11-05,78,1,86,164
"7920","1800-1859",2018-11-06,72,2,83,155
"7921","1800-1859",2018-11-07,72,3,84,156
"7922","1800-1859",2018-11-08,81,4,84,165
"7923","1800-1859",2018-11-09,79,5,82,161
"7924","1800-1859",2018-11-10,70,6,69,139
"7925","1800-1859",2018-11-11,84,7,82,166
"7926","1800-1859",2018-11-12,83,1,86,169
"7927","1800-1859",2018-11-13,80,2,86,166
"7928","1800-1859",2018-11-14,79,3,84,163
"7929","1800-1859",2018-11-15,83,4,89,172
"7930","1800-1859",2018-11-16,83,5,82,165
"7931","1800-1859",2018-11-17,69,6,77,146
"7932","1800-1859",2018-11-18,76,7,82,158
"7933","1800-1859",2018-11-19,74,1,78,152
"7934","1800-1859",2018-11-20,78,2,77,155
"7935","1800-1859",2018-11-21,82,3,83,165
"7936","1800-1859",2018-11-22,23,4,43,66
"7937","1800-1859",2018-11-23,75,5,75,150
"7938","1800-1859",2018-11-24,86,6,80,166
"7939","1800-1859",2018-11-25,79,7,83,162
"7940","1800-1859",2018-11-26,84,1,85,169
"7941","1800-1859",2018-11-27,76,2,87,163
"7942","1800-1859",2018-11-28,78,3,82,160
"7943","1800-1859",2018-11-29,81,4,85,166
"7944","1800-1859",2018-11-30,83,5,87,170
"7945","1900-1959",2018-11-01,77,4,76,153
"7946","1900-1959",2018-11-02,77,5,77,154
"7947","1900-1959",2018-11-03,56,6,74,130
"7948","1900-1959",2018-11-04,70,7,77,147
"7949","1900-1959",2018-11-05,75,1,78,153
"7950","1900-1959",2018-11-06,74,2,78,152
"7951","1900-1959",2018-11-07,74,3,75,149
"7952","1900-1959",2018-11-08,76,4,79,155
"7953","1900-1959",2018-11-09,76,5,77,153
"7954","1900-1959",2018-11-10,48,6,74,122
"7955","1900-1959",2018-11-11,69,7,76,145
"7956","1900-1959",2018-11-12,74,1,77,151
"7957","1900-1959",2018-11-13,74,2,78,152
"7958","1900-1959",2018-11-14,73,3,76,149
"7959","1900-1959",2018-11-15,75,4,77,152
"7960","1900-1959",2018-11-16,70,5,77,147
"7961","1900-1959",2018-11-17,58,6,80,138
"7962","1900-1959",2018-11-18,66,7,71,137
"7963","1900-1959",2018-11-19,71,1,73,144
"7964","1900-1959",2018-11-20,68,2,76,144
"7965","1900-1959",2018-11-21,72,3,79,151
"7966","1900-1959",2018-11-22,20,4,39,59
"7967","1900-1959",2018-11-23,62,5,71,133
"7968","1900-1959",2018-11-24,68,6,84,152
"7969","1900-1959",2018-11-25,74,7,81,155
"7970","1900-1959",2018-11-26,71,1,76,147
"7971","1900-1959",2018-11-27,75,2,76,151
"7972","1900-1959",2018-11-28,71,3,75,146
"7973","1900-1959",2018-11-29,76,4,74,150
"7974","1900-1959",2018-11-30,74,5,74,148
"7975","2000-2059",2018-11-01,61,4,81,142
"7976","2000-2059",2018-11-02,61,5,83,144
"7977","2000-2059",2018-11-03,45,6,78,123
"7978","2000-2059",2018-11-04,59,7,86,145
"7979","2000-2059",2018-11-05,54,1,80,134
"7980","2000-2059",2018-11-06,52,2,81,133
"7981","2000-2059",2018-11-07,54,3,79,133
"7982","2000-2059",2018-11-08,57,4,79,136
"7983","2000-2059",2018-11-09,58,5,81,139
"7984","2000-2059",2018-11-10,52,6,74,126
"7985","2000-2059",2018-11-11,60,7,85,145
"7986","2000-2059",2018-11-12,60,1,81,141
"7987","2000-2059",2018-11-13,56,2,82,138
"7988","2000-2059",2018-11-14,58,3,81,139
"7989","2000-2059",2018-11-15,58,4,82,140
"7990","2000-2059",2018-11-16,65,5,82,147
"7991","2000-2059",2018-11-17,56,6,66,122
"7992","2000-2059",2018-11-18,56,7,84,140
"7993","2000-2059",2018-11-19,56,1,82,138
"7994","2000-2059",2018-11-20,64,2,83,147
"7995","2000-2059",2018-11-21,66,3,82,148
"7996","2000-2059",2018-11-22,20,4,36,56
"7997","2000-2059",2018-11-23,58,5,82,140
"7998","2000-2059",2018-11-24,62,6,77,139
"7999","2000-2059",2018-11-25,70,7,82,152
"8000","2000-2059",2018-11-26,65,1,82,147
"8001","2000-2059",2018-11-27,55,2,83,138
"8002","2000-2059",2018-11-28,58,3,84,142
"8003","2000-2059",2018-11-29,62,4,87,149
"8004","2000-2059",2018-11-30,60,5,86,146
"8005","2100-2159",2018-11-01,61,4,104,165
"8006","2100-2159",2018-11-02,61,5,102,163
"8007","2100-2159",2018-11-03,33,6,83,116
"8008","2100-2159",2018-11-04,68,7,95,163
"8009","2100-2159",2018-11-05,62,1,95,157
"8010","2100-2159",2018-11-06,65,2,91,156
"8011","2100-2159",2018-11-07,64,3,92,156
"8012","2100-2159",2018-11-08,62,4,95,157
"8013","2100-2159",2018-11-09,60,5,95,155
"8014","2100-2159",2018-11-10,37,6,73,110
"8015","2100-2159",2018-11-11,68,7,94,162
"8016","2100-2159",2018-11-12,60,1,95,155
"8017","2100-2159",2018-11-13,61,2,92,153
"8018","2100-2159",2018-11-14,60,3,94,154
"8019","2100-2159",2018-11-15,61,4,97,158
"8020","2100-2159",2018-11-16,63,5,94,157
"8021","2100-2159",2018-11-17,49,6,80,129
"8022","2100-2159",2018-11-18,66,7,87,153
"8023","2100-2159",2018-11-19,56,1,87,143
"8024","2100-2159",2018-11-20,63,2,89,152
"8025","2100-2159",2018-11-21,64,3,92,156
"8026","2100-2159",2018-11-22,26,4,35,61
"8027","2100-2159",2018-11-23,55,5,81,136
"8028","2100-2159",2018-11-24,60,6,93,153
"8029","2100-2159",2018-11-25,66,7,95,161
"8030","2100-2159",2018-11-26,63,1,94,157
"8031","2100-2159",2018-11-27,60,2,91,151
"8032","2100-2159",2018-11-28,58,3,85,143
"8033","2100-2159",2018-11-29,59,4,91,150
"8034","2100-2159",2018-11-30,60,5,92,152
"8035","2200-2259",2018-11-01,48,4,69,117
"8036","2200-2259",2018-11-02,50,5,68,118
"8037","2200-2259",2018-11-03,33,6,57,90
"8038","2200-2259",2018-11-04,46,7,78,124
"8039","2200-2259",2018-11-05,39,1,84,123
"8040","2200-2259",2018-11-06,33,2,82,115
"8041","2200-2259",2018-11-07,36,3,83,119
"8042","2200-2259",2018-11-08,43,4,87,130
"8043","2200-2259",2018-11-09,45,5,86,131
"8044","2200-2259",2018-11-10,25,6,63,88
"8045","2200-2259",2018-11-11,45,7,80,125
"8046","2200-2259",2018-11-12,43,1,86,129
"8047","2200-2259",2018-11-13,34,2,81,115
"8048","2200-2259",2018-11-14,36,3,80,116
"8049","2200-2259",2018-11-15,44,4,85,129
"8050","2200-2259",2018-11-16,54,5,81,135
"8051","2200-2259",2018-11-17,35,6,67,102
"8052","2200-2259",2018-11-18,40,7,78,118
"8053","2200-2259",2018-11-19,37,1,85,122
"8054","2200-2259",2018-11-20,49,2,80,129
"8055","2200-2259",2018-11-21,50,3,80,130
"8056","2200-2259",2018-11-22,16,4,20,36
"8057","2200-2259",2018-11-23,33,5,74,107
"8058","2200-2259",2018-11-24,44,6,76,120
"8059","2200-2259",2018-11-25,52,7,81,133
"8060","2200-2259",2018-11-26,51,1,82,133
"8061","2200-2259",2018-11-27,35,2,82,117
"8062","2200-2259",2018-11-28,35,3,79,114
"8063","2200-2259",2018-11-29,37,4,79,116
"8064","2200-2259",2018-11-30,39,5,79,118
"8065","2300-2359",2018-11-01,19,4,72,91
"8066","2300-2359",2018-11-02,21,5,74,95
"8067","2300-2359",2018-11-03,23,6,42,65
"8068","2300-2359",2018-11-04,26,7,79,105
"8069","2300-2359",2018-11-05,25,1,64,89
"8070","2300-2359",2018-11-06,20,2,63,83
"8071","2300-2359",2018-11-07,23,3,62,85
"8072","2300-2359",2018-11-08,26,4,68,94
"8073","2300-2359",2018-11-09,29,5,67,96
"8074","2300-2359",2018-11-10,22,6,48,70
"8075","2300-2359",2018-11-11,29,7,80,109
"8076","2300-2359",2018-11-12,28,1,71,99
"8077","2300-2359",2018-11-13,23,2,68,91
"8078","2300-2359",2018-11-14,25,3,67,92
"8079","2300-2359",2018-11-15,29,4,73,102
"8080","2300-2359",2018-11-16,33,5,82,115
"8081","2300-2359",2018-11-17,23,6,61,84
"8082","2300-2359",2018-11-18,29,7,77,106
"8083","2300-2359",2018-11-19,28,1,58,86
"8084","2300-2359",2018-11-20,29,2,75,104
"8085","2300-2359",2018-11-21,34,3,81,115
"8086","2300-2359",2018-11-22,19,4,25,44
"8087","2300-2359",2018-11-23,27,5,62,89
"8088","2300-2359",2018-11-24,30,6,80,110
"8089","2300-2359",2018-11-25,42,7,85,127
"8090","2300-2359",2018-11-26,32,1,82,114
"8091","2300-2359",2018-11-27,25,2,70,95
"8092","2300-2359",2018-11-28,24,3,73,97
"8093","2300-2359",2018-11-29,24,4,79,103
"8094","2300-2359",2018-11-30,26,5,80,106
"8095","0001-0559",2018-10-01,32,1,74,106
"8096","0001-0559",2018-10-02,28,2,70,98
"8097","0001-0559",2018-10-03,31,3,70,101
"8098","0001-0559",2018-10-04,27,4,72,99
"8099","0001-0559",2018-10-05,30,5,73,103
"8100","0001-0559",2018-10-06,18,6,54,72
"8101","0001-0559",2018-10-07,19,7,71,90
"8102","0001-0559",2018-10-08,30,1,70,100
"8103","0001-0559",2018-10-09,28,2,70,98
"8104","0001-0559",2018-10-10,29,3,72,101
"8105","0001-0559",2018-10-11,28,4,72,100
"8106","0001-0559",2018-10-12,30,5,74,104
"8107","0001-0559",2018-10-13,18,6,54,72
"8108","0001-0559",2018-10-14,19,7,73,92
"8109","0001-0559",2018-10-15,31,1,71,102
"8110","0001-0559",2018-10-16,28,2,70,98
"8111","0001-0559",2018-10-17,29,3,73,102
"8112","0001-0559",2018-10-18,28,4,74,102
"8113","0001-0559",2018-10-19,30,5,73,103
"8114","0001-0559",2018-10-20,18,6,54,72
"8115","0001-0559",2018-10-21,19,7,72,91
"8116","0001-0559",2018-10-22,30,1,69,99
"8117","0001-0559",2018-10-23,28,2,70,98
"8118","0001-0559",2018-10-24,29,3,73,102
"8119","0001-0559",2018-10-25,28,4,72,100
"8120","0001-0559",2018-10-26,30,5,74,104
"8121","0001-0559",2018-10-27,16,6,54,70
"8122","0001-0559",2018-10-28,24,7,68,92
"8123","0001-0559",2018-10-29,34,1,63,97
"8124","0001-0559",2018-10-30,28,2,62,90
"8125","0001-0559",2018-10-31,21,3,56,77
"8126","0600-0659",2018-10-01,109,1,32,141
"8127","0600-0659",2018-10-02,108,2,26,134
"8128","0600-0659",2018-10-03,103,3,28,131
"8129","0600-0659",2018-10-04,111,4,28,139
"8130","0600-0659",2018-10-05,109,5,32,141
"8131","0600-0659",2018-10-06,93,6,16,109
"8132","0600-0659",2018-10-07,95,7,24,119
"8133","0600-0659",2018-10-08,111,1,32,143
"8134","0600-0659",2018-10-09,110,2,24,134
"8135","0600-0659",2018-10-10,110,3,26,136
"8136","0600-0659",2018-10-11,110,4,30,140
"8137","0600-0659",2018-10-12,109,5,32,141
"8138","0600-0659",2018-10-13,93,6,16,109
"8139","0600-0659",2018-10-14,97,7,24,121
"8140","0600-0659",2018-10-15,111,1,33,144
"8141","0600-0659",2018-10-16,110,2,24,134
"8142","0600-0659",2018-10-17,110,3,26,136
"8143","0600-0659",2018-10-18,109,4,30,139
"8144","0600-0659",2018-10-19,110,5,32,142
"8145","0600-0659",2018-10-20,91,6,16,107
"8146","0600-0659",2018-10-21,96,7,24,120
"8147","0600-0659",2018-10-22,111,1,32,143
"8148","0600-0659",2018-10-23,110,2,24,134
"8149","0600-0659",2018-10-24,110,3,26,136
"8150","0600-0659",2018-10-25,110,4,30,140
"8151","0600-0659",2018-10-26,110,5,32,142
"8152","0600-0659",2018-10-27,87,6,15,102
"8153","0600-0659",2018-10-28,92,7,25,117
"8154","0600-0659",2018-10-29,100,1,35,135
"8155","0600-0659",2018-10-30,100,2,26,126
"8156","0600-0659",2018-10-31,81,3,19,100
"8157","0700-0759",2018-10-01,106,1,63,169
"8158","0700-0759",2018-10-02,101,2,62,163
"8159","0700-0759",2018-10-03,103,3,60,163
"8160","0700-0759",2018-10-04,107,4,67,174
"8161","0700-0759",2018-10-05,109,5,65,174
"8162","0700-0759",2018-10-06,89,6,58,147
"8163","0700-0759",2018-10-07,95,7,60,155
"8164","0700-0759",2018-10-08,106,1,66,172
"8165","0700-0759",2018-10-09,102,2,66,168
"8166","0700-0759",2018-10-10,102,3,66,168
"8167","0700-0759",2018-10-11,106,4,65,171
"8168","0700-0759",2018-10-12,106,5,64,170
"8169","0700-0759",2018-10-13,85,6,58,143
"8170","0700-0759",2018-10-14,94,7,62,156
"8171","0700-0759",2018-10-15,107,1,66,173
"8172","0700-0759",2018-10-16,102,2,66,168
"8173","0700-0759",2018-10-17,102,3,66,168
"8174","0700-0759",2018-10-18,108,4,65,173
"8175","0700-0759",2018-10-19,107,5,65,172
"8176","0700-0759",2018-10-20,88,6,55,143
"8177","0700-0759",2018-10-21,94,7,59,153
"8178","0700-0759",2018-10-22,107,1,66,173
"8179","0700-0759",2018-10-23,102,2,66,168
"8180","0700-0759",2018-10-24,102,3,66,168
"8181","0700-0759",2018-10-25,108,4,65,173
"8182","0700-0759",2018-10-26,108,5,65,173
"8183","0700-0759",2018-10-27,87,6,55,142
"8184","0700-0759",2018-10-28,84,7,52,136
"8185","0700-0759",2018-10-29,102,1,55,157
"8186","0700-0759",2018-10-30,95,2,52,147
"8187","0700-0759",2018-10-31,81,3,46,127
"8188","0800-0859",2018-10-01,108,1,85,193
"8189","0800-0859",2018-10-02,107,2,82,189
"8190","0800-0859",2018-10-03,107,3,83,190
"8191","0800-0859",2018-10-04,111,4,85,196
"8192","0800-0859",2018-10-05,112,5,83,195
"8193","0800-0859",2018-10-06,104,6,67,171
"8194","0800-0859",2018-10-07,107,7,67,174
"8195","0800-0859",2018-10-08,110,1,82,192
"8196","0800-0859",2018-10-09,109,2,81,190
"8197","0800-0859",2018-10-10,108,3,79,187
"8198","0800-0859",2018-10-11,111,4,83,194
"8199","0800-0859",2018-10-12,110,5,82,192
"8200","0800-0859",2018-10-13,104,6,64,168
"8201","0800-0859",2018-10-14,104,7,66,170
"8202","0800-0859",2018-10-15,109,1,82,191
"8203","0800-0859",2018-10-16,109,2,81,190
"8204","0800-0859",2018-10-17,108,3,79,187
"8205","0800-0859",2018-10-18,110,4,82,192
"8206","0800-0859",2018-10-19,110,5,82,192
"8207","0800-0859",2018-10-20,102,6,67,169
"8208","0800-0859",2018-10-21,102,7,68,170
"8209","0800-0859",2018-10-22,110,1,82,192
"8210","0800-0859",2018-10-23,109,2,81,190
"8211","0800-0859",2018-10-24,108,3,79,187
"8212","0800-0859",2018-10-25,110,4,83,193
"8213","0800-0859",2018-10-26,110,5,83,193
"8214","0800-0859",2018-10-27,101,6,61,162
"8215","0800-0859",2018-10-28,103,7,63,166
"8216","0800-0859",2018-10-29,109,1,76,185
"8217","0800-0859",2018-10-30,114,2,77,191
"8218","0800-0859",2018-10-31,110,3,62,172
"8219","0900-0959",2018-10-01,87,1,53,140
"8220","0900-0959",2018-10-02,86,2,50,136
"8221","0900-0959",2018-10-03,83,3,51,134
"8222","0900-0959",2018-10-04,87,4,57,144
"8223","0900-0959",2018-10-05,84,5,60,144
"8224","0900-0959",2018-10-06,79,6,49,128
"8225","0900-0959",2018-10-07,82,7,53,135
"8226","0900-0959",2018-10-08,85,1,57,142
"8227","0900-0959",2018-10-09,84,2,55,139
"8228","0900-0959",2018-10-10,83,3,56,139
"8229","0900-0959",2018-10-11,86,4,56,142
"8230","0900-0959",2018-10-12,85,5,57,142
"8231","0900-0959",2018-10-13,78,6,48,126
"8232","0900-0959",2018-10-14,82,7,50,132
"8233","0900-0959",2018-10-15,85,1,58,143
"8234","0900-0959",2018-10-16,84,2,55,139
"8235","0900-0959",2018-10-17,83,3,56,139
"8236","0900-0959",2018-10-18,85,4,57,142
"8237","0900-0959",2018-10-19,84,5,57,141
"8238","0900-0959",2018-10-20,76,6,48,124
"8239","0900-0959",2018-10-21,81,7,50,131
"8240","0900-0959",2018-10-22,84,1,58,142
"8241","0900-0959",2018-10-23,84,2,55,139
"8242","0900-0959",2018-10-24,83,3,56,139
"8243","0900-0959",2018-10-25,86,4,57,143
"8244","0900-0959",2018-10-26,85,5,58,143
"8245","0900-0959",2018-10-27,74,6,48,122
"8246","0900-0959",2018-10-28,76,7,50,126
"8247","0900-0959",2018-10-29,78,1,56,134
"8248","0900-0959",2018-10-30,74,2,55,129
"8249","0900-0959",2018-10-31,66,3,52,118
"8250","1000-1059",2018-10-01,83,1,78,161
"8251","1000-1059",2018-10-02,75,2,79,154
"8252","1000-1059",2018-10-03,80,3,75,155
"8253","1000-1059",2018-10-04,81,4,72,153
"8254","1000-1059",2018-10-05,85,5,72,157
"8255","1000-1059",2018-10-06,62,6,65,127
"8256","1000-1059",2018-10-07,75,7,69,144
"8257","1000-1059",2018-10-08,83,1,72,155
"8258","1000-1059",2018-10-09,76,2,73,149
"8259","1000-1059",2018-10-10,79,3,71,150
"8260","1000-1059",2018-10-11,80,4,72,152
"8261","1000-1059",2018-10-12,82,5,72,154
"8262","1000-1059",2018-10-13,63,6,64,127
"8263","1000-1059",2018-10-14,77,7,69,146
"8264","1000-1059",2018-10-15,84,1,72,156
"8265","1000-1059",2018-10-16,77,2,73,150
"8266","1000-1059",2018-10-17,80,3,71,151
"8267","1000-1059",2018-10-18,81,4,73,154
"8268","1000-1059",2018-10-19,83,5,72,155
"8269","1000-1059",2018-10-20,64,6,62,126
"8270","1000-1059",2018-10-21,80,7,69,149
"8271","1000-1059",2018-10-22,84,1,72,156
"8272","1000-1059",2018-10-23,77,2,73,150
"8273","1000-1059",2018-10-24,80,3,71,151
"8274","1000-1059",2018-10-25,81,4,73,154
"8275","1000-1059",2018-10-26,84,5,72,156
"8276","1000-1059",2018-10-27,64,6,62,126
"8277","1000-1059",2018-10-28,77,7,67,144
"8278","1000-1059",2018-10-29,82,1,73,155
"8279","1000-1059",2018-10-30,77,2,72,149
"8280","1000-1059",2018-10-31,74,3,60,134
"8281","1100-1159",2018-10-01,80,1,79,159
"8282","1100-1159",2018-10-02,80,2,76,156
"8283","1100-1159",2018-10-03,82,3,79,161
"8284","1100-1159",2018-10-04,83,4,83,166
"8285","1100-1159",2018-10-05,84,5,83,167
"8286","1100-1159",2018-10-06,66,6,71,137
"8287","1100-1159",2018-10-07,79,7,74,153
"8288","1100-1159",2018-10-08,82,1,84,166
"8289","1100-1159",2018-10-09,83,2,80,163
"8290","1100-1159",2018-10-10,82,3,79,161
"8291","1100-1159",2018-10-11,84,4,84,168
"8292","1100-1159",2018-10-12,85,5,83,168
"8293","1100-1159",2018-10-13,67,6,71,138
"8294","1100-1159",2018-10-14,83,7,74,157
"8295","1100-1159",2018-10-15,82,1,83,165
"8296","1100-1159",2018-10-16,83,2,80,163
"8297","1100-1159",2018-10-17,82,3,79,161
"8298","1100-1159",2018-10-18,84,4,82,166
"8299","1100-1159",2018-10-19,83,5,83,166
"8300","1100-1159",2018-10-20,67,6,72,139
"8301","1100-1159",2018-10-21,80,7,74,154
"8302","1100-1159",2018-10-22,82,1,83,165
"8303","1100-1159",2018-10-23,83,2,80,163
"8304","1100-1159",2018-10-24,82,3,79,161
"8305","1100-1159",2018-10-25,84,4,83,167
"8306","1100-1159",2018-10-26,84,5,84,168
"8307","1100-1159",2018-10-27,65,6,70,135
"8308","1100-1159",2018-10-28,80,7,72,152
"8309","1100-1159",2018-10-29,78,1,81,159
"8310","1100-1159",2018-10-30,76,2,81,157
"8311","1100-1159",2018-10-31,71,3,75,146
"8312","1200-1259",2018-10-01,74,1,78,152
"8313","1200-1259",2018-10-02,69,2,73,142
"8314","1200-1259",2018-10-03,79,3,73,152
"8315","1200-1259",2018-10-04,80,4,74,154
"8316","1200-1259",2018-10-05,81,5,75,156
"8317","1200-1259",2018-10-06,67,6,61,128
"8318","1200-1259",2018-10-07,73,7,71,144
"8319","1200-1259",2018-10-08,81,1,74,155
"8320","1200-1259",2018-10-09,76,2,72,148
"8321","1200-1259",2018-10-10,78,3,75,153
"8322","1200-1259",2018-10-11,81,4,76,157
"8323","1200-1259",2018-10-12,81,5,77,158
"8324","1200-1259",2018-10-13,67,6,64,131
"8325","1200-1259",2018-10-14,73,7,73,146
"8326","1200-1259",2018-10-15,82,1,75,157
"8327","1200-1259",2018-10-16,77,2,72,149
"8328","1200-1259",2018-10-17,79,3,75,154
"8329","1200-1259",2018-10-18,81,4,76,157
"8330","1200-1259",2018-10-19,80,5,76,156
"8331","1200-1259",2018-10-20,67,6,62,129
"8332","1200-1259",2018-10-21,72,7,72,144
"8333","1200-1259",2018-10-22,82,1,74,156
"8334","1200-1259",2018-10-23,77,2,72,149
"8335","1200-1259",2018-10-24,79,3,75,154
"8336","1200-1259",2018-10-25,81,4,76,157
"8337","1200-1259",2018-10-26,81,5,77,158
"8338","1200-1259",2018-10-27,67,6,62,129
"8339","1200-1259",2018-10-28,73,7,72,145
"8340","1200-1259",2018-10-29,82,1,71,153
"8341","1200-1259",2018-10-30,76,2,67,143
"8342","1200-1259",2018-10-31,69,3,67,136
"8343","1300-1359",2018-10-01,79,1,57,136
"8344","1300-1359",2018-10-02,76,2,55,131
"8345","1300-1359",2018-10-03,80,3,61,141
"8346","1300-1359",2018-10-04,82,4,62,144
"8347","1300-1359",2018-10-05,83,5,61,144
"8348","1300-1359",2018-10-06,63,6,55,118
"8349","1300-1359",2018-10-07,77,7,56,133
"8350","1300-1359",2018-10-08,78,1,58,136
"8351","1300-1359",2018-10-09,79,2,57,136
"8352","1300-1359",2018-10-10,80,3,58,138
"8353","1300-1359",2018-10-11,81,4,58,139
"8354","1300-1359",2018-10-12,82,5,58,140
"8355","1300-1359",2018-10-13,66,6,53,119
"8356","1300-1359",2018-10-14,78,7,59,137
"8357","1300-1359",2018-10-15,80,1,59,139
"8358","1300-1359",2018-10-16,80,2,58,138
"8359","1300-1359",2018-10-17,80,3,59,139
"8360","1300-1359",2018-10-18,81,4,59,140
"8361","1300-1359",2018-10-19,83,5,57,140
"8362","1300-1359",2018-10-20,65,6,53,118
"8363","1300-1359",2018-10-21,78,7,57,135
"8364","1300-1359",2018-10-22,78,1,60,138
"8365","1300-1359",2018-10-23,79,2,58,137
"8366","1300-1359",2018-10-24,81,3,59,140
"8367","1300-1359",2018-10-25,81,4,59,140
"8368","1300-1359",2018-10-26,83,5,58,141
"8369","1300-1359",2018-10-27,63,6,54,117
"8370","1300-1359",2018-10-28,73,7,63,136
"8371","1300-1359",2018-10-29,74,1,61,135
"8372","1300-1359",2018-10-30,72,2,59,131
"8373","1300-1359",2018-10-31,70,3,57,127
"8374","1400-1459",2018-10-01,69,1,87,156
"8375","1400-1459",2018-10-02,65,2,81,146
"8376","1400-1459",2018-10-03,63,3,89,152
"8377","1400-1459",2018-10-04,66,4,87,153
"8378","1400-1459",2018-10-05,65,5,91,156
"8379","1400-1459",2018-10-06,60,6,64,124
"8380","1400-1459",2018-10-07,69,7,83,152
"8381","1400-1459",2018-10-08,64,1,89,153
"8382","1400-1459",2018-10-09,63,2,84,147
"8383","1400-1459",2018-10-10,63,3,87,150
"8384","1400-1459",2018-10-11,67,4,86,153
"8385","1400-1459",2018-10-12,64,5,89,153
"8386","1400-1459",2018-10-13,60,6,67,127
"8387","1400-1459",2018-10-14,69,7,81,150
"8388","1400-1459",2018-10-15,64,1,89,153
"8389","1400-1459",2018-10-16,63,2,84,147
"8390","1400-1459",2018-10-17,63,3,86,149
"8391","1400-1459",2018-10-18,66,4,86,152
"8392","1400-1459",2018-10-19,63,5,90,153
"8393","1400-1459",2018-10-20,60,6,67,127
"8394","1400-1459",2018-10-21,69,7,80,149
"8395","1400-1459",2018-10-22,65,1,88,153
"8396","1400-1459",2018-10-23,63,2,84,147
"8397","1400-1459",2018-10-24,63,3,86,149
"8398","1400-1459",2018-10-25,66,4,86,152
"8399","1400-1459",2018-10-26,63,5,90,153
"8400","1400-1459",2018-10-27,63,6,64,127
"8401","1400-1459",2018-10-28,69,7,78,147
"8402","1400-1459",2018-10-29,66,1,89,155
"8403","1400-1459",2018-10-30,61,2,83,144
"8404","1400-1459",2018-10-31,59,3,75,134
"8405","1500-1559",2018-10-01,89,1,73,162
"8406","1500-1559",2018-10-02,85,2,71,156
"8407","1500-1559",2018-10-03,85,3,74,159
"8408","1500-1559",2018-10-04,90,4,79,169
"8409","1500-1559",2018-10-05,90,5,76,166
"8410","1500-1559",2018-10-06,65,6,69,134
"8411","1500-1559",2018-10-07,80,7,77,157
"8412","1500-1559",2018-10-08,87,1,79,166
"8413","1500-1559",2018-10-09,84,2,79,163
"8414","1500-1559",2018-10-10,84,3,79,163
"8415","1500-1559",2018-10-11,88,4,84,172
"8416","1500-1559",2018-10-12,90,5,79,169
"8417","1500-1559",2018-10-13,65,6,71,136
"8418","1500-1559",2018-10-14,83,7,79,162
"8419","1500-1559",2018-10-15,88,1,81,169
"8420","1500-1559",2018-10-16,84,2,80,164
"8421","1500-1559",2018-10-17,84,3,81,165
"8422","1500-1559",2018-10-18,88,4,84,172
"8423","1500-1559",2018-10-19,88,5,78,166
"8424","1500-1559",2018-10-20,64,6,70,134
"8425","1500-1559",2018-10-21,82,7,81,163
"8426","1500-1559",2018-10-22,87,1,81,168
"8427","1500-1559",2018-10-23,84,2,80,164
"8428","1500-1559",2018-10-24,84,3,81,165
"8429","1500-1559",2018-10-25,89,4,84,173
"8430","1500-1559",2018-10-26,90,5,78,168
"8431","1500-1559",2018-10-27,62,6,72,134
"8432","1500-1559",2018-10-28,75,7,75,150
"8433","1500-1559",2018-10-29,77,1,77,154
"8434","1500-1559",2018-10-30,76,2,73,149
"8435","1500-1559",2018-10-31,73,3,66,139
"8436","1600-1659",2018-10-01,74,1,90,164
"8437","1600-1659",2018-10-02,74,2,87,161
"8438","1600-1659",2018-10-03,71,3,83,154
"8439","1600-1659",2018-10-04,74,4,81,155
"8440","1600-1659",2018-10-05,74,5,80,154
"8441","1600-1659",2018-10-06,73,6,64,137
"8442","1600-1659",2018-10-07,78,7,80,158
"8443","1600-1659",2018-10-08,75,1,80,155
"8444","1600-1659",2018-10-09,75,2,80,155
"8445","1600-1659",2018-10-10,75,3,80,155
"8446","1600-1659",2018-10-11,76,4,79,155
"8447","1600-1659",2018-10-12,75,5,80,155
"8448","1600-1659",2018-10-13,74,6,65,139
"8449","1600-1659",2018-10-14,81,7,81,162
"8450","1600-1659",2018-10-15,75,1,79,154
"8451","1600-1659",2018-10-16,75,2,79,154
"8452","1600-1659",2018-10-17,76,3,78,154
"8453","1600-1659",2018-10-18,76,4,79,155
"8454","1600-1659",2018-10-19,75,5,78,153
"8455","1600-1659",2018-10-20,74,6,65,139
"8456","1600-1659",2018-10-21,81,7,80,161
"8457","1600-1659",2018-10-22,75,1,77,152
"8458","1600-1659",2018-10-23,76,2,78,154
"8459","1600-1659",2018-10-24,75,3,79,154
"8460","1600-1659",2018-10-25,76,4,79,155
"8461","1600-1659",2018-10-26,76,5,82,158
"8462","1600-1659",2018-10-27,73,6,61,134
"8463","1600-1659",2018-10-28,79,7,76,155
"8464","1600-1659",2018-10-29,73,1,70,143
"8465","1600-1659",2018-10-30,72,2,68,140
"8466","1600-1659",2018-10-31,68,3,71,139
"8467","1700-1759",2018-10-01,86,1,77,163
"8468","1700-1759",2018-10-02,77,2,72,149
"8469","1700-1759",2018-10-03,80,3,74,154
"8470","1700-1759",2018-10-04,85,4,80,165
"8471","1700-1759",2018-10-05,84,5,82,166
"8472","1700-1759",2018-10-06,71,6,64,135
"8473","1700-1759",2018-10-07,81,7,74,155
"8474","1700-1759",2018-10-08,83,1,79,162
"8475","1700-1759",2018-10-09,77,2,76,153
"8476","1700-1759",2018-10-10,77,3,76,153
"8477","1700-1759",2018-10-11,84,4,82,166
"8478","1700-1759",2018-10-12,83,5,82,165
"8479","1700-1759",2018-10-13,71,6,62,133
"8480","1700-1759",2018-10-14,80,7,76,156
"8481","1700-1759",2018-10-15,84,1,80,164
"8482","1700-1759",2018-10-16,77,2,77,154
"8483","1700-1759",2018-10-17,79,3,77,156
"8484","1700-1759",2018-10-18,84,4,80,164
"8485","1700-1759",2018-10-19,83,5,81,164
"8486","1700-1759",2018-10-20,68,6,62,130
"8487","1700-1759",2018-10-21,77,7,74,151
"8488","1700-1759",2018-10-22,82,1,81,163
"8489","1700-1759",2018-10-23,77,2,77,154
"8490","1700-1759",2018-10-24,79,3,77,156
"8491","1700-1759",2018-10-25,83,4,81,164
"8492","1700-1759",2018-10-26,83,5,80,163
"8493","1700-1759",2018-10-27,69,6,65,134
"8494","1700-1759",2018-10-28,82,7,63,145
"8495","1700-1759",2018-10-29,82,1,72,154
"8496","1700-1759",2018-10-30,78,2,67,145
"8497","1700-1759",2018-10-31,67,3,63,130
"8498","1800-1859",2018-10-01,81,1,87,168
"8499","1800-1859",2018-10-02,74,2,84,158
"8500","1800-1859",2018-10-03,71,3,84,155
"8501","1800-1859",2018-10-04,75,4,90,165
"8502","1800-1859",2018-10-05,75,5,89,164
"8503","1800-1859",2018-10-06,63,6,73,136
"8504","1800-1859",2018-10-07,77,7,91,168
"8505","1800-1859",2018-10-08,72,1,87,159
"8506","1800-1859",2018-10-09,68,2,85,153
"8507","1800-1859",2018-10-10,68,3,86,154
"8508","1800-1859",2018-10-11,76,4,89,165
"8509","1800-1859",2018-10-12,75,5,88,163
"8510","1800-1859",2018-10-13,64,6,74,138
"8511","1800-1859",2018-10-14,79,7,90,169
"8512","1800-1859",2018-10-15,73,1,87,160
"8513","1800-1859",2018-10-16,70,2,85,155
"8514","1800-1859",2018-10-17,70,3,86,156
"8515","1800-1859",2018-10-18,75,4,89,164
"8516","1800-1859",2018-10-19,74,5,88,162
"8517","1800-1859",2018-10-20,65,6,73,138
"8518","1800-1859",2018-10-21,79,7,90,169
"8519","1800-1859",2018-10-22,73,1,86,159
"8520","1800-1859",2018-10-23,70,2,85,155
"8521","1800-1859",2018-10-24,70,3,86,156
"8522","1800-1859",2018-10-25,75,4,89,164
"8523","1800-1859",2018-10-26,75,5,88,163
"8524","1800-1859",2018-10-27,63,6,72,135
"8525","1800-1859",2018-10-28,68,7,91,159
"8526","1800-1859",2018-10-29,58,1,86,144
"8527","1800-1859",2018-10-30,57,2,81,138
"8528","1800-1859",2018-10-31,53,3,73,126
"8529","1900-1959",2018-10-01,81,1,82,163
"8530","1900-1959",2018-10-02,72,2,77,149
"8531","1900-1959",2018-10-03,75,3,77,152
"8532","1900-1959",2018-10-04,81,4,83,164
"8533","1900-1959",2018-10-05,81,5,86,167
"8534","1900-1959",2018-10-06,55,6,80,135
"8535","1900-1959",2018-10-07,82,7,85,167
"8536","1900-1959",2018-10-08,80,1,82,162
"8537","1900-1959",2018-10-09,76,2,80,156
"8538","1900-1959",2018-10-10,77,3,78,155
"8539","1900-1959",2018-10-11,81,4,83,164
"8540","1900-1959",2018-10-12,81,5,85,166
"8541","1900-1959",2018-10-13,57,6,80,137
"8542","1900-1959",2018-10-14,82,7,86,168
"8543","1900-1959",2018-10-15,81,1,83,164
"8544","1900-1959",2018-10-16,75,2,80,155
"8545","1900-1959",2018-10-17,76,3,79,155
"8546","1900-1959",2018-10-18,81,4,83,164
"8547","1900-1959",2018-10-19,81,5,84,165
"8548","1900-1959",2018-10-20,56,6,79,135
"8549","1900-1959",2018-10-21,81,7,85,166
"8550","1900-1959",2018-10-22,81,1,82,163
"8551","1900-1959",2018-10-23,75,2,80,155
"8552","1900-1959",2018-10-24,76,3,79,155
"8553","1900-1959",2018-10-25,81,4,83,164
"8554","1900-1959",2018-10-26,81,5,85,166
"8555","1900-1959",2018-10-27,57,6,78,135
"8556","1900-1959",2018-10-28,69,7,82,151
"8557","1900-1959",2018-10-29,72,1,76,148
"8558","1900-1959",2018-10-30,66,2,74,140
"8559","1900-1959",2018-10-31,58,3,69,127
"8560","2000-2059",2018-10-01,63,1,89,152
"8561","2000-2059",2018-10-02,61,2,86,147
"8562","2000-2059",2018-10-03,60,3,84,144
"8563","2000-2059",2018-10-04,66,4,82,148
"8564","2000-2059",2018-10-05,68,5,82,150
"8565","2000-2059",2018-10-06,52,6,73,125
"8566","2000-2059",2018-10-07,61,7,82,143
"8567","2000-2059",2018-10-08,67,1,82,149
"8568","2000-2059",2018-10-09,64,2,79,143
"8569","2000-2059",2018-10-10,64,3,80,144
"8570","2000-2059",2018-10-11,68,4,83,151
"8571","2000-2059",2018-10-12,68,5,83,151
"8572","2000-2059",2018-10-13,50,6,74,124
"8573","2000-2059",2018-10-14,62,7,85,147
"8574","2000-2059",2018-10-15,67,1,84,151
"8575","2000-2059",2018-10-16,66,2,80,146
"8576","2000-2059",2018-10-17,66,3,82,148
"8577","2000-2059",2018-10-18,68,4,83,151
"8578","2000-2059",2018-10-19,68,5,83,151
"8579","2000-2059",2018-10-20,51,6,72,123
"8580","2000-2059",2018-10-21,61,7,82,143
"8581","2000-2059",2018-10-22,66,1,84,150
"8582","2000-2059",2018-10-23,66,2,81,147
"8583","2000-2059",2018-10-24,66,3,81,147
"8584","2000-2059",2018-10-25,68,4,82,150
"8585","2000-2059",2018-10-26,68,5,83,151
"8586","2000-2059",2018-10-27,46,6,72,118
"8587","2000-2059",2018-10-28,58,7,78,136
"8588","2000-2059",2018-10-29,61,1,79,140
"8589","2000-2059",2018-10-30,60,2,80,140
"8590","2000-2059",2018-10-31,43,3,76,119
"8591","2100-2159",2018-10-01,61,1,97,158
"8592","2100-2159",2018-10-02,58,2,87,145
"8593","2100-2159",2018-10-03,60,3,90,150
"8594","2100-2159",2018-10-04,62,4,103,165
"8595","2100-2159",2018-10-05,61,5,102,163
"8596","2100-2159",2018-10-06,39,6,84,123
"8597","2100-2159",2018-10-07,61,7,96,157
"8598","2100-2159",2018-10-08,59,1,96,155
"8599","2100-2159",2018-10-09,61,2,90,151
"8600","2100-2159",2018-10-10,60,3,91,151
"8601","2100-2159",2018-10-11,63,4,103,166
"8602","2100-2159",2018-10-12,62,5,101,163
"8603","2100-2159",2018-10-13,39,6,83,122
"8604","2100-2159",2018-10-14,64,7,95,159
"8605","2100-2159",2018-10-15,62,1,97,159
"8606","2100-2159",2018-10-16,61,2,92,153
"8607","2100-2159",2018-10-17,61,3,93,154
"8608","2100-2159",2018-10-18,65,4,102,167
"8609","2100-2159",2018-10-19,61,5,101,162
"8610","2100-2159",2018-10-20,38,6,83,121
"8611","2100-2159",2018-10-21,63,7,94,157
"8612","2100-2159",2018-10-22,61,1,96,157
"8613","2100-2159",2018-10-23,61,2,92,153
"8614","2100-2159",2018-10-24,61,3,93,154
"8615","2100-2159",2018-10-25,63,4,102,165
"8616","2100-2159",2018-10-26,62,5,101,163
"8617","2100-2159",2018-10-27,40,6,77,117
"8618","2100-2159",2018-10-28,61,7,90,151
"8619","2100-2159",2018-10-29,56,1,92,148
"8620","2100-2159",2018-10-30,53,2,90,143
"8621","2100-2159",2018-10-31,42,3,67,109
"8622","2200-2259",2018-10-01,50,1,76,126
"8623","2200-2259",2018-10-02,46,2,74,120
"8624","2200-2259",2018-10-03,45,3,75,120
"8625","2200-2259",2018-10-04,51,4,73,124
"8626","2200-2259",2018-10-05,52,5,73,125
"8627","2200-2259",2018-10-06,29,6,54,83
"8628","2200-2259",2018-10-07,50,7,76,126
"8629","2200-2259",2018-10-08,51,1,72,123
"8630","2200-2259",2018-10-09,48,2,74,122
"8631","2200-2259",2018-10-10,49,3,73,122
"8632","2200-2259",2018-10-11,52,4,74,126
"8633","2200-2259",2018-10-12,53,5,72,125
"8634","2200-2259",2018-10-13,29,6,54,83
"8635","2200-2259",2018-10-14,52,7,78,130
"8636","2200-2259",2018-10-15,51,1,73,124
"8637","2200-2259",2018-10-16,48,2,73,121
"8638","2200-2259",2018-10-17,49,3,71,120
"8639","2200-2259",2018-10-18,52,4,74,126
"8640","2200-2259",2018-10-19,53,5,72,125
"8641","2200-2259",2018-10-20,30,6,56,86
"8642","2200-2259",2018-10-21,50,7,79,129
"8643","2200-2259",2018-10-22,50,1,74,124
"8644","2200-2259",2018-10-23,48,2,73,121
"8645","2200-2259",2018-10-24,49,3,71,120
"8646","2200-2259",2018-10-25,52,4,74,126
"8647","2200-2259",2018-10-26,53,5,72,125
"8648","2200-2259",2018-10-27,29,6,57,86
"8649","2200-2259",2018-10-28,46,7,77,123
"8650","2200-2259",2018-10-29,46,1,68,114
"8651","2200-2259",2018-10-30,38,2,63,101
"8652","2200-2259",2018-10-31,32,3,53,85
"8653","2300-2359",2018-10-01,21,1,76,97
"8654","2300-2359",2018-10-02,18,2,68,86
"8655","2300-2359",2018-10-03,21,3,69,90
"8656","2300-2359",2018-10-04,21,4,82,103
"8657","2300-2359",2018-10-05,23,5,85,108
"8658","2300-2359",2018-10-06,19,6,46,65
"8659","2300-2359",2018-10-07,23,7,75,98
"8660","2300-2359",2018-10-08,22,1,85,107
"8661","2300-2359",2018-10-09,19,2,77,96
"8662","2300-2359",2018-10-10,22,3,78,100
"8663","2300-2359",2018-10-11,22,4,85,107
"8664","2300-2359",2018-10-12,23,5,86,109
"8665","2300-2359",2018-10-13,19,6,47,66
"8666","2300-2359",2018-10-14,23,7,81,104
"8667","2300-2359",2018-10-15,22,1,86,108
"8668","2300-2359",2018-10-16,19,2,79,98
"8669","2300-2359",2018-10-17,22,3,82,104
"8670","2300-2359",2018-10-18,22,4,86,108
"8671","2300-2359",2018-10-19,22,5,86,108
"8672","2300-2359",2018-10-20,19,6,47,66
"8673","2300-2359",2018-10-21,24,7,79,103
"8674","2300-2359",2018-10-22,22,1,85,107
"8675","2300-2359",2018-10-23,19,2,79,98
"8676","2300-2359",2018-10-24,22,3,82,104
"8677","2300-2359",2018-10-25,22,4,86,108
"8678","2300-2359",2018-10-26,23,5,87,110
"8679","2300-2359",2018-10-27,19,6,46,65
"8680","2300-2359",2018-10-28,20,7,67,87
"8681","2300-2359",2018-10-29,17,1,67,84
"8682","2300-2359",2018-10-30,17,2,60,77
"8683","2300-2359",2018-10-31,18,3,49,67
"8684","0001-0559",2018-09-01,23,6,48,71
"8685","0001-0559",2018-09-02,21,7,60,81
"8686","0001-0559",2018-09-03,26,1,68,94
"8687","0001-0559",2018-09-04,32,2,70,102
"8688","0001-0559",2018-09-05,29,3,71,100
"8689","0001-0559",2018-09-06,31,4,73,104
"8690","0001-0559",2018-09-07,31,5,73,104
"8691","0001-0559",2018-09-08,22,6,57,79
"8692","0001-0559",2018-09-09,25,7,75,100
"8693","0001-0559",2018-09-10,31,1,71,102
"8694","0001-0559",2018-09-11,30,2,68,98
"8695","0001-0559",2018-09-12,30,3,71,101
"8696","0001-0559",2018-09-13,30,4,73,103
"8697","0001-0559",2018-09-14,31,5,74,105
"8698","0001-0559",2018-09-15,22,6,56,78
"8699","0001-0559",2018-09-16,25,7,75,100
"8700","0001-0559",2018-09-17,31,1,72,103
"8701","0001-0559",2018-09-18,30,2,68,98
"8702","0001-0559",2018-09-19,30,3,71,101
"8703","0001-0559",2018-09-20,30,4,72,102
"8704","0001-0559",2018-09-21,31,5,74,105
"8705","0001-0559",2018-09-22,22,6,56,78
"8706","0001-0559",2018-09-23,26,7,75,101
"8707","0001-0559",2018-09-24,31,1,72,103
"8708","0001-0559",2018-09-25,30,2,68,98
"8709","0001-0559",2018-09-26,30,3,71,101
"8710","0001-0559",2018-09-27,30,4,70,100
"8711","0001-0559",2018-09-28,32,5,75,107
"8712","0001-0559",2018-09-29,22,6,55,77
"8713","0001-0559",2018-09-30,25,7,75,100
"8714","0600-0659",2018-09-01,92,6,26,118
"8715","0600-0659",2018-09-02,70,7,29,99
"8716","0600-0659",2018-09-03,98,1,31,129
"8717","0600-0659",2018-09-04,108,2,31,139
"8718","0600-0659",2018-09-05,107,3,32,139
"8719","0600-0659",2018-09-06,105,4,34,139
"8720","0600-0659",2018-09-07,107,5,35,142
"8721","0600-0659",2018-09-08,90,6,25,115
"8722","0600-0659",2018-09-09,95,7,31,126
"8723","0600-0659",2018-09-10,109,1,34,143
"8724","0600-0659",2018-09-11,109,2,29,138
"8725","0600-0659",2018-09-12,105,3,31,136
"8726","0600-0659",2018-09-13,108,4,35,143
"8727","0600-0659",2018-09-14,109,5,35,144
"8728","0600-0659",2018-09-15,90,6,24,114
"8729","0600-0659",2018-09-16,93,7,32,125
"8730","0600-0659",2018-09-17,109,1,35,144
"8731","0600-0659",2018-09-18,109,2,29,138
"8732","0600-0659",2018-09-19,105,3,32,137
"8733","0600-0659",2018-09-20,107,4,35,142
"8734","0600-0659",2018-09-21,109,5,35,144
"8735","0600-0659",2018-09-22,90,6,24,114
"8736","0600-0659",2018-09-23,93,7,32,125
"8737","0600-0659",2018-09-24,109,1,35,144
"8738","0600-0659",2018-09-25,109,2,29,138
"8739","0600-0659",2018-09-26,105,3,32,137
"8740","0600-0659",2018-09-27,108,4,35,143
"8741","0600-0659",2018-09-28,107,5,34,141
"8742","0600-0659",2018-09-29,90,6,24,114
"8743","0600-0659",2018-09-30,94,7,32,126
"8744","0700-0759",2018-09-01,93,6,52,145
"8745","0700-0759",2018-09-02,76,7,44,120
"8746","0700-0759",2018-09-03,102,1,57,159
"8747","0700-0759",2018-09-04,98,2,65,163
"8748","0700-0759",2018-09-05,93,3,59,152
"8749","0700-0759",2018-09-06,102,4,61,163
"8750","0700-0759",2018-09-07,102,5,62,164
"8751","0700-0759",2018-09-08,93,6,48,141
"8752","0700-0759",2018-09-09,100,7,57,157
"8753","0700-0759",2018-09-10,109,1,62,171
"8754","0700-0759",2018-09-11,104,2,61,165
"8755","0700-0759",2018-09-12,103,3,59,162
"8756","0700-0759",2018-09-13,109,4,63,172
"8757","0700-0759",2018-09-14,110,5,64,174
"8758","0700-0759",2018-09-15,94,6,48,142
"8759","0700-0759",2018-09-16,99,7,56,155
"8760","0700-0759",2018-09-17,109,1,63,172
"8761","0700-0759",2018-09-18,104,2,62,166
"8762","0700-0759",2018-09-19,103,3,60,163
"8763","0700-0759",2018-09-20,108,4,62,170
"8764","0700-0759",2018-09-21,108,5,64,172
"8765","0700-0759",2018-09-22,94,6,48,142
"8766","0700-0759",2018-09-23,98,7,58,156
"8767","0700-0759",2018-09-24,108,1,63,171
"8768","0700-0759",2018-09-25,103,2,62,165
"8769","0700-0759",2018-09-26,103,3,60,163
"8770","0700-0759",2018-09-27,108,4,63,171
"8771","0700-0759",2018-09-28,107,5,64,171
"8772","0700-0759",2018-09-29,95,6,48,143
"8773","0700-0759",2018-09-30,98,7,57,155
"8774","0800-0859",2018-09-01,104,6,71,175
"8775","0800-0859",2018-09-02,104,7,50,154
"8776","0800-0859",2018-09-03,112,1,78,190
"8777","0800-0859",2018-09-04,112,2,81,193
"8778","0800-0859",2018-09-05,110,3,81,191
"8779","0800-0859",2018-09-06,109,4,83,192
"8780","0800-0859",2018-09-07,109,5,83,192
"8781","0800-0859",2018-09-08,103,6,72,175
"8782","0800-0859",2018-09-09,108,7,73,181
"8783","0800-0859",2018-09-10,109,1,86,195
"8784","0800-0859",2018-09-11,108,2,85,193
"8785","0800-0859",2018-09-12,108,3,85,193
"8786","0800-0859",2018-09-13,109,4,86,195
"8787","0800-0859",2018-09-14,107,5,86,193
"8788","0800-0859",2018-09-15,103,6,73,176
"8789","0800-0859",2018-09-16,108,7,73,181
"8790","0800-0859",2018-09-17,109,1,86,195
"8791","0800-0859",2018-09-18,108,2,85,193
"8792","0800-0859",2018-09-19,108,3,85,193
"8793","0800-0859",2018-09-20,110,4,86,196
"8794","0800-0859",2018-09-21,110,5,86,196
"8795","0800-0859",2018-09-22,104,6,73,177
"8796","0800-0859",2018-09-23,109,7,71,180
"8797","0800-0859",2018-09-24,110,1,86,196
"8798","0800-0859",2018-09-25,109,2,85,194
"8799","0800-0859",2018-09-26,108,3,85,193
"8800","0800-0859",2018-09-27,109,4,86,195
"8801","0800-0859",2018-09-28,109,5,84,193
"8802","0800-0859",2018-09-29,103,6,73,176
"8803","0800-0859",2018-09-30,109,7,72,181
"8804","0900-0959",2018-09-01,79,6,52,131
"8805","0900-0959",2018-09-02,76,7,49,125
"8806","0900-0959",2018-09-03,83,1,58,141
"8807","0900-0959",2018-09-04,83,2,56,139
"8808","0900-0959",2018-09-05,80,3,52,132
"8809","0900-0959",2018-09-06,83,4,52,135
"8810","0900-0959",2018-09-07,82,5,54,136
"8811","0900-0959",2018-09-08,81,6,51,132
"8812","0900-0959",2018-09-09,83,7,55,138
"8813","0900-0959",2018-09-10,85,1,55,140
"8814","0900-0959",2018-09-11,84,2,53,137
"8815","0900-0959",2018-09-12,83,3,51,134
"8816","0900-0959",2018-09-13,88,4,54,142
"8817","0900-0959",2018-09-14,89,5,55,144
"8818","0900-0959",2018-09-15,84,6,51,135
"8819","0900-0959",2018-09-16,84,7,54,138
"8820","0900-0959",2018-09-17,87,1,55,142
"8821","0900-0959",2018-09-18,87,2,53,140
"8822","0900-0959",2018-09-19,84,3,51,135
"8823","0900-0959",2018-09-20,88,4,54,142
"8824","0900-0959",2018-09-21,87,5,54,141
"8825","0900-0959",2018-09-22,83,6,50,133
"8826","0900-0959",2018-09-23,85,7,55,140
"8827","0900-0959",2018-09-24,87,1,55,142
"8828","0900-0959",2018-09-25,87,2,53,140
"8829","0900-0959",2018-09-26,85,3,51,136
"8830","0900-0959",2018-09-27,87,4,54,141
"8831","0900-0959",2018-09-28,87,5,54,141
"8832","0900-0959",2018-09-29,82,6,49,131
"8833","0900-0959",2018-09-30,84,7,55,139
"8834","1000-1059",2018-09-01,68,6,64,132
"8835","1000-1059",2018-09-02,74,7,62,136
"8836","1000-1059",2018-09-03,85,1,74,159
"8837","1000-1059",2018-09-04,77,2,74,151
"8838","1000-1059",2018-09-05,81,3,75,156
"8839","1000-1059",2018-09-06,79,4,77,156
"8840","1000-1059",2018-09-07,80,5,76,156
"8841","1000-1059",2018-09-08,66,6,64,130
"8842","1000-1059",2018-09-09,76,7,72,148
"8843","1000-1059",2018-09-10,84,1,76,160
"8844","1000-1059",2018-09-11,77,2,77,154
"8845","1000-1059",2018-09-12,82,3,76,158
"8846","1000-1059",2018-09-13,82,4,77,159
"8847","1000-1059",2018-09-14,85,5,77,162
"8848","1000-1059",2018-09-15,65,6,64,129
"8849","1000-1059",2018-09-16,76,7,71,147
"8850","1000-1059",2018-09-17,85,1,76,161
"8851","1000-1059",2018-09-18,77,2,77,154
"8852","1000-1059",2018-09-19,82,3,76,158
"8853","1000-1059",2018-09-20,82,4,77,159
"8854","1000-1059",2018-09-21,85,5,77,162
"8855","1000-1059",2018-09-22,65,6,65,130
"8856","1000-1059",2018-09-23,76,7,71,147
"8857","1000-1059",2018-09-24,85,1,76,161
"8858","1000-1059",2018-09-25,77,2,77,154
"8859","1000-1059",2018-09-26,82,3,76,158
"8860","1000-1059",2018-09-27,82,4,77,159
"8861","1000-1059",2018-09-28,85,5,77,162
"8862","1000-1059",2018-09-29,65,6,66,131
"8863","1000-1059",2018-09-30,77,7,71,148
"8864","1100-1159",2018-09-01,66,6,77,143
"8865","1100-1159",2018-09-02,69,7,78,147
"8866","1100-1159",2018-09-03,78,1,85,163
"8867","1100-1159",2018-09-04,76,2,81,157
"8868","1100-1159",2018-09-05,78,3,78,156
"8869","1100-1159",2018-09-06,79,4,78,157
"8870","1100-1159",2018-09-07,78,5,78,156
"8871","1100-1159",2018-09-08,66,6,76,142
"8872","1100-1159",2018-09-09,76,7,76,152
"8873","1100-1159",2018-09-10,80,1,81,161
"8874","1100-1159",2018-09-11,79,2,77,156
"8875","1100-1159",2018-09-12,81,3,76,157
"8876","1100-1159",2018-09-13,81,4,79,160
"8877","1100-1159",2018-09-14,80,5,80,160
"8878","1100-1159",2018-09-15,66,6,77,143
"8879","1100-1159",2018-09-16,76,7,76,152
"8880","1100-1159",2018-09-17,80,1,81,161
"8881","1100-1159",2018-09-18,78,2,77,155
"8882","1100-1159",2018-09-19,80,3,76,156
"8883","1100-1159",2018-09-20,81,4,79,160
"8884","1100-1159",2018-09-21,80,5,80,160
"8885","1100-1159",2018-09-22,64,6,77,141
"8886","1100-1159",2018-09-23,76,7,77,153
"8887","1100-1159",2018-09-24,79,1,80,159
"8888","1100-1159",2018-09-25,78,2,77,155
"8889","1100-1159",2018-09-26,80,3,76,156
"8890","1100-1159",2018-09-27,81,4,77,158
"8891","1100-1159",2018-09-28,80,5,79,159
"8892","1100-1159",2018-09-29,65,6,77,142
"8893","1100-1159",2018-09-30,75,7,77,152
"8894","1200-1259",2018-09-01,68,6,69,137
"8895","1200-1259",2018-09-02,66,7,62,128
"8896","1200-1259",2018-09-03,81,1,75,156
"8897","1200-1259",2018-09-04,72,2,72,144
"8898","1200-1259",2018-09-05,72,3,73,145
"8899","1200-1259",2018-09-06,71,4,75,146
"8900","1200-1259",2018-09-07,74,5,73,147
"8901","1200-1259",2018-09-08,68,6,68,136
"8902","1200-1259",2018-09-09,68,7,70,138
"8903","1200-1259",2018-09-10,73,1,77,150
"8904","1200-1259",2018-09-11,68,2,74,142
"8905","1200-1259",2018-09-12,69,3,77,146
"8906","1200-1259",2018-09-13,72,4,79,151
"8907","1200-1259",2018-09-14,74,5,78,152
"8908","1200-1259",2018-09-15,69,6,68,137
"8909","1200-1259",2018-09-16,68,7,70,138
"8910","1200-1259",2018-09-17,74,1,77,151
"8911","1200-1259",2018-09-18,69,2,74,143
"8912","1200-1259",2018-09-19,70,3,76,146
"8913","1200-1259",2018-09-20,72,4,79,151
"8914","1200-1259",2018-09-21,74,5,78,152
"8915","1200-1259",2018-09-22,69,6,68,137
"8916","1200-1259",2018-09-23,68,7,70,138
"8917","1200-1259",2018-09-24,74,1,78,152
"8918","1200-1259",2018-09-25,69,2,74,143
"8919","1200-1259",2018-09-26,70,3,77,147
"8920","1200-1259",2018-09-27,71,4,79,150
"8921","1200-1259",2018-09-28,72,5,78,150
"8922","1200-1259",2018-09-29,70,6,68,138
"8923","1200-1259",2018-09-30,68,7,69,137
"8924","1300-1359",2018-09-01,67,6,52,119
"8925","1300-1359",2018-09-02,74,7,59,133
"8926","1300-1359",2018-09-03,76,1,60,136
"8927","1300-1359",2018-09-04,76,2,51,127
"8928","1300-1359",2018-09-05,79,3,56,135
"8929","1300-1359",2018-09-06,79,4,55,134
"8930","1300-1359",2018-09-07,77,5,56,133
"8931","1300-1359",2018-09-08,68,6,53,121
"8932","1300-1359",2018-09-09,85,7,62,147
"8933","1300-1359",2018-09-10,79,1,60,139
"8934","1300-1359",2018-09-11,77,2,56,133
"8935","1300-1359",2018-09-12,79,3,59,138
"8936","1300-1359",2018-09-13,83,4,59,142
"8937","1300-1359",2018-09-14,81,5,60,141
"8938","1300-1359",2018-09-15,71,6,52,123
"8939","1300-1359",2018-09-16,83,7,63,146
"8940","1300-1359",2018-09-17,81,1,60,141
"8941","1300-1359",2018-09-18,78,2,55,133
"8942","1300-1359",2018-09-19,83,3,58,141
"8943","1300-1359",2018-09-20,83,4,59,142
"8944","1300-1359",2018-09-21,81,5,60,141
"8945","1300-1359",2018-09-22,69,6,51,120
"8946","1300-1359",2018-09-23,83,7,63,146
"8947","1300-1359",2018-09-24,81,1,59,140
"8948","1300-1359",2018-09-25,79,2,55,134
"8949","1300-1359",2018-09-26,81,3,58,139
"8950","1300-1359",2018-09-27,83,4,58,141
"8951","1300-1359",2018-09-28,80,5,58,138
"8952","1300-1359",2018-09-29,68,6,51,119
"8953","1300-1359",2018-09-30,83,7,62,145
"8954","1400-1459",2018-09-01,63,6,75,138
"8955","1400-1459",2018-09-02,65,7,68,133
"8956","1400-1459",2018-09-03,70,1,87,157
"8957","1400-1459",2018-09-04,66,2,85,151
"8958","1400-1459",2018-09-05,67,3,87,154
"8959","1400-1459",2018-09-06,70,4,87,157
"8960","1400-1459",2018-09-07,70,5,88,158
"8961","1400-1459",2018-09-08,65,6,71,136
"8962","1400-1459",2018-09-09,67,7,79,146
"8963","1400-1459",2018-09-10,73,1,88,161
"8964","1400-1459",2018-09-11,66,2,83,149
"8965","1400-1459",2018-09-12,71,3,86,157
"8966","1400-1459",2018-09-13,74,4,87,161
"8967","1400-1459",2018-09-14,73,5,89,162
"8968","1400-1459",2018-09-15,65,6,72,137
"8969","1400-1459",2018-09-16,69,7,78,147
"8970","1400-1459",2018-09-17,74,1,89,163
"8971","1400-1459",2018-09-18,65,2,84,149
"8972","1400-1459",2018-09-19,69,3,87,156
"8973","1400-1459",2018-09-20,73,4,87,160
"8974","1400-1459",2018-09-21,73,5,89,162
"8975","1400-1459",2018-09-22,66,6,71,137
"8976","1400-1459",2018-09-23,68,7,78,146
"8977","1400-1459",2018-09-24,72,1,89,161
"8978","1400-1459",2018-09-25,65,2,84,149
"8979","1400-1459",2018-09-26,71,3,87,158
"8980","1400-1459",2018-09-27,72,4,87,159
"8981","1400-1459",2018-09-28,72,5,88,160
"8982","1400-1459",2018-09-29,64,6,71,135
"8983","1400-1459",2018-09-30,66,7,78,144
"8984","1500-1559",2018-09-01,67,6,61,128
"8985","1500-1559",2018-09-02,79,7,67,146
"8986","1500-1559",2018-09-03,86,1,68,154
"8987","1500-1559",2018-09-04,85,2,66,151
"8988","1500-1559",2018-09-05,87,3,67,154
"8989","1500-1559",2018-09-06,87,4,67,154
"8990","1500-1559",2018-09-07,86,5,66,152
"8991","1500-1559",2018-09-08,65,6,61,126
"8992","1500-1559",2018-09-09,86,7,71,157
"8993","1500-1559",2018-09-10,85,1,68,153
"8994","1500-1559",2018-09-11,83,2,65,148
"8995","1500-1559",2018-09-12,85,3,68,153
"8996","1500-1559",2018-09-13,88,4,71,159
"8997","1500-1559",2018-09-14,89,5,70,159
"8998","1500-1559",2018-09-15,67,6,62,129
"8999","1500-1559",2018-09-16,83,7,71,154
"9000","1500-1559",2018-09-17,87,1,70,157
"9001","1500-1559",2018-09-18,85,2,67,152
"9002","1500-1559",2018-09-19,87,3,70,157
"9003","1500-1559",2018-09-20,89,4,71,160
"9004","1500-1559",2018-09-21,89,5,70,159
"9005","1500-1559",2018-09-22,67,6,62,129
"9006","1500-1559",2018-09-23,85,7,71,156
"9007","1500-1559",2018-09-24,88,1,70,158
"9008","1500-1559",2018-09-25,85,2,67,152
"9009","1500-1559",2018-09-26,87,3,70,157
"9010","1500-1559",2018-09-27,89,4,70,159
"9011","1500-1559",2018-09-28,89,5,70,159
"9012","1500-1559",2018-09-29,67,6,61,128
"9013","1500-1559",2018-09-30,85,7,70,155
"9014","1600-1659",2018-09-01,65,6,73,138
"9015","1600-1659",2018-09-02,72,7,83,155
"9016","1600-1659",2018-09-03,76,1,87,163
"9017","1600-1659",2018-09-04,75,2,92,167
"9018","1600-1659",2018-09-05,78,3,92,170
"9019","1600-1659",2018-09-06,79,4,92,171
"9020","1600-1659",2018-09-07,76,5,91,167
"9021","1600-1659",2018-09-08,72,6,71,143
"9022","1600-1659",2018-09-09,80,7,85,165
"9023","1600-1659",2018-09-10,74,1,91,165
"9024","1600-1659",2018-09-11,75,2,90,165
"9025","1600-1659",2018-09-12,78,3,91,169
"9026","1600-1659",2018-09-13,78,4,94,172
"9027","1600-1659",2018-09-14,77,5,92,169
"9028","1600-1659",2018-09-15,71,6,72,143
"9029","1600-1659",2018-09-16,78,7,87,165
"9030","1600-1659",2018-09-17,77,1,93,170
"9031","1600-1659",2018-09-18,78,2,91,169
"9032","1600-1659",2018-09-19,78,3,94,172
"9033","1600-1659",2018-09-20,78,4,94,172
"9034","1600-1659",2018-09-21,78,5,92,170
"9035","1600-1659",2018-09-22,70,6,71,141
"9036","1600-1659",2018-09-23,80,7,87,167
"9037","1600-1659",2018-09-24,76,1,93,169
"9038","1600-1659",2018-09-25,77,2,92,169
"9039","1600-1659",2018-09-26,79,3,93,172
"9040","1600-1659",2018-09-27,79,4,94,173
"9041","1600-1659",2018-09-28,78,5,91,169
"9042","1600-1659",2018-09-29,70,6,72,142
"9043","1600-1659",2018-09-30,79,7,87,166
"9044","1700-1759",2018-09-01,66,6,63,129
"9045","1700-1759",2018-09-02,75,7,73,148
"9046","1700-1759",2018-09-03,84,1,79,163
"9047","1700-1759",2018-09-04,77,2,76,153
"9048","1700-1759",2018-09-05,80,3,77,157
"9049","1700-1759",2018-09-06,81,4,79,160
"9050","1700-1759",2018-09-07,82,5,79,161
"9051","1700-1759",2018-09-08,63,6,63,126
"9052","1700-1759",2018-09-09,83,7,82,165
"9053","1700-1759",2018-09-10,86,1,81,167
"9054","1700-1759",2018-09-11,78,2,74,152
"9055","1700-1759",2018-09-12,82,3,79,161
"9056","1700-1759",2018-09-13,89,4,82,171
"9057","1700-1759",2018-09-14,89,5,83,172
"9058","1700-1759",2018-09-15,63,6,66,129
"9059","1700-1759",2018-09-16,84,7,80,164
"9060","1700-1759",2018-09-17,87,1,82,169
"9061","1700-1759",2018-09-18,80,2,75,155
"9062","1700-1759",2018-09-19,83,3,78,161
"9063","1700-1759",2018-09-20,89,4,82,171
"9064","1700-1759",2018-09-21,87,5,84,171
"9065","1700-1759",2018-09-22,64,6,66,130
"9066","1700-1759",2018-09-23,83,7,81,164
"9067","1700-1759",2018-09-24,87,1,81,168
"9068","1700-1759",2018-09-25,79,2,75,154
"9069","1700-1759",2018-09-26,82,3,79,161
"9070","1700-1759",2018-09-27,86,4,82,168
"9071","1700-1759",2018-09-28,86,5,84,170
"9072","1700-1759",2018-09-29,63,6,66,129
"9073","1700-1759",2018-09-30,82,7,81,163
"9074","1800-1859",2018-09-01,49,6,63,112
"9075","1800-1859",2018-09-02,63,7,77,140
"9076","1800-1859",2018-09-03,76,1,85,161
"9077","1800-1859",2018-09-04,67,2,79,146
"9078","1800-1859",2018-09-05,68,3,81,149
"9079","1800-1859",2018-09-06,75,4,82,157
"9080","1800-1859",2018-09-07,72,5,80,152
"9081","1800-1859",2018-09-08,62,6,69,131
"9082","1800-1859",2018-09-09,79,7,85,164
"9083","1800-1859",2018-09-10,76,1,81,157
"9084","1800-1859",2018-09-11,70,2,80,150
"9085","1800-1859",2018-09-12,72,3,81,153
"9086","1800-1859",2018-09-13,81,4,86,167
"9087","1800-1859",2018-09-14,79,5,85,164
"9088","1800-1859",2018-09-15,65,6,69,134
"9089","1800-1859",2018-09-16,79,7,84,163
"9090","1800-1859",2018-09-17,80,1,84,164
"9091","1800-1859",2018-09-18,71,2,81,152
"9092","1800-1859",2018-09-19,74,3,83,157
"9093","1800-1859",2018-09-20,79,4,86,165
"9094","1800-1859",2018-09-21,79,5,84,163
"9095","1800-1859",2018-09-22,64,6,67,131
"9096","1800-1859",2018-09-23,81,7,84,165
"9097","1800-1859",2018-09-24,79,1,83,162
"9098","1800-1859",2018-09-25,72,2,81,153
"9099","1800-1859",2018-09-26,75,3,83,158
"9100","1800-1859",2018-09-27,81,4,86,167
"9101","1800-1859",2018-09-28,80,5,84,164
"9102","1800-1859",2018-09-29,64,6,66,130
"9103","1800-1859",2018-09-30,78,7,83,161
"9104","1900-1959",2018-09-01,54,6,75,129
"9105","1900-1959",2018-09-02,69,7,70,139
"9106","1900-1959",2018-09-03,78,1,84,162
"9107","1900-1959",2018-09-04,74,2,77,151
"9108","1900-1959",2018-09-05,74,3,79,153
"9109","1900-1959",2018-09-06,76,4,80,156
"9110","1900-1959",2018-09-07,78,5,79,157
"9111","1900-1959",2018-09-08,64,6,72,136
"9112","1900-1959",2018-09-09,78,7,82,160
"9113","1900-1959",2018-09-10,78,1,82,160
"9114","1900-1959",2018-09-11,74,2,79,153
"9115","1900-1959",2018-09-12,75,3,79,154
"9116","1900-1959",2018-09-13,79,4,85,164
"9117","1900-1959",2018-09-14,79,5,85,164
"9118","1900-1959",2018-09-15,63,6,75,138
"9119","1900-1959",2018-09-16,78,7,80,158
"9120","1900-1959",2018-09-17,79,1,84,163
"9121","1900-1959",2018-09-18,75,2,81,156
"9122","1900-1959",2018-09-19,74,3,82,156
"9123","1900-1959",2018-09-20,79,4,85,164
"9124","1900-1959",2018-09-21,79,5,84,163
"9125","1900-1959",2018-09-22,63,6,76,139
"9126","1900-1959",2018-09-23,78,7,82,160
"9127","1900-1959",2018-09-24,79,1,84,163
"9128","1900-1959",2018-09-25,75,2,81,156
"9129","1900-1959",2018-09-26,74,3,81,155
"9130","1900-1959",2018-09-27,77,4,84,161
"9131","1900-1959",2018-09-28,79,5,84,163
"9132","1900-1959",2018-09-29,61,6,77,138
"9133","1900-1959",2018-09-30,78,7,82,160
"9134","2000-2059",2018-09-01,42,6,69,111
"9135","2000-2059",2018-09-02,51,7,80,131
"9136","2000-2059",2018-09-03,68,1,88,156
"9137","2000-2059",2018-09-04,61,2,81,142
"9138","2000-2059",2018-09-05,62,3,84,146
"9139","2000-2059",2018-09-06,63,4,86,149
"9140","2000-2059",2018-09-07,62,5,86,148
"9141","2000-2059",2018-09-08,48,6,79,127
"9142","2000-2059",2018-09-09,65,7,88,153
"9143","2000-2059",2018-09-10,63,1,85,148
"9144","2000-2059",2018-09-11,61,2,81,142
"9145","2000-2059",2018-09-12,62,3,85,147
"9146","2000-2059",2018-09-13,66,4,89,155
"9147","2000-2059",2018-09-14,66,5,89,155
"9148","2000-2059",2018-09-15,48,6,80,128
"9149","2000-2059",2018-09-16,65,7,86,151
"9150","2000-2059",2018-09-17,65,1,88,153
"9151","2000-2059",2018-09-18,61,2,84,145
"9152","2000-2059",2018-09-19,62,3,85,147
"9153","2000-2059",2018-09-20,66,4,87,153
"9154","2000-2059",2018-09-21,66,5,89,155
"9155","2000-2059",2018-09-22,48,6,80,128
"9156","2000-2059",2018-09-23,65,7,88,153
"9157","2000-2059",2018-09-24,65,1,87,152
"9158","2000-2059",2018-09-25,61,2,83,144
"9159","2000-2059",2018-09-26,62,3,86,148
"9160","2000-2059",2018-09-27,66,4,87,153
"9161","2000-2059",2018-09-28,67,5,89,156
"9162","2000-2059",2018-09-29,49,6,77,126
"9163","2000-2059",2018-09-30,64,7,85,149
"9164","2100-2159",2018-09-01,43,6,64,107
"9165","2100-2159",2018-09-02,48,7,84,132
"9166","2100-2159",2018-09-03,67,1,91,158
"9167","2100-2159",2018-09-04,64,2,85,149
"9168","2100-2159",2018-09-05,63,3,83,146
"9169","2100-2159",2018-09-06,63,4,91,154
"9170","2100-2159",2018-09-07,60,5,91,151
"9171","2100-2159",2018-09-08,42,6,79,121
"9172","2100-2159",2018-09-09,65,7,94,159
"9173","2100-2159",2018-09-10,61,1,94,155
"9174","2100-2159",2018-09-11,62,2,86,148
"9175","2100-2159",2018-09-12,61,3,88,149
"9176","2100-2159",2018-09-13,64,4,99,163
"9177","2100-2159",2018-09-14,64,5,98,162
"9178","2100-2159",2018-09-15,42,6,78,120
"9179","2100-2159",2018-09-16,64,7,96,160
"9180","2100-2159",2018-09-17,62,1,97,159
"9181","2100-2159",2018-09-18,61,2,88,149
"9182","2100-2159",2018-09-19,61,3,88,149
"9183","2100-2159",2018-09-20,63,4,100,163
"9184","2100-2159",2018-09-21,63,5,98,161
"9185","2100-2159",2018-09-22,42,6,79,121
"9186","2100-2159",2018-09-23,64,7,95,159
"9187","2100-2159",2018-09-24,62,1,97,159
"9188","2100-2159",2018-09-25,61,2,88,149
"9189","2100-2159",2018-09-26,61,3,89,150
"9190","2100-2159",2018-09-27,63,4,99,162
"9191","2100-2159",2018-09-28,63,5,98,161
"9192","2100-2159",2018-09-29,42,6,78,120
"9193","2100-2159",2018-09-30,66,7,94,160
"9194","2200-2259",2018-09-01,27,6,58,85
"9195","2200-2259",2018-09-02,35,7,60,95
"9196","2200-2259",2018-09-03,47,1,85,132
"9197","2200-2259",2018-09-04,43,2,77,120
"9198","2200-2259",2018-09-05,45,3,78,123
"9199","2200-2259",2018-09-06,50,4,80,130
"9200","2200-2259",2018-09-07,50,5,77,127
"9201","2200-2259",2018-09-08,31,6,62,93
"9202","2200-2259",2018-09-09,56,7,78,134
"9203","2200-2259",2018-09-10,51,1,80,131
"9204","2200-2259",2018-09-11,42,2,79,121
"9205","2200-2259",2018-09-12,47,3,80,127
"9206","2200-2259",2018-09-13,54,4,81,135
"9207","2200-2259",2018-09-14,52,5,79,131
"9208","2200-2259",2018-09-15,31,6,64,95
"9209","2200-2259",2018-09-16,57,7,79,136
"9210","2200-2259",2018-09-17,52,1,80,132
"9211","2200-2259",2018-09-18,43,2,78,121
"9212","2200-2259",2018-09-19,48,3,79,127
"9213","2200-2259",2018-09-20,54,4,79,133
"9214","2200-2259",2018-09-21,53,5,79,132
"9215","2200-2259",2018-09-22,31,6,63,94
"9216","2200-2259",2018-09-23,56,7,78,134
"9217","2200-2259",2018-09-24,52,1,80,132
"9218","2200-2259",2018-09-25,43,2,78,121
"9219","2200-2259",2018-09-26,48,3,79,127
"9220","2200-2259",2018-09-27,53,4,80,133
"9221","2200-2259",2018-09-28,53,5,80,133
"9222","2200-2259",2018-09-29,30,6,63,93
"9223","2200-2259",2018-09-30,56,7,78,134
"9224","2300-2359",2018-09-01,17,6,41,58
"9225","2300-2359",2018-09-02,22,7,54,76
"9226","2300-2359",2018-09-03,23,1,76,99
"9227","2300-2359",2018-09-04,22,2,69,91
"9228","2300-2359",2018-09-05,24,3,72,96
"9229","2300-2359",2018-09-06,20,4,70,90
"9230","2300-2359",2018-09-07,22,5,71,93
"9231","2300-2359",2018-09-08,16,6,44,60
"9232","2300-2359",2018-09-09,21,7,81,102
"9233","2300-2359",2018-09-10,19,1,73,92
"9234","2300-2359",2018-09-11,18,2,68,86
"9235","2300-2359",2018-09-12,20,3,71,91
"9236","2300-2359",2018-09-13,20,4,76,96
"9237","2300-2359",2018-09-14,22,5,77,99
"9238","2300-2359",2018-09-15,15,6,43,58
"9239","2300-2359",2018-09-16,21,7,79,100
"9240","2300-2359",2018-09-17,19,1,75,94
"9241","2300-2359",2018-09-18,18,2,68,86
"9242","2300-2359",2018-09-19,21,3,71,92
"9243","2300-2359",2018-09-20,20,4,77,97
"9244","2300-2359",2018-09-21,22,5,77,99
"9245","2300-2359",2018-09-22,15,6,43,58
"9246","2300-2359",2018-09-23,22,7,80,102
"9247","2300-2359",2018-09-24,19,1,75,94
"9248","2300-2359",2018-09-25,18,2,68,86
"9249","2300-2359",2018-09-26,21,3,71,92
"9250","2300-2359",2018-09-27,19,4,76,95
"9251","2300-2359",2018-09-28,22,5,77,99
"9252","2300-2359",2018-09-29,15,6,43,58
"9253","2300-2359",2018-09-30,22,7,81,103
"9254","0001-0559",2018-08-01,39,3,99,138
"9255","0001-0559",2018-08-02,39,4,100,139
"9256","0001-0559",2018-08-03,39,5,99,138
"9257","0001-0559",2018-08-04,37,6,64,101
"9258","0001-0559",2018-08-05,33,7,100,133
"9259","0001-0559",2018-08-06,41,1,101,142
"9260","0001-0559",2018-08-07,36,2,87,123
"9261","0001-0559",2018-08-08,36,3,86,122
"9262","0001-0559",2018-08-09,36,4,88,124
"9263","0001-0559",2018-08-10,36,5,86,122
"9264","0001-0559",2018-08-11,25,6,61,86
"9265","0001-0559",2018-08-12,30,7,89,119
"9266","0001-0559",2018-08-13,35,1,86,121
"9267","0001-0559",2018-08-14,34,2,84,118
"9268","0001-0559",2018-08-15,34,3,83,117
"9269","0001-0559",2018-08-16,34,4,84,118
"9270","0001-0559",2018-08-17,34,5,82,116
"9271","0001-0559",2018-08-18,24,6,59,83
"9272","0001-0559",2018-08-19,29,7,86,115
"9273","0001-0559",2018-08-20,36,1,81,117
"9274","0001-0559",2018-08-21,34,2,67,101
"9275","0001-0559",2018-08-22,35,3,67,102
"9276","0001-0559",2018-08-23,35,4,70,105
"9277","0001-0559",2018-08-24,35,5,71,106
"9278","0001-0559",2018-08-25,25,6,53,78
"9279","0001-0559",2018-08-26,27,7,75,102
"9280","0001-0559",2018-08-27,36,1,70,106
"9281","0001-0559",2018-08-28,32,2,65,97
"9282","0001-0559",2018-08-29,32,3,67,99
"9283","0001-0559",2018-08-30,33,4,70,103
"9284","0001-0559",2018-08-31,34,5,70,104
"9285","0600-0659",2018-08-01,112,3,37,149
"9286","0600-0659",2018-08-02,111,4,37,148
"9287","0600-0659",2018-08-03,112,5,37,149
"9288","0600-0659",2018-08-04,95,6,31,126
"9289","0600-0659",2018-08-05,106,7,33,139
"9290","0600-0659",2018-08-06,114,1,37,151
"9291","0600-0659",2018-08-07,113,2,34,147
"9292","0600-0659",2018-08-08,115,3,34,149
"9293","0600-0659",2018-08-09,113,4,34,147
"9294","0600-0659",2018-08-10,115,5,34,149
"9295","0600-0659",2018-08-11,91,6,27,118
"9296","0600-0659",2018-08-12,107,7,32,139
"9297","0600-0659",2018-08-13,114,1,33,147
"9298","0600-0659",2018-08-14,114,2,33,147
"9299","0600-0659",2018-08-15,114,3,33,147
"9300","0600-0659",2018-08-16,114,4,33,147
"9301","0600-0659",2018-08-17,112,5,33,145
"9302","0600-0659",2018-08-18,91,6,28,119
"9303","0600-0659",2018-08-19,105,7,31,136
"9304","0600-0659",2018-08-20,114,1,32,146
"9305","0600-0659",2018-08-21,110,2,30,140
"9306","0600-0659",2018-08-22,107,3,30,137
"9307","0600-0659",2018-08-23,109,4,31,140
"9308","0600-0659",2018-08-24,111,5,32,143
"9309","0600-0659",2018-08-25,96,6,26,122
"9310","0600-0659",2018-08-26,95,7,28,123
"9311","0600-0659",2018-08-27,110,1,32,142
"9312","0600-0659",2018-08-28,108,2,27,135
"9313","0600-0659",2018-08-29,105,3,28,133
"9314","0600-0659",2018-08-30,108,4,31,139
"9315","0600-0659",2018-08-31,108,5,32,140
"9316","0700-0759",2018-08-01,109,3,73,182
"9317","0700-0759",2018-08-02,110,4,73,183
"9318","0700-0759",2018-08-03,110,5,74,184
"9319","0700-0759",2018-08-04,103,6,63,166
"9320","0700-0759",2018-08-05,102,7,69,171
"9321","0700-0759",2018-08-06,108,1,76,184
"9322","0700-0759",2018-08-07,113,2,76,189
"9323","0700-0759",2018-08-08,114,3,77,191
"9324","0700-0759",2018-08-09,115,4,77,192
"9325","0700-0759",2018-08-10,115,5,78,193
"9326","0700-0759",2018-08-11,103,6,59,162
"9327","0700-0759",2018-08-12,102,7,70,172
"9328","0700-0759",2018-08-13,112,1,76,188
"9329","0700-0759",2018-08-14,110,2,75,185
"9330","0700-0759",2018-08-15,111,3,76,187
"9331","0700-0759",2018-08-16,113,4,76,189
"9332","0700-0759",2018-08-17,113,5,77,190
"9333","0700-0759",2018-08-18,97,6,57,154
"9334","0700-0759",2018-08-19,99,7,68,167
"9335","0700-0759",2018-08-20,113,1,75,188
"9336","0700-0759",2018-08-21,111,2,69,180
"9337","0700-0759",2018-08-22,110,3,69,179
"9338","0700-0759",2018-08-23,112,4,71,183
"9339","0700-0759",2018-08-24,112,5,72,184
"9340","0700-0759",2018-08-25,96,6,54,150
"9341","0700-0759",2018-08-26,100,7,60,160
"9342","0700-0759",2018-08-27,110,1,70,180
"9343","0700-0759",2018-08-28,109,2,68,177
"9344","0700-0759",2018-08-29,109,3,66,175
"9345","0700-0759",2018-08-30,110,4,68,178
"9346","0700-0759",2018-08-31,112,5,69,181
"9347","0800-0859",2018-08-01,103,3,80,183
"9348","0800-0859",2018-08-02,102,4,80,182
"9349","0800-0859",2018-08-03,103,5,80,183
"9350","0800-0859",2018-08-04,90,6,75,165
"9351","0800-0859",2018-08-05,105,7,78,183
"9352","0800-0859",2018-08-06,105,1,80,185
"9353","0800-0859",2018-08-07,106,2,80,186
"9354","0800-0859",2018-08-08,105,3,80,185
"9355","0800-0859",2018-08-09,105,4,79,184
"9356","0800-0859",2018-08-10,105,5,80,185
"9357","0800-0859",2018-08-11,96,6,73,169
"9358","0800-0859",2018-08-12,109,7,76,185
"9359","0800-0859",2018-08-13,106,1,77,183
"9360","0800-0859",2018-08-14,106,2,79,185
"9361","0800-0859",2018-08-15,105,3,77,182
"9362","0800-0859",2018-08-16,106,4,79,185
"9363","0800-0859",2018-08-17,106,5,77,183
"9364","0800-0859",2018-08-18,98,6,71,169
"9365","0800-0859",2018-08-19,111,7,72,183
"9366","0800-0859",2018-08-20,107,1,79,186
"9367","0800-0859",2018-08-21,102,2,80,182
"9368","0800-0859",2018-08-22,102,3,79,181
"9369","0800-0859",2018-08-23,105,4,80,185
"9370","0800-0859",2018-08-24,103,5,80,183
"9371","0800-0859",2018-08-25,99,6,74,173
"9372","0800-0859",2018-08-26,112,7,72,184
"9373","0800-0859",2018-08-27,110,1,81,191
"9374","0800-0859",2018-08-28,108,2,79,187
"9375","0800-0859",2018-08-29,108,3,79,187
"9376","0800-0859",2018-08-30,109,4,80,189
"9377","0800-0859",2018-08-31,108,5,80,188
"9378","0900-0959",2018-08-01,89,3,61,150
"9379","0900-0959",2018-08-02,93,4,63,156
"9380","0900-0959",2018-08-03,92,5,63,155
"9381","0900-0959",2018-08-04,85,6,50,135
"9382","0900-0959",2018-08-05,90,7,58,148
"9383","0900-0959",2018-08-06,91,1,62,153
"9384","0900-0959",2018-08-07,92,2,66,158
"9385","0900-0959",2018-08-08,88,3,64,152
"9386","0900-0959",2018-08-09,90,4,66,156
"9387","0900-0959",2018-08-10,92,5,66,158
"9388","0900-0959",2018-08-11,89,6,54,143
"9389","0900-0959",2018-08-12,88,7,63,151
"9390","0900-0959",2018-08-13,88,1,65,153
"9391","0900-0959",2018-08-14,89,2,65,154
"9392","0900-0959",2018-08-15,87,3,65,152
"9393","0900-0959",2018-08-16,89,4,65,154
"9394","0900-0959",2018-08-17,88,5,65,153
"9395","0900-0959",2018-08-18,83,6,55,138
"9396","0900-0959",2018-08-19,85,7,64,149
"9397","0900-0959",2018-08-20,88,1,65,153
"9398","0900-0959",2018-08-21,85,2,61,146
"9399","0900-0959",2018-08-22,84,3,60,144
"9400","0900-0959",2018-08-23,85,4,61,146
"9401","0900-0959",2018-08-24,86,5,62,148
"9402","0900-0959",2018-08-25,82,6,53,135
"9403","0900-0959",2018-08-26,83,7,60,143
"9404","0900-0959",2018-08-27,85,1,62,147
"9405","0900-0959",2018-08-28,84,2,62,146
"9406","0900-0959",2018-08-29,83,3,61,144
"9407","0900-0959",2018-08-30,84,4,62,146
"9408","0900-0959",2018-08-31,85,5,62,147
"9409","1000-1059",2018-08-01,77,3,69,146
"9410","1000-1059",2018-08-02,76,4,70,146
"9411","1000-1059",2018-08-03,77,5,70,147
"9412","1000-1059",2018-08-04,68,6,66,134
"9413","1000-1059",2018-08-05,76,7,69,145
"9414","1000-1059",2018-08-06,77,1,70,147
"9415","1000-1059",2018-08-07,82,2,71,153
"9416","1000-1059",2018-08-08,82,3,71,153
"9417","1000-1059",2018-08-09,82,4,72,154
"9418","1000-1059",2018-08-10,84,5,72,156
"9419","1000-1059",2018-08-11,66,6,64,130
"9420","1000-1059",2018-08-12,77,7,64,141
"9421","1000-1059",2018-08-13,84,1,72,156
"9422","1000-1059",2018-08-14,82,2,71,153
"9423","1000-1059",2018-08-15,84,3,71,155
"9424","1000-1059",2018-08-16,83,4,72,155
"9425","1000-1059",2018-08-17,84,5,72,156
"9426","1000-1059",2018-08-18,70,6,61,131
"9427","1000-1059",2018-08-19,78,7,64,142
"9428","1000-1059",2018-08-20,84,1,72,156
"9429","1000-1059",2018-08-21,83,2,70,153
"9430","1000-1059",2018-08-22,84,3,71,155
"9431","1000-1059",2018-08-23,83,4,74,157
"9432","1000-1059",2018-08-24,86,5,73,159
"9433","1000-1059",2018-08-25,70,6,62,132
"9434","1000-1059",2018-08-26,79,7,67,146
"9435","1000-1059",2018-08-27,84,1,76,160
"9436","1000-1059",2018-08-28,79,2,75,154
"9437","1000-1059",2018-08-29,82,3,74,156
"9438","1000-1059",2018-08-30,82,4,75,157
"9439","1000-1059",2018-08-31,82,5,74,156
"9440","1100-1159",2018-08-01,82,3,83,165
"9441","1100-1159",2018-08-02,84,4,83,167
"9442","1100-1159",2018-08-03,83,5,84,167
"9443","1100-1159",2018-08-04,71,6,73,144
"9444","1100-1159",2018-08-05,78,7,79,157
"9445","1100-1159",2018-08-06,83,1,85,168
"9446","1100-1159",2018-08-07,78,2,82,160
"9447","1100-1159",2018-08-08,80,3,83,163
"9448","1100-1159",2018-08-09,82,4,82,164
"9449","1100-1159",2018-08-10,81,5,84,165
"9450","1100-1159",2018-08-11,75,6,73,148
"9451","1100-1159",2018-08-12,78,7,82,160
"9452","1100-1159",2018-08-13,83,1,83,166
"9453","1100-1159",2018-08-14,80,2,82,162
"9454","1100-1159",2018-08-15,82,3,82,164
"9455","1100-1159",2018-08-16,83,4,83,166
"9456","1100-1159",2018-08-17,82,5,83,165
"9457","1100-1159",2018-08-18,72,6,71,143
"9458","1100-1159",2018-08-19,82,7,82,164
"9459","1100-1159",2018-08-20,83,1,84,167
"9460","1100-1159",2018-08-21,77,2,85,162
"9461","1100-1159",2018-08-22,79,3,83,162
"9462","1100-1159",2018-08-23,79,4,82,161
"9463","1100-1159",2018-08-24,79,5,83,162
"9464","1100-1159",2018-08-25,68,6,75,143
"9465","1100-1159",2018-08-26,75,7,84,159
"9466","1100-1159",2018-08-27,78,1,84,162
"9467","1100-1159",2018-08-28,76,2,82,158
"9468","1100-1159",2018-08-29,78,3,82,160
"9469","1100-1159",2018-08-30,79,4,82,161
"9470","1100-1159",2018-08-31,78,5,84,162
"9471","1200-1259",2018-08-01,78,3,76,154
"9472","1200-1259",2018-08-02,77,4,76,153
"9473","1200-1259",2018-08-03,78,5,76,154
"9474","1200-1259",2018-08-04,67,6,73,140
"9475","1200-1259",2018-08-05,71,7,73,144
"9476","1200-1259",2018-08-06,80,1,77,157
"9477","1200-1259",2018-08-07,81,2,79,160
"9478","1200-1259",2018-08-08,85,3,80,165
"9479","1200-1259",2018-08-09,83,4,81,164
"9480","1200-1259",2018-08-10,84,5,82,166
"9481","1200-1259",2018-08-11,68,6,76,144
"9482","1200-1259",2018-08-12,70,7,71,141
"9483","1200-1259",2018-08-13,84,1,81,165
"9484","1200-1259",2018-08-14,82,2,79,161
"9485","1200-1259",2018-08-15,84,3,79,163
"9486","1200-1259",2018-08-16,83,4,81,164
"9487","1200-1259",2018-08-17,86,5,79,165
"9488","1200-1259",2018-08-18,71,6,75,146
"9489","1200-1259",2018-08-19,71,7,72,143
"9490","1200-1259",2018-08-20,86,1,80,166
"9491","1200-1259",2018-08-21,78,2,75,153
"9492","1200-1259",2018-08-22,79,3,78,157
"9493","1200-1259",2018-08-23,82,4,79,161
"9494","1200-1259",2018-08-24,84,5,79,163
"9495","1200-1259",2018-08-25,71,6,74,145
"9496","1200-1259",2018-08-26,72,7,69,141
"9497","1200-1259",2018-08-27,84,1,77,161
"9498","1200-1259",2018-08-28,78,2,75,153
"9499","1200-1259",2018-08-29,79,3,77,156
"9500","1200-1259",2018-08-30,80,4,78,158
"9501","1200-1259",2018-08-31,83,5,76,159
"9502","1300-1359",2018-08-01,81,3,62,143
"9503","1300-1359",2018-08-02,81,4,62,143
"9504","1300-1359",2018-08-03,81,5,63,144
"9505","1300-1359",2018-08-04,67,6,58,125
"9506","1300-1359",2018-08-05,73,7,61,134
"9507","1300-1359",2018-08-06,80,1,64,144
"9508","1300-1359",2018-08-07,75,2,64,139
"9509","1300-1359",2018-08-08,74,3,65,139
"9510","1300-1359",2018-08-09,75,4,65,140
"9511","1300-1359",2018-08-10,77,5,66,143
"9512","1300-1359",2018-08-11,69,6,58,127
"9513","1300-1359",2018-08-12,79,7,65,144
"9514","1300-1359",2018-08-13,76,1,66,142
"9515","1300-1359",2018-08-14,74,2,63,137
"9516","1300-1359",2018-08-15,74,3,66,140
"9517","1300-1359",2018-08-16,74,4,64,138
"9518","1300-1359",2018-08-17,74,5,66,140
"9519","1300-1359",2018-08-18,68,6,57,125
"9520","1300-1359",2018-08-19,79,7,67,146
"9521","1300-1359",2018-08-20,74,1,65,139
"9522","1300-1359",2018-08-21,70,2,60,130
"9523","1300-1359",2018-08-22,73,3,62,135
"9524","1300-1359",2018-08-23,75,4,61,136
"9525","1300-1359",2018-08-24,74,5,63,137
"9526","1300-1359",2018-08-25,67,6,54,121
"9527","1300-1359",2018-08-26,81,7,64,145
"9528","1300-1359",2018-08-27,73,1,64,137
"9529","1300-1359",2018-08-28,68,2,58,126
"9530","1300-1359",2018-08-29,73,3,62,135
"9531","1300-1359",2018-08-30,75,4,62,137
"9532","1300-1359",2018-08-31,73,5,64,137
"9533","1400-1459",2018-08-01,71,3,96,167
"9534","1400-1459",2018-08-02,69,4,93,162
"9535","1400-1459",2018-08-03,70,5,94,164
"9536","1400-1459",2018-08-04,65,6,77,142
"9537","1400-1459",2018-08-05,70,7,84,154
"9538","1400-1459",2018-08-06,72,1,94,166
"9539","1400-1459",2018-08-07,72,2,87,159
"9540","1400-1459",2018-08-08,74,3,91,165
"9541","1400-1459",2018-08-09,72,4,88,160
"9542","1400-1459",2018-08-10,73,5,89,162
"9543","1400-1459",2018-08-11,70,6,80,150
"9544","1400-1459",2018-08-12,68,7,82,150
"9545","1400-1459",2018-08-13,71,1,89,160
"9546","1400-1459",2018-08-14,69,2,86,155
"9547","1400-1459",2018-08-15,72,3,89,161
"9548","1400-1459",2018-08-16,70,4,87,157
"9549","1400-1459",2018-08-17,70,5,90,160
"9550","1400-1459",2018-08-18,65,6,78,143
"9551","1400-1459",2018-08-19,69,7,82,151
"9552","1400-1459",2018-08-20,70,1,92,162
"9553","1400-1459",2018-08-21,67,2,81,148
"9554","1400-1459",2018-08-22,71,3,87,158
"9555","1400-1459",2018-08-23,70,4,85,155
"9556","1400-1459",2018-08-24,70,5,88,158
"9557","1400-1459",2018-08-25,67,6,75,142
"9558","1400-1459",2018-08-26,70,7,79,149
"9559","1400-1459",2018-08-27,72,1,85,157
"9560","1400-1459",2018-08-28,65,2,81,146
"9561","1400-1459",2018-08-29,69,3,85,154
"9562","1400-1459",2018-08-30,71,4,83,154
"9563","1400-1459",2018-08-31,71,5,85,156
"9564","1500-1559",2018-08-01,89,3,66,155
"9565","1500-1559",2018-08-02,88,4,67,155
"9566","1500-1559",2018-08-03,89,5,66,155
"9567","1500-1559",2018-08-04,82,6,62,144
"9568","1500-1559",2018-08-05,89,7,70,159
"9569","1500-1559",2018-08-06,89,1,66,155
"9570","1500-1559",2018-08-07,89,2,73,162
"9571","1500-1559",2018-08-08,92,3,71,163
"9572","1500-1559",2018-08-09,91,4,72,163
"9573","1500-1559",2018-08-10,92,5,72,164
"9574","1500-1559",2018-08-11,81,6,68,149
"9575","1500-1559",2018-08-12,90,7,70,160
"9576","1500-1559",2018-08-13,95,1,71,166
"9577","1500-1559",2018-08-14,91,2,72,163
"9578","1500-1559",2018-08-15,92,3,71,163
"9579","1500-1559",2018-08-16,94,4,72,166
"9580","1500-1559",2018-08-17,92,5,71,163
"9581","1500-1559",2018-08-18,77,6,68,145
"9582","1500-1559",2018-08-19,93,7,73,166
"9583","1500-1559",2018-08-20,93,1,71,164
"9584","1500-1559",2018-08-21,86,2,70,156
"9585","1500-1559",2018-08-22,87,3,68,155
"9586","1500-1559",2018-08-23,90,4,73,163
"9587","1500-1559",2018-08-24,89,5,69,158
"9588","1500-1559",2018-08-25,65,6,68,133
"9589","1500-1559",2018-08-26,85,7,73,158
"9590","1500-1559",2018-08-27,87,1,71,158
"9591","1500-1559",2018-08-28,85,2,67,152
"9592","1500-1559",2018-08-29,86,3,69,155
"9593","1500-1559",2018-08-30,88,4,73,161
"9594","1500-1559",2018-08-31,87,5,71,158
"9595","1600-1659",2018-08-01,77,3,86,163
"9596","1600-1659",2018-08-02,79,4,88,167
"9597","1600-1659",2018-08-03,78,5,88,166
"9598","1600-1659",2018-08-04,63,6,71,134
"9599","1600-1659",2018-08-05,77,7,85,162
"9600","1600-1659",2018-08-06,78,1,89,167
"9601","1600-1659",2018-08-07,78,2,90,168
"9602","1600-1659",2018-08-08,78,3,88,166
"9603","1600-1659",2018-08-09,79,4,90,169
"9604","1600-1659",2018-08-10,79,5,91,170
"9605","1600-1659",2018-08-11,68,6,70,138
"9606","1600-1659",2018-08-12,77,7,88,165
"9607","1600-1659",2018-08-13,79,1,93,172
"9608","1600-1659",2018-08-14,76,2,92,168
"9609","1600-1659",2018-08-15,77,3,92,169
"9610","1600-1659",2018-08-16,78,4,92,170
"9611","1600-1659",2018-08-17,77,5,91,168
"9612","1600-1659",2018-08-18,70,6,72,142
"9613","1600-1659",2018-08-19,77,7,90,167
"9614","1600-1659",2018-08-20,76,1,91,167
"9615","1600-1659",2018-08-21,72,2,88,160
"9616","1600-1659",2018-08-22,73,3,90,163
"9617","1600-1659",2018-08-23,75,4,90,165
"9618","1600-1659",2018-08-24,73,5,91,164
"9619","1600-1659",2018-08-25,69,6,71,140
"9620","1600-1659",2018-08-26,77,7,86,163
"9621","1600-1659",2018-08-27,76,1,87,163
"9622","1600-1659",2018-08-28,76,2,84,160
"9623","1600-1659",2018-08-29,77,3,85,162
"9624","1600-1659",2018-08-30,78,4,87,165
"9625","1600-1659",2018-08-31,77,5,86,163
"9626","1700-1759",2018-08-01,87,3,82,169
"9627","1700-1759",2018-08-02,88,4,81,169
"9628","1700-1759",2018-08-03,88,5,82,170
"9629","1700-1759",2018-08-04,78,6,68,146
"9630","1700-1759",2018-08-05,85,7,79,164
"9631","1700-1759",2018-08-06,90,1,82,172
"9632","1700-1759",2018-08-07,93,2,76,169
"9633","1700-1759",2018-08-08,88,3,78,166
"9634","1700-1759",2018-08-09,92,4,79,171
"9635","1700-1759",2018-08-10,94,5,79,173
"9636","1700-1759",2018-08-11,72,6,67,139
"9637","1700-1759",2018-08-12,89,7,79,168
"9638","1700-1759",2018-08-13,93,1,79,172
"9639","1700-1759",2018-08-14,92,2,76,168
"9640","1700-1759",2018-08-15,88,3,78,166
"9641","1700-1759",2018-08-16,92,4,78,170
"9642","1700-1759",2018-08-17,92,5,79,171
"9643","1700-1759",2018-08-18,72,6,65,137
"9644","1700-1759",2018-08-19,88,7,79,167
"9645","1700-1759",2018-08-20,90,1,79,169
"9646","1700-1759",2018-08-21,81,2,75,156
"9647","1700-1759",2018-08-22,80,3,77,157
"9648","1700-1759",2018-08-23,85,4,82,167
"9649","1700-1759",2018-08-24,85,5,81,166
"9650","1700-1759",2018-08-25,70,6,66,136
"9651","1700-1759",2018-08-26,83,7,81,164
"9652","1700-1759",2018-08-27,83,1,81,164
"9653","1700-1759",2018-08-28,79,2,72,151
"9654","1700-1759",2018-08-29,79,3,75,154
"9655","1700-1759",2018-08-30,83,4,80,163
"9656","1700-1759",2018-08-31,83,5,80,163
"9657","1800-1859",2018-08-01,82,3,87,169
"9658","1800-1859",2018-08-02,83,4,93,176
"9659","1800-1859",2018-08-03,84,5,93,177
"9660","1800-1859",2018-08-04,70,6,80,150
"9661","1800-1859",2018-08-05,84,7,84,168
"9662","1800-1859",2018-08-06,83,1,94,177
"9663","1800-1859",2018-08-07,80,2,92,172
"9664","1800-1859",2018-08-08,81,3,88,169
"9665","1800-1859",2018-08-09,82,4,92,174
"9666","1800-1859",2018-08-10,83,5,95,178
"9667","1800-1859",2018-08-11,70,6,80,150
"9668","1800-1859",2018-08-12,81,7,90,171
"9669","1800-1859",2018-08-13,85,1,93,178
"9670","1800-1859",2018-08-14,81,2,91,172
"9671","1800-1859",2018-08-15,81,3,88,169
"9672","1800-1859",2018-08-16,84,4,93,177
"9673","1800-1859",2018-08-17,81,5,90,171
"9674","1800-1859",2018-08-18,69,6,75,144
"9675","1800-1859",2018-08-19,82,7,93,175
"9676","1800-1859",2018-08-20,79,1,90,169
"9677","1800-1859",2018-08-21,81,2,83,164
"9678","1800-1859",2018-08-22,81,3,78,159
"9679","1800-1859",2018-08-23,85,4,83,168
"9680","1800-1859",2018-08-24,82,5,80,162
"9681","1800-1859",2018-08-25,65,6,68,133
"9682","1800-1859",2018-08-26,82,7,88,170
"9683","1800-1859",2018-08-27,81,1,84,165
"9684","1800-1859",2018-08-28,77,2,85,162
"9685","1800-1859",2018-08-29,78,3,82,160
"9686","1800-1859",2018-08-30,81,4,87,168
"9687","1800-1859",2018-08-31,81,5,84,165
"9688","1900-1959",2018-08-01,80,3,84,164
"9689","1900-1959",2018-08-02,84,4,86,170
"9690","1900-1959",2018-08-03,83,5,86,169
"9691","1900-1959",2018-08-04,72,6,80,152
"9692","1900-1959",2018-08-05,84,7,91,175
"9693","1900-1959",2018-08-06,86,1,84,170
"9694","1900-1959",2018-08-07,86,2,90,176
"9695","1900-1959",2018-08-08,84,3,87,171
"9696","1900-1959",2018-08-09,89,4,90,179
"9697","1900-1959",2018-08-10,87,5,89,176
"9698","1900-1959",2018-08-11,71,6,82,153
"9699","1900-1959",2018-08-12,86,7,84,170
"9700","1900-1959",2018-08-13,88,1,88,176
"9701","1900-1959",2018-08-14,85,2,85,170
"9702","1900-1959",2018-08-15,82,3,84,166
"9703","1900-1959",2018-08-16,87,4,87,174
"9704","1900-1959",2018-08-17,86,5,88,174
"9705","1900-1959",2018-08-18,72,6,83,155
"9706","1900-1959",2018-08-19,84,7,80,164
"9707","1900-1959",2018-08-20,83,1,85,168
"9708","1900-1959",2018-08-21,74,2,80,154
"9709","1900-1959",2018-08-22,76,3,82,158
"9710","1900-1959",2018-08-23,78,4,85,163
"9711","1900-1959",2018-08-24,80,5,87,167
"9712","1900-1959",2018-08-25,64,6,81,145
"9713","1900-1959",2018-08-26,78,7,78,156
"9714","1900-1959",2018-08-27,76,1,84,160
"9715","1900-1959",2018-08-28,75,2,78,153
"9716","1900-1959",2018-08-29,75,3,80,155
"9717","1900-1959",2018-08-30,77,4,82,159
"9718","1900-1959",2018-08-31,76,5,84,160
"9719","2000-2059",2018-08-01,70,3,90,160
"9720","2000-2059",2018-08-02,71,4,89,160
"9721","2000-2059",2018-08-03,69,5,90,159
"9722","2000-2059",2018-08-04,55,6,76,131
"9723","2000-2059",2018-08-05,70,7,88,158
"9724","2000-2059",2018-08-06,69,1,92,161
"9725","2000-2059",2018-08-07,70,2,88,158
"9726","2000-2059",2018-08-08,69,3,92,161
"9727","2000-2059",2018-08-09,72,4,92,164
"9728","2000-2059",2018-08-10,72,5,95,167
"9729","2000-2059",2018-08-11,51,6,78,129
"9730","2000-2059",2018-08-12,65,7,91,156
"9731","2000-2059",2018-08-13,69,1,97,166
"9732","2000-2059",2018-08-14,67,2,92,159
"9733","2000-2059",2018-08-15,69,3,94,163
"9734","2000-2059",2018-08-16,69,4,94,163
"9735","2000-2059",2018-08-17,70,5,93,163
"9736","2000-2059",2018-08-18,48,6,77,125
"9737","2000-2059",2018-08-19,63,7,91,154
"9738","2000-2059",2018-08-20,65,1,91,156
"9739","2000-2059",2018-08-21,61,2,90,151
"9740","2000-2059",2018-08-22,60,3,91,151
"9741","2000-2059",2018-08-23,62,4,92,154
"9742","2000-2059",2018-08-24,63,5,91,154
"9743","2000-2059",2018-08-25,47,6,81,128
"9744","2000-2059",2018-08-26,62,7,90,152
"9745","2000-2059",2018-08-27,64,1,91,155
"9746","2000-2059",2018-08-28,62,2,88,150
"9747","2000-2059",2018-08-29,64,3,90,154
"9748","2000-2059",2018-08-30,65,4,90,155
"9749","2000-2059",2018-08-31,65,5,91,156
"9750","2100-2159",2018-08-01,70,3,97,167
"9751","2100-2159",2018-08-02,69,4,94,163
"9752","2100-2159",2018-08-03,69,5,95,164
"9753","2100-2159",2018-08-04,56,6,83,139
"9754","2100-2159",2018-08-05,72,7,95,167
"9755","2100-2159",2018-08-06,69,1,96,165
"9756","2100-2159",2018-08-07,71,2,97,168
"9757","2100-2159",2018-08-08,73,3,98,171
"9758","2100-2159",2018-08-09,72,4,97,169
"9759","2100-2159",2018-08-10,72,5,99,171
"9760","2100-2159",2018-08-11,49,6,85,134
"9761","2100-2159",2018-08-12,71,7,90,161
"9762","2100-2159",2018-08-13,71,1,99,170
"9763","2100-2159",2018-08-14,70,2,96,166
"9764","2100-2159",2018-08-15,70,3,94,164
"9765","2100-2159",2018-08-16,70,4,98,168
"9766","2100-2159",2018-08-17,69,5,96,165
"9767","2100-2159",2018-08-18,47,6,85,132
"9768","2100-2159",2018-08-19,70,7,91,161
"9769","2100-2159",2018-08-20,67,1,94,161
"9770","2100-2159",2018-08-21,67,2,88,155
"9771","2100-2159",2018-08-22,66,3,91,157
"9772","2100-2159",2018-08-23,69,4,95,164
"9773","2100-2159",2018-08-24,69,5,95,164
"9774","2100-2159",2018-08-25,44,6,80,124
"9775","2100-2159",2018-08-26,66,7,93,159
"9776","2100-2159",2018-08-27,65,1,92,157
"9777","2100-2159",2018-08-28,64,2,90,154
"9778","2100-2159",2018-08-29,63,3,92,155
"9779","2100-2159",2018-08-30,67,4,96,163
"9780","2100-2159",2018-08-31,67,5,94,161
"9781","2200-2259",2018-08-01,71,3,85,156
"9782","2200-2259",2018-08-02,70,4,86,156
"9783","2200-2259",2018-08-03,68,5,84,152
"9784","2200-2259",2018-08-04,37,6,81,118
"9785","2200-2259",2018-08-05,69,7,84,153
"9786","2200-2259",2018-08-06,70,1,84,154
"9787","2200-2259",2018-08-07,58,2,93,151
"9788","2200-2259",2018-08-08,57,3,93,150
"9789","2200-2259",2018-08-09,58,4,95,153
"9790","2200-2259",2018-08-10,56,5,93,149
"9791","2200-2259",2018-08-11,35,6,71,106
"9792","2200-2259",2018-08-12,60,7,84,144
"9793","2200-2259",2018-08-13,56,1,90,146
"9794","2200-2259",2018-08-14,56,2,88,144
"9795","2200-2259",2018-08-15,56,3,91,147
"9796","2200-2259",2018-08-16,56,4,90,146
"9797","2200-2259",2018-08-17,55,5,89,144
"9798","2200-2259",2018-08-18,35,6,64,99
"9799","2200-2259",2018-08-19,59,7,84,143
"9800","2200-2259",2018-08-20,56,1,87,143
"9801","2200-2259",2018-08-21,44,2,84,128
"9802","2200-2259",2018-08-22,47,3,83,130
"9803","2200-2259",2018-08-23,49,4,85,134
"9804","2200-2259",2018-08-24,51,5,85,136
"9805","2200-2259",2018-08-25,34,6,59,93
"9806","2200-2259",2018-08-26,52,7,79,131
"9807","2200-2259",2018-08-27,50,1,84,134
"9808","2200-2259",2018-08-28,44,2,84,128
"9809","2200-2259",2018-08-29,47,3,82,129
"9810","2200-2259",2018-08-30,51,4,85,136
"9811","2200-2259",2018-08-31,50,5,83,133
"9812","2300-2359",2018-08-01,27,3,81,108
"9813","2300-2359",2018-08-02,29,4,82,111
"9814","2300-2359",2018-08-03,30,5,79,109
"9815","2300-2359",2018-08-04,28,6,58,86
"9816","2300-2359",2018-08-05,30,7,84,114
"9817","2300-2359",2018-08-06,30,1,82,112
"9818","2300-2359",2018-08-07,28,2,76,104
"9819","2300-2359",2018-08-08,28,3,77,105
"9820","2300-2359",2018-08-09,30,4,79,109
"9821","2300-2359",2018-08-10,31,5,78,109
"9822","2300-2359",2018-08-11,28,6,51,79
"9823","2300-2359",2018-08-12,30,7,87,117
"9824","2300-2359",2018-08-13,29,1,80,109
"9825","2300-2359",2018-08-14,27,2,76,103
"9826","2300-2359",2018-08-15,27,3,76,103
"9827","2300-2359",2018-08-16,29,4,80,109
"9828","2300-2359",2018-08-17,30,5,80,110
"9829","2300-2359",2018-08-18,27,6,55,82
"9830","2300-2359",2018-08-19,29,7,84,113
"9831","2300-2359",2018-08-20,28,1,79,107
"9832","2300-2359",2018-08-21,24,2,71,95
"9833","2300-2359",2018-08-22,26,3,74,100
"9834","2300-2359",2018-08-23,27,4,76,103
"9835","2300-2359",2018-08-24,27,5,77,104
"9836","2300-2359",2018-08-25,21,6,46,67
"9837","2300-2359",2018-08-26,25,7,78,103
"9838","2300-2359",2018-08-27,24,1,73,97
"9839","2300-2359",2018-08-28,22,2,71,93
"9840","2300-2359",2018-08-29,24,3,75,99
"9841","2300-2359",2018-08-30,24,4,74,98
"9842","2300-2359",2018-08-31,24,5,75,99
"9843","0001-0559",2018-07-01,33,7,94,127
"9844","0001-0559",2018-07-02,37,1,93,130
"9845","0001-0559",2018-07-03,28,2,74,102
"9846","0001-0559",2018-07-04,26,3,63,89
"9847","0001-0559",2018-07-05,34,4,94,128
"9848","0001-0559",2018-07-06,35,5,92,127
"9849","0001-0559",2018-07-07,33,6,71,104
"9850","0001-0559",2018-07-08,32,7,100,132
"9851","0001-0559",2018-07-09,39,1,99,138
"9852","0001-0559",2018-07-10,39,2,101,140
"9853","0001-0559",2018-07-11,39,3,101,140
"9854","0001-0559",2018-07-12,39,4,103,142
"9855","0001-0559",2018-07-13,39,5,101,140
"9856","0001-0559",2018-07-14,37,6,65,102
"9857","0001-0559",2018-07-15,31,7,99,130
"9858","0001-0559",2018-07-16,39,1,99,138
"9859","0001-0559",2018-07-17,39,2,100,139
"9860","0001-0559",2018-07-18,39,3,100,139
"9861","0001-0559",2018-07-19,39,4,101,140
"9862","0001-0559",2018-07-20,39,5,99,138
"9863","0001-0559",2018-07-21,37,6,65,102
"9864","0001-0559",2018-07-22,32,7,100,132
"9865","0001-0559",2018-07-23,39,1,100,139
"9866","0001-0559",2018-07-24,39,2,101,140
"9867","0001-0559",2018-07-25,39,3,100,139
"9868","0001-0559",2018-07-26,39,4,101,140
"9869","0001-0559",2018-07-27,39,5,99,138
"9870","0001-0559",2018-07-28,37,6,65,102
"9871","0001-0559",2018-07-29,32,7,99,131
"9872","0001-0559",2018-07-30,39,1,99,138
"9873","0001-0559",2018-07-31,39,2,100,139
"9874","0600-0659",2018-07-01,101,7,32,133
"9875","0600-0659",2018-07-02,106,1,33,139
"9876","0600-0659",2018-07-03,101,2,27,128
"9877","0600-0659",2018-07-04,92,3,25,117
"9878","0600-0659",2018-07-05,99,4,33,132
"9879","0600-0659",2018-07-06,106,5,35,141
"9880","0600-0659",2018-07-07,97,6,29,126
"9881","0600-0659",2018-07-08,106,7,34,140
"9882","0600-0659",2018-07-09,113,1,38,151
"9883","0600-0659",2018-07-10,110,2,38,148
"9884","0600-0659",2018-07-11,112,3,38,150
"9885","0600-0659",2018-07-12,111,4,38,149
"9886","0600-0659",2018-07-13,112,5,38,150
"9887","0600-0659",2018-07-14,96,6,32,128
"9888","0600-0659",2018-07-15,106,7,34,140
"9889","0600-0659",2018-07-16,112,1,38,150
"9890","0600-0659",2018-07-17,110,2,38,148
"9891","0600-0659",2018-07-18,112,3,38,150
"9892","0600-0659",2018-07-19,111,4,38,149
"9893","0600-0659",2018-07-20,111,5,38,149
"9894","0600-0659",2018-07-21,96,6,32,128
"9895","0600-0659",2018-07-22,106,7,34,140
"9896","0600-0659",2018-07-23,113,1,38,151
"9897","0600-0659",2018-07-24,110,2,38,148
"9898","0600-0659",2018-07-25,112,3,38,150
"9899","0600-0659",2018-07-26,111,4,38,149
"9900","0600-0659",2018-07-27,112,5,38,150
"9901","0600-0659",2018-07-28,96,6,32,128
"9902","0600-0659",2018-07-29,106,7,34,140
"9903","0600-0659",2018-07-30,112,1,38,150
"9904","0600-0659",2018-07-31,110,2,38,148
"9905","0700-0759",2018-07-01,96,7,64,160
"9906","0700-0759",2018-07-02,99,1,70,169
"9907","0700-0759",2018-07-03,96,2,61,157
"9908","0700-0759",2018-07-04,91,3,58,149
"9909","0700-0759",2018-07-05,98,4,67,165
"9910","0700-0759",2018-07-06,101,5,70,171
"9911","0700-0759",2018-07-07,98,6,62,160
"9912","0700-0759",2018-07-08,104,7,67,171
"9913","0700-0759",2018-07-09,110,1,74,184
"9914","0700-0759",2018-07-10,110,2,72,182
"9915","0700-0759",2018-07-11,110,3,73,183
"9916","0700-0759",2018-07-12,111,4,73,184
"9917","0700-0759",2018-07-13,111,5,74,185
"9918","0700-0759",2018-07-14,104,6,63,167
"9919","0700-0759",2018-07-15,104,7,67,171
"9920","0700-0759",2018-07-16,110,1,74,184
"9921","0700-0759",2018-07-17,110,2,72,182
"9922","0700-0759",2018-07-18,110,3,73,183
"9923","0700-0759",2018-07-19,112,4,73,185
"9924","0700-0759",2018-07-20,111,5,74,185
"9925","0700-0759",2018-07-21,104,6,63,167
"9926","0700-0759",2018-07-22,104,7,67,171
"9927","0700-0759",2018-07-23,110,1,74,184
"9928","0700-0759",2018-07-24,110,2,72,182
"9929","0700-0759",2018-07-25,110,3,73,183
"9930","0700-0759",2018-07-26,111,4,73,184
"9931","0700-0759",2018-07-27,111,5,74,185
"9932","0700-0759",2018-07-28,104,6,63,167
"9933","0700-0759",2018-07-29,104,7,67,171
"9934","0700-0759",2018-07-30,110,1,74,184
"9935","0700-0759",2018-07-31,110,2,72,182
"9936","0800-0859",2018-07-01,106,7,70,176
"9937","0800-0859",2018-07-02,107,1,70,177
"9938","0800-0859",2018-07-03,105,2,71,176
"9939","0800-0859",2018-07-04,98,3,67,165
"9940","0800-0859",2018-07-05,105,4,68,173
"9941","0800-0859",2018-07-06,106,5,70,176
"9942","0800-0859",2018-07-07,90,6,70,160
"9943","0800-0859",2018-07-08,108,7,79,187
"9944","0800-0859",2018-07-09,107,1,80,187
"9945","0800-0859",2018-07-10,107,2,80,187
"9946","0800-0859",2018-07-11,106,3,80,186
"9947","0800-0859",2018-07-12,106,4,80,186
"9948","0800-0859",2018-07-13,106,5,80,186
"9949","0800-0859",2018-07-14,93,6,76,169
"9950","0800-0859",2018-07-15,108,7,79,187
"9951","0800-0859",2018-07-16,106,1,79,185
"9952","0800-0859",2018-07-17,106,2,80,186
"9953","0800-0859",2018-07-18,105,3,80,185
"9954","0800-0859",2018-07-19,105,4,80,185
"9955","0800-0859",2018-07-20,105,5,79,184
"9956","0800-0859",2018-07-21,92,6,76,168
"9957","0800-0859",2018-07-22,107,7,79,186
"9958","0800-0859",2018-07-23,106,1,80,186
"9959","0800-0859",2018-07-24,106,2,80,186
"9960","0800-0859",2018-07-25,105,3,80,185
"9961","0800-0859",2018-07-26,105,4,80,185
"9962","0800-0859",2018-07-27,105,5,79,184
"9963","0800-0859",2018-07-28,92,6,76,168
"9964","0800-0859",2018-07-29,106,7,79,185
"9965","0800-0859",2018-07-30,106,1,79,185
"9966","0800-0859",2018-07-31,106,2,80,186
"9967","0900-0959",2018-07-01,90,7,59,149
"9968","0900-0959",2018-07-02,87,1,61,148
"9969","0900-0959",2018-07-03,84,2,59,143
"9970","0900-0959",2018-07-04,81,3,50,131
"9971","0900-0959",2018-07-05,91,4,59,150
"9972","0900-0959",2018-07-06,90,5,62,152
"9973","0900-0959",2018-07-07,89,6,49,138
"9974","0900-0959",2018-07-08,90,7,59,149
"9975","0900-0959",2018-07-09,91,1,64,155
"9976","0900-0959",2018-07-10,91,2,64,155
"9977","0900-0959",2018-07-11,89,3,62,151
"9978","0900-0959",2018-07-12,92,4,64,156
"9979","0900-0959",2018-07-13,92,5,65,157
"9980","0900-0959",2018-07-14,86,6,51,137
"9981","0900-0959",2018-07-15,89,7,59,148
"9982","0900-0959",2018-07-16,91,1,64,155
"9983","0900-0959",2018-07-17,92,2,64,156
"9984","0900-0959",2018-07-18,90,3,62,152
"9985","0900-0959",2018-07-19,93,4,65,158
"9986","0900-0959",2018-07-20,92,5,65,157
"9987","0900-0959",2018-07-21,87,6,51,138
"9988","0900-0959",2018-07-22,91,7,59,150
"9989","0900-0959",2018-07-23,92,1,64,156
"9990","0900-0959",2018-07-24,92,2,64,156
"9991","0900-0959",2018-07-25,90,3,62,152
"9992","0900-0959",2018-07-26,93,4,64,157
"9993","0900-0959",2018-07-27,92,5,65,157
"9994","0900-0959",2018-07-28,87,6,51,138
"9995","0900-0959",2018-07-29,91,7,59,150
"9996","0900-0959",2018-07-30,91,1,64,155
"9997","0900-0959",2018-07-31,92,2,64,156
"9998","1000-1059",2018-07-01,75,7,70,145
"9999","1000-1059",2018-07-02,76,1,69,145
"10000","1000-1059",2018-07-03,78,2,62,140
"10001","1000-1059",2018-07-04,74,3,61,135
"10002","1000-1059",2018-07-05,72,4,67,139
"10003","1000-1059",2018-07-06,74,5,67,141
"10004","1000-1059",2018-07-07,69,6,65,134
"10005","1000-1059",2018-07-08,79,7,69,148
"10006","1000-1059",2018-07-09,79,1,69,148
"10007","1000-1059",2018-07-10,77,2,69,146
"10008","1000-1059",2018-07-11,78,3,69,147
"10009","1000-1059",2018-07-12,77,4,70,147
"10010","1000-1059",2018-07-13,79,5,69,148
"10011","1000-1059",2018-07-14,69,6,66,135
"10012","1000-1059",2018-07-15,79,7,69,148
"10013","1000-1059",2018-07-16,79,1,69,148
"10014","1000-1059",2018-07-17,77,2,69,146
"10015","1000-1059",2018-07-18,78,3,69,147
"10016","1000-1059",2018-07-19,77,4,70,147
"10017","1000-1059",2018-07-20,79,5,69,148
"10018","1000-1059",2018-07-21,69,6,66,135
"10019","1000-1059",2018-07-22,79,7,69,148
"10020","1000-1059",2018-07-23,79,1,69,148
"10021","1000-1059",2018-07-24,77,2,69,146
"10022","1000-1059",2018-07-25,78,3,69,147
"10023","1000-1059",2018-07-26,76,4,70,146
"10024","1000-1059",2018-07-27,80,5,70,150
"10025","1000-1059",2018-07-28,69,6,66,135
"10026","1000-1059",2018-07-29,79,7,68,147
"10027","1000-1059",2018-07-30,78,1,69,147
"10028","1000-1059",2018-07-31,77,2,69,146
"10029","1100-1159",2018-07-01,80,7,77,157
"10030","1100-1159",2018-07-02,84,1,82,166
"10031","1100-1159",2018-07-03,74,2,77,151
"10032","1100-1159",2018-07-04,73,3,78,151
"10033","1100-1159",2018-07-05,87,4,78,165
"10034","1100-1159",2018-07-06,85,5,82,167
"10035","1100-1159",2018-07-07,72,6,77,149
"10036","1100-1159",2018-07-08,77,7,81,158
"10037","1100-1159",2018-07-09,83,1,86,169
"10038","1100-1159",2018-07-10,82,2,84,166
"10039","1100-1159",2018-07-11,83,3,85,168
"10040","1100-1159",2018-07-12,85,4,85,170
"10041","1100-1159",2018-07-13,84,5,86,170
"10042","1100-1159",2018-07-14,73,6,76,149
"10043","1100-1159",2018-07-15,77,7,80,157
"10044","1100-1159",2018-07-16,83,1,85,168
"10045","1100-1159",2018-07-17,82,2,84,166
"10046","1100-1159",2018-07-18,82,3,85,167
"10047","1100-1159",2018-07-19,85,4,85,170
"10048","1100-1159",2018-07-20,84,5,85,169
"10049","1100-1159",2018-07-21,73,6,76,149
"10050","1100-1159",2018-07-22,77,7,81,158
"10051","1100-1159",2018-07-23,83,1,86,169
"10052","1100-1159",2018-07-24,82,2,84,166
"10053","1100-1159",2018-07-25,83,3,85,168
"10054","1100-1159",2018-07-26,84,4,85,169
"10055","1100-1159",2018-07-27,84,5,85,169
"10056","1100-1159",2018-07-28,73,6,76,149
"10057","1100-1159",2018-07-29,76,7,81,157
"10058","1100-1159",2018-07-30,83,1,85,168
"10059","1100-1159",2018-07-31,82,2,84,166
"10060","1200-1259",2018-07-01,73,7,72,145
"10061","1200-1259",2018-07-02,72,1,74,146
"10062","1200-1259",2018-07-03,74,2,74,148
"10063","1200-1259",2018-07-04,73,3,72,145
"10064","1200-1259",2018-07-05,73,4,78,151
"10065","1200-1259",2018-07-06,74,5,76,150
"10066","1200-1259",2018-07-07,72,6,73,145
"10067","1200-1259",2018-07-08,71,7,74,145
"10068","1200-1259",2018-07-09,79,1,78,157
"10069","1200-1259",2018-07-10,76,2,76,152
"10070","1200-1259",2018-07-11,79,3,77,156
"10071","1200-1259",2018-07-12,78,4,77,155
"10072","1200-1259",2018-07-13,78,5,78,156
"10073","1200-1259",2018-07-14,67,6,74,141
"10074","1200-1259",2018-07-15,71,7,74,145
"10075","1200-1259",2018-07-16,79,1,77,156
"10076","1200-1259",2018-07-17,76,2,75,151
"10077","1200-1259",2018-07-18,79,3,76,155
"10078","1200-1259",2018-07-19,78,4,76,154
"10079","1200-1259",2018-07-20,78,5,77,155
"10080","1200-1259",2018-07-21,67,6,73,140
"10081","1200-1259",2018-07-22,71,7,73,144
"10082","1200-1259",2018-07-23,79,1,77,156
"10083","1200-1259",2018-07-24,76,2,75,151
"10084","1200-1259",2018-07-25,79,3,76,155
"10085","1200-1259",2018-07-26,77,4,75,152
"10086","1200-1259",2018-07-27,78,5,77,155
"10087","1200-1259",2018-07-28,67,6,73,140
"10088","1200-1259",2018-07-29,71,7,72,143
"10089","1200-1259",2018-07-30,79,1,76,155
"10090","1200-1259",2018-07-31,75,2,75,150
"10091","1300-1359",2018-07-01,68,7,62,130
"10092","1300-1359",2018-07-02,75,1,60,135
"10093","1300-1359",2018-07-03,70,2,59,129
"10094","1300-1359",2018-07-04,68,3,55,123
"10095","1300-1359",2018-07-05,76,4,58,134
"10096","1300-1359",2018-07-06,79,5,61,140
"10097","1300-1359",2018-07-07,68,6,58,126
"10098","1300-1359",2018-07-08,75,7,61,136
"10099","1300-1359",2018-07-09,83,1,64,147
"10100","1300-1359",2018-07-10,83,2,62,145
"10101","1300-1359",2018-07-11,83,3,63,146
"10102","1300-1359",2018-07-12,82,4,63,145
"10103","1300-1359",2018-07-13,84,5,64,148
"10104","1300-1359",2018-07-14,68,6,59,127
"10105","1300-1359",2018-07-15,74,7,61,135
"10106","1300-1359",2018-07-16,83,1,65,148
"10107","1300-1359",2018-07-17,83,2,63,146
"10108","1300-1359",2018-07-18,83,3,63,146
"10109","1300-1359",2018-07-19,82,4,64,146
"10110","1300-1359",2018-07-20,84,5,65,149
"10111","1300-1359",2018-07-21,67,6,60,127
"10112","1300-1359",2018-07-22,75,7,62,137
"10113","1300-1359",2018-07-23,83,1,65,148
"10114","1300-1359",2018-07-24,83,2,63,146
"10115","1300-1359",2018-07-25,83,3,64,147
"10116","1300-1359",2018-07-26,82,4,63,145
"10117","1300-1359",2018-07-27,84,5,65,149
"10118","1300-1359",2018-07-28,69,6,60,129
"10119","1300-1359",2018-07-29,75,7,62,137
"10120","1300-1359",2018-07-30,83,1,65,148
"10121","1300-1359",2018-07-31,83,2,63,146
"10122","1400-1459",2018-07-01,73,7,81,154
"10123","1400-1459",2018-07-02,70,1,91,161
"10124","1400-1459",2018-07-03,68,2,85,153
"10125","1400-1459",2018-07-04,65,3,80,145
"10126","1400-1459",2018-07-05,70,4,93,163
"10127","1400-1459",2018-07-06,71,5,94,165
"10128","1400-1459",2018-07-07,69,6,82,151
"10129","1400-1459",2018-07-08,73,7,84,157
"10130","1400-1459",2018-07-09,72,1,95,167
"10131","1400-1459",2018-07-10,70,2,93,163
"10132","1400-1459",2018-07-11,72,3,97,169
"10133","1400-1459",2018-07-12,70,4,94,164
"10134","1400-1459",2018-07-13,71,5,95,166
"10135","1400-1459",2018-07-14,67,6,79,146
"10136","1400-1459",2018-07-15,73,7,83,156
"10137","1400-1459",2018-07-16,72,1,94,166
"10138","1400-1459",2018-07-17,70,2,92,162
"10139","1400-1459",2018-07-18,71,3,96,167
"10140","1400-1459",2018-07-19,70,4,93,163
"10141","1400-1459",2018-07-20,71,5,94,165
"10142","1400-1459",2018-07-21,66,6,78,144
"10143","1400-1459",2018-07-22,72,7,83,155
"10144","1400-1459",2018-07-23,72,1,94,166
"10145","1400-1459",2018-07-24,70,2,92,162
"10146","1400-1459",2018-07-25,72,3,96,168
"10147","1400-1459",2018-07-26,70,4,93,163
"10148","1400-1459",2018-07-27,71,5,94,165
"10149","1400-1459",2018-07-28,66,6,79,145
"10150","1400-1459",2018-07-29,71,7,83,154
"10151","1400-1459",2018-07-30,71,1,94,165
"10152","1400-1459",2018-07-31,69,2,92,161
"10153","1500-1559",2018-07-01,87,7,71,158
"10154","1500-1559",2018-07-02,87,1,61,148
"10155","1500-1559",2018-07-03,86,2,64,150
"10156","1500-1559",2018-07-04,87,3,57,144
"10157","1500-1559",2018-07-05,86,4,63,149
"10158","1500-1559",2018-07-06,86,5,62,148
"10159","1500-1559",2018-07-07,82,6,59,141
"10160","1500-1559",2018-07-08,92,7,71,163
"10161","1500-1559",2018-07-09,91,1,65,156
"10162","1500-1559",2018-07-10,89,2,66,155
"10163","1500-1559",2018-07-11,90,3,65,155
"10164","1500-1559",2018-07-12,91,4,66,157
"10165","1500-1559",2018-07-13,91,5,65,156
"10166","1500-1559",2018-07-14,84,6,60,144
"10167","1500-1559",2018-07-15,92,7,70,162
"10168","1500-1559",2018-07-16,90,1,66,156
"10169","1500-1559",2018-07-17,88,2,67,155
"10170","1500-1559",2018-07-18,90,3,66,156
"10171","1500-1559",2018-07-19,90,4,67,157
"10172","1500-1559",2018-07-20,90,5,66,156
"10173","1500-1559",2018-07-21,84,6,60,144
"10174","1500-1559",2018-07-22,91,7,72,163
"10175","1500-1559",2018-07-23,90,1,66,156
"10176","1500-1559",2018-07-24,88,2,67,155
"10177","1500-1559",2018-07-25,90,3,66,156
"10178","1500-1559",2018-07-26,89,4,67,156
"10179","1500-1559",2018-07-27,90,5,66,156
"10180","1500-1559",2018-07-28,84,6,61,145
"10181","1500-1559",2018-07-29,91,7,71,162
"10182","1500-1559",2018-07-30,90,1,66,156
"10183","1500-1559",2018-07-31,87,2,66,153
"10184","1600-1659",2018-07-01,72,7,86,158
"10185","1600-1659",2018-07-02,73,1,87,160
"10186","1600-1659",2018-07-03,67,2,83,150
"10187","1600-1659",2018-07-04,63,3,81,144
"10188","1600-1659",2018-07-05,74,4,85,159
"10189","1600-1659",2018-07-06,74,5,87,161
"10190","1600-1659",2018-07-07,62,6,74,136
"10191","1600-1659",2018-07-08,76,7,88,164
"10192","1600-1659",2018-07-09,80,1,91,171
"10193","1600-1659",2018-07-10,78,2,89,167
"10194","1600-1659",2018-07-11,78,3,88,166
"10195","1600-1659",2018-07-12,78,4,90,168
"10196","1600-1659",2018-07-13,79,5,91,170
"10197","1600-1659",2018-07-14,63,6,74,137
"10198","1600-1659",2018-07-15,76,7,88,164
"10199","1600-1659",2018-07-16,79,1,90,169
"10200","1600-1659",2018-07-17,78,2,88,166
"10201","1600-1659",2018-07-18,78,3,87,165
"10202","1600-1659",2018-07-19,77,4,89,166
"10203","1600-1659",2018-07-20,78,5,90,168
"10204","1600-1659",2018-07-21,63,6,72,135
"10205","1600-1659",2018-07-22,75,7,86,161
"10206","1600-1659",2018-07-23,79,1,90,169
"10207","1600-1659",2018-07-24,78,2,88,166
"10208","1600-1659",2018-07-25,78,3,88,166
"10209","1600-1659",2018-07-26,78,4,87,165
"10210","1600-1659",2018-07-27,79,5,90,169
"10211","1600-1659",2018-07-28,63,6,72,135
"10212","1600-1659",2018-07-29,77,7,86,163
"10213","1600-1659",2018-07-30,80,1,89,169
"10214","1600-1659",2018-07-31,78,2,87,165
"10215","1700-1759",2018-07-01,87,7,73,160
"10216","1700-1759",2018-07-02,91,1,78,169
"10217","1700-1759",2018-07-03,91,2,75,166
"10218","1700-1759",2018-07-04,91,3,72,163
"10219","1700-1759",2018-07-05,88,4,79,167
"10220","1700-1759",2018-07-06,90,5,80,170
"10221","1700-1759",2018-07-07,79,6,71,150
"10222","1700-1759",2018-07-08,86,7,81,167
"10223","1700-1759",2018-07-09,90,1,85,175
"10224","1700-1759",2018-07-10,90,2,83,173
"10225","1700-1759",2018-07-11,88,3,82,170
"10226","1700-1759",2018-07-12,89,4,83,172
"10227","1700-1759",2018-07-13,91,5,85,176
"10228","1700-1759",2018-07-14,78,6,69,147
"10229","1700-1759",2018-07-15,85,7,80,165
"10230","1700-1759",2018-07-16,90,1,83,173
"10231","1700-1759",2018-07-17,89,2,82,171
"10232","1700-1759",2018-07-18,88,3,81,169
"10233","1700-1759",2018-07-19,88,4,82,170
"10234","1700-1759",2018-07-20,91,5,83,174
"10235","1700-1759",2018-07-21,77,6,68,145
"10236","1700-1759",2018-07-22,86,7,78,164
"10237","1700-1759",2018-07-23,90,1,83,173
"10238","1700-1759",2018-07-24,90,2,82,172
"10239","1700-1759",2018-07-25,88,3,81,169
"10240","1700-1759",2018-07-26,88,4,82,170
"10241","1700-1759",2018-07-27,91,5,85,176
"10242","1700-1759",2018-07-28,76,6,68,144
"10243","1700-1759",2018-07-29,85,7,79,164
"10244","1700-1759",2018-07-30,90,1,84,174
"10245","1700-1759",2018-07-31,88,2,81,169
"10246","1800-1859",2018-07-01,77,7,82,159
"10247","1800-1859",2018-07-02,77,1,84,161
"10248","1800-1859",2018-07-03,69,2,83,152
"10249","1800-1859",2018-07-04,63,3,81,144
"10250","1800-1859",2018-07-05,76,4,87,163
"10251","1800-1859",2018-07-06,78,5,87,165
"10252","1800-1859",2018-07-07,76,6,79,155
"10253","1800-1859",2018-07-08,87,7,82,169
"10254","1800-1859",2018-07-09,88,1,91,179
"10255","1800-1859",2018-07-10,85,2,90,175
"10256","1800-1859",2018-07-11,84,3,88,172
"10257","1800-1859",2018-07-12,86,4,91,177
"10258","1800-1859",2018-07-13,87,5,91,178
"10259","1800-1859",2018-07-14,73,6,78,151
"10260","1800-1859",2018-07-15,87,7,82,169
"10261","1800-1859",2018-07-16,86,1,92,178
"10262","1800-1859",2018-07-17,84,2,91,175
"10263","1800-1859",2018-07-18,84,3,89,173
"10264","1800-1859",2018-07-19,85,4,91,176
"10265","1800-1859",2018-07-20,85,5,92,177
"10266","1800-1859",2018-07-21,72,6,79,151
"10267","1800-1859",2018-07-22,85,7,84,169
"10268","1800-1859",2018-07-23,86,1,92,178
"10269","1800-1859",2018-07-24,84,2,91,175
"10270","1800-1859",2018-07-25,84,3,89,173
"10271","1800-1859",2018-07-26,85,4,92,177
"10272","1800-1859",2018-07-27,86,5,92,178
"10273","1800-1859",2018-07-28,72,6,80,152
"10274","1800-1859",2018-07-29,86,7,84,170
"10275","1800-1859",2018-07-30,87,1,92,179
"10276","1800-1859",2018-07-31,84,2,90,174
"10277","1900-1959",2018-07-01,81,7,92,173
"10278","1900-1959",2018-07-02,79,1,87,166
"10279","1900-1959",2018-07-03,75,2,88,163
"10280","1900-1959",2018-07-04,75,3,88,163
"10281","1900-1959",2018-07-05,83,4,83,166
"10282","1900-1959",2018-07-06,80,5,84,164
"10283","1900-1959",2018-07-07,73,6,82,155
"10284","1900-1959",2018-07-08,80,7,91,171
"10285","1900-1959",2018-07-09,82,1,86,168
"10286","1900-1959",2018-07-10,80,2,85,165
"10287","1900-1959",2018-07-11,79,3,84,163
"10288","1900-1959",2018-07-12,83,4,86,169
"10289","1900-1959",2018-07-13,82,5,86,168
"10290","1900-1959",2018-07-14,72,6,80,152
"10291","1900-1959",2018-07-15,80,7,91,171
"10292","1900-1959",2018-07-16,83,1,86,169
"10293","1900-1959",2018-07-17,81,2,85,166
"10294","1900-1959",2018-07-18,80,3,85,165
"10295","1900-1959",2018-07-19,83,4,85,168
"10296","1900-1959",2018-07-20,83,5,86,169
"10297","1900-1959",2018-07-21,73,6,81,154
"10298","1900-1959",2018-07-22,81,7,91,172
"10299","1900-1959",2018-07-23,83,1,86,169
"10300","1900-1959",2018-07-24,81,2,85,166
"10301","1900-1959",2018-07-25,80,3,85,165
"10302","1900-1959",2018-07-26,84,4,86,170
"10303","1900-1959",2018-07-27,83,5,86,169
"10304","1900-1959",2018-07-28,72,6,79,151
"10305","1900-1959",2018-07-29,81,7,91,172
"10306","1900-1959",2018-07-30,83,1,86,169
"10307","1900-1959",2018-07-31,80,2,84,164
"10308","2000-2059",2018-07-01,64,7,89,153
"10309","2000-2059",2018-07-02,63,1,93,156
"10310","2000-2059",2018-07-03,58,2,82,140
"10311","2000-2059",2018-07-04,56,3,83,139
"10312","2000-2059",2018-07-05,67,4,88,155
"10313","2000-2059",2018-07-06,67,5,90,157
"10314","2000-2059",2018-07-07,56,6,76,132
"10315","2000-2059",2018-07-08,70,7,88,158
"10316","2000-2059",2018-07-09,70,1,94,164
"10317","2000-2059",2018-07-10,70,2,90,160
"10318","2000-2059",2018-07-11,71,3,91,162
"10319","2000-2059",2018-07-12,71,4,91,162
"10320","2000-2059",2018-07-13,70,5,94,164
"10321","2000-2059",2018-07-14,55,6,77,132
"10322","2000-2059",2018-07-15,69,7,88,157
"10323","2000-2059",2018-07-16,69,1,93,162
"10324","2000-2059",2018-07-17,68,2,89,157
"10325","2000-2059",2018-07-18,70,3,91,161
"10326","2000-2059",2018-07-19,70,4,91,161
"10327","2000-2059",2018-07-20,69,5,93,162
"10328","2000-2059",2018-07-21,54,6,76,130
"10329","2000-2059",2018-07-22,69,7,87,156
"10330","2000-2059",2018-07-23,69,1,93,162
"10331","2000-2059",2018-07-24,69,2,90,159
"10332","2000-2059",2018-07-25,70,3,91,161
"10333","2000-2059",2018-07-26,69,4,90,159
"10334","2000-2059",2018-07-27,69,5,94,163
"10335","2000-2059",2018-07-28,53,6,76,129
"10336","2000-2059",2018-07-29,69,7,88,157
"10337","2000-2059",2018-07-30,69,1,94,163
"10338","2000-2059",2018-07-31,69,2,90,159
"10339","2100-2159",2018-07-01,70,7,90,160
"10340","2100-2159",2018-07-02,65,1,87,152
"10341","2100-2159",2018-07-03,56,2,89,145
"10342","2100-2159",2018-07-04,54,3,85,139
"10343","2100-2159",2018-07-05,65,4,93,158
"10344","2100-2159",2018-07-06,65,5,93,158
"10345","2100-2159",2018-07-07,57,6,89,146
"10346","2100-2159",2018-07-08,73,7,97,170
"10347","2100-2159",2018-07-09,70,1,96,166
"10348","2100-2159",2018-07-10,69,2,95,164
"10349","2100-2159",2018-07-11,71,3,98,169
"10350","2100-2159",2018-07-12,70,4,95,165
"10351","2100-2159",2018-07-13,70,5,96,166
"10352","2100-2159",2018-07-14,55,6,84,139
"10353","2100-2159",2018-07-15,73,7,97,170
"10354","2100-2159",2018-07-16,70,1,96,166
"10355","2100-2159",2018-07-17,69,2,95,164
"10356","2100-2159",2018-07-18,71,3,98,169
"10357","2100-2159",2018-07-19,70,4,94,164
"10358","2100-2159",2018-07-20,70,5,96,166
"10359","2100-2159",2018-07-21,56,6,84,140
"10360","2100-2159",2018-07-22,73,7,97,170
"10361","2100-2159",2018-07-23,69,1,96,165
"10362","2100-2159",2018-07-24,69,2,95,164
"10363","2100-2159",2018-07-25,71,3,98,169
"10364","2100-2159",2018-07-26,70,4,95,165
"10365","2100-2159",2018-07-27,70,5,96,166
"10366","2100-2159",2018-07-28,56,6,83,139
"10367","2100-2159",2018-07-29,74,7,97,171
"10368","2100-2159",2018-07-30,70,1,96,166
"10369","2100-2159",2018-07-31,69,2,94,163
"10370","2200-2259",2018-07-01,60,7,77,137
"10371","2200-2259",2018-07-02,61,1,76,137
"10372","2200-2259",2018-07-03,42,2,66,108
"10373","2200-2259",2018-07-04,39,3,68,107
"10374","2200-2259",2018-07-05,63,4,81,144
"10375","2200-2259",2018-07-06,62,5,79,141
"10376","2200-2259",2018-07-07,42,6,79,121
"10377","2200-2259",2018-07-08,69,7,81,150
"10378","2200-2259",2018-07-09,70,1,83,153
"10379","2200-2259",2018-07-10,72,2,83,155
"10380","2200-2259",2018-07-11,72,3,85,157
"10381","2200-2259",2018-07-12,72,4,85,157
"10382","2200-2259",2018-07-13,69,5,84,153
"10383","2200-2259",2018-07-14,38,6,81,119
"10384","2200-2259",2018-07-15,69,7,81,150
"10385","2200-2259",2018-07-16,70,1,85,155
"10386","2200-2259",2018-07-17,72,2,84,156
"10387","2200-2259",2018-07-18,72,3,87,159
"10388","2200-2259",2018-07-19,72,4,87,159
"10389","2200-2259",2018-07-20,69,5,86,155
"10390","2200-2259",2018-07-21,38,6,83,121
"10391","2200-2259",2018-07-22,69,7,83,152
"10392","2200-2259",2018-07-23,71,1,84,155
"10393","2200-2259",2018-07-24,73,2,85,158
"10394","2200-2259",2018-07-25,72,3,87,159
"10395","2200-2259",2018-07-26,72,4,86,158
"10396","2200-2259",2018-07-27,69,5,86,155
"10397","2200-2259",2018-07-28,38,6,82,120
"10398","2200-2259",2018-07-29,69,7,84,153
"10399","2200-2259",2018-07-30,70,1,85,155
"10400","2200-2259",2018-07-31,72,2,85,157
"10401","2300-2359",2018-07-01,27,7,79,106
"10402","2300-2359",2018-07-02,25,1,78,103
"10403","2300-2359",2018-07-03,22,2,65,87
"10404","2300-2359",2018-07-04,21,3,66,87
"10405","2300-2359",2018-07-05,25,4,78,103
"10406","2300-2359",2018-07-06,26,5,78,104
"10407","2300-2359",2018-07-07,27,6,66,93
"10408","2300-2359",2018-07-08,29,7,90,119
"10409","2300-2359",2018-07-09,29,1,88,117
"10410","2300-2359",2018-07-10,27,2,85,112
"10411","2300-2359",2018-07-11,27,3,85,112
"10412","2300-2359",2018-07-12,29,4,86,115
"10413","2300-2359",2018-07-13,30,5,83,113
"10414","2300-2359",2018-07-14,28,6,62,90
"10415","2300-2359",2018-07-15,29,7,90,119
"10416","2300-2359",2018-07-16,29,1,85,114
"10417","2300-2359",2018-07-17,27,2,83,110
"10418","2300-2359",2018-07-18,27,3,83,110
"10419","2300-2359",2018-07-19,29,4,85,114
"10420","2300-2359",2018-07-20,30,5,82,112
"10421","2300-2359",2018-07-21,28,6,60,88
"10422","2300-2359",2018-07-22,29,7,87,116
"10423","2300-2359",2018-07-23,29,1,85,114
"10424","2300-2359",2018-07-24,27,2,83,110
"10425","2300-2359",2018-07-25,27,3,83,110
"10426","2300-2359",2018-07-26,29,4,85,114
"10427","2300-2359",2018-07-27,30,5,82,112
"10428","2300-2359",2018-07-28,28,6,60,88
"10429","2300-2359",2018-07-29,29,7,88,117
"10430","2300-2359",2018-07-30,29,1,85,114
"10431","2300-2359",2018-07-31,27,2,83,110
"10432","0001-0559",2018-06-01,36,5,90,126
"10433","0001-0559",2018-06-02,22,6,60,82
"10434","0001-0559",2018-06-03,28,7,88,116
"10435","0001-0559",2018-06-04,37,1,94,131
"10436","0001-0559",2018-06-05,38,2,90,128
"10437","0001-0559",2018-06-06,38,3,92,130
"10438","0001-0559",2018-06-07,42,4,105,147
"10439","0001-0559",2018-06-08,43,5,104,147
"10440","0001-0559",2018-06-09,40,6,66,106
"10441","0001-0559",2018-06-10,36,7,107,143
"10442","0001-0559",2018-06-11,44,1,105,149
"10443","0001-0559",2018-06-12,44,2,104,148
"10444","0001-0559",2018-06-13,44,3,103,147
"10445","0001-0559",2018-06-14,44,4,103,147
"10446","0001-0559",2018-06-15,43,5,100,143
"10447","0001-0559",2018-06-16,41,6,65,106
"10448","0001-0559",2018-06-17,37,7,102,139
"10449","0001-0559",2018-06-18,44,1,103,147
"10450","0001-0559",2018-06-19,43,2,102,145
"10451","0001-0559",2018-06-20,43,3,101,144
"10452","0001-0559",2018-06-21,43,4,103,146
"10453","0001-0559",2018-06-22,43,5,101,144
"10454","0001-0559",2018-06-23,41,6,66,107
"10455","0001-0559",2018-06-24,37,7,103,140
"10456","0001-0559",2018-06-25,44,1,103,147
"10457","0001-0559",2018-06-26,43,2,102,145
"10458","0001-0559",2018-06-27,43,3,102,145
"10459","0001-0559",2018-06-28,43,4,102,145
"10460","0001-0559",2018-06-29,40,5,100,140
"10461","0001-0559",2018-06-30,37,6,74,111
"10462","0600-0659",2018-06-01,113,5,32,145
"10463","0600-0659",2018-06-02,100,6,22,122
"10464","0600-0659",2018-06-03,105,7,29,134
"10465","0600-0659",2018-06-04,112,1,32,144
"10466","0600-0659",2018-06-05,108,2,30,138
"10467","0600-0659",2018-06-06,111,3,32,143
"10468","0600-0659",2018-06-07,109,4,35,144
"10469","0600-0659",2018-06-08,107,5,34,141
"10470","0600-0659",2018-06-09,96,6,30,126
"10471","0600-0659",2018-06-10,102,7,30,132
"10472","0600-0659",2018-06-11,108,1,33,141
"10473","0600-0659",2018-06-12,106,2,32,138
"10474","0600-0659",2018-06-13,108,3,33,141
"10475","0600-0659",2018-06-14,106,4,35,141
"10476","0600-0659",2018-06-15,107,5,36,143
"10477","0600-0659",2018-06-16,95,6,32,127
"10478","0600-0659",2018-06-17,102,7,32,134
"10479","0600-0659",2018-06-18,107,1,36,143
"10480","0600-0659",2018-06-19,105,2,34,139
"10481","0600-0659",2018-06-20,107,3,35,142
"10482","0600-0659",2018-06-21,106,4,35,141
"10483","0600-0659",2018-06-22,107,5,35,142
"10484","0600-0659",2018-06-23,95,6,32,127
"10485","0600-0659",2018-06-24,102,7,32,134
"10486","0600-0659",2018-06-25,107,1,35,142
"10487","0600-0659",2018-06-26,105,2,34,139
"10488","0600-0659",2018-06-27,107,3,35,142
"10489","0600-0659",2018-06-28,106,4,36,142
"10490","0600-0659",2018-06-29,112,5,38,150
"10491","0600-0659",2018-06-30,97,6,31,128
"10492","0700-0759",2018-06-01,102,5,71,173
"10493","0700-0759",2018-06-02,90,6,60,150
"10494","0700-0759",2018-06-03,99,7,65,164
"10495","0700-0759",2018-06-04,103,1,70,173
"10496","0700-0759",2018-06-05,100,2,68,168
"10497","0700-0759",2018-06-06,100,3,70,170
"10498","0700-0759",2018-06-07,113,4,76,189
"10499","0700-0759",2018-06-08,109,5,75,184
"10500","0700-0759",2018-06-09,99,6,64,163
"10501","0700-0759",2018-06-10,104,7,68,172
"10502","0700-0759",2018-06-11,109,1,74,183
"10503","0700-0759",2018-06-12,107,2,72,179
"10504","0700-0759",2018-06-13,108,3,73,181
"10505","0700-0759",2018-06-14,111,4,71,182
"10506","0700-0759",2018-06-15,110,5,72,182
"10507","0700-0759",2018-06-16,101,6,62,163
"10508","0700-0759",2018-06-17,105,7,65,170
"10509","0700-0759",2018-06-18,110,1,71,181
"10510","0700-0759",2018-06-19,108,2,69,177
"10511","0700-0759",2018-06-20,110,3,70,180
"10512","0700-0759",2018-06-21,110,4,71,181
"10513","0700-0759",2018-06-22,110,5,72,182
"10514","0700-0759",2018-06-23,101,6,62,163
"10515","0700-0759",2018-06-24,105,7,65,170
"10516","0700-0759",2018-06-25,110,1,71,181
"10517","0700-0759",2018-06-26,108,2,69,177
"10518","0700-0759",2018-06-27,110,3,70,180
"10519","0700-0759",2018-06-28,110,4,71,181
"10520","0700-0759",2018-06-29,109,5,73,182
"10521","0700-0759",2018-06-30,102,6,64,166
"10522","0800-0859",2018-06-01,102,5,74,176
"10523","0800-0859",2018-06-02,92,6,65,157
"10524","0800-0859",2018-06-03,100,7,70,170
"10525","0800-0859",2018-06-04,105,1,77,182
"10526","0800-0859",2018-06-05,104,2,74,178
"10527","0800-0859",2018-06-06,102,3,74,176
"10528","0800-0859",2018-06-07,103,4,78,181
"10529","0800-0859",2018-06-08,108,5,75,183
"10530","0800-0859",2018-06-09,93,6,70,163
"10531","0800-0859",2018-06-10,107,7,74,181
"10532","0800-0859",2018-06-11,109,1,75,184
"10533","0800-0859",2018-06-12,110,2,75,185
"10534","0800-0859",2018-06-13,107,3,75,182
"10535","0800-0859",2018-06-14,107,4,77,184
"10536","0800-0859",2018-06-15,107,5,77,184
"10537","0800-0859",2018-06-16,91,6,73,164
"10538","0800-0859",2018-06-17,106,7,77,183
"10539","0800-0859",2018-06-18,108,1,78,186
"10540","0800-0859",2018-06-19,109,2,78,187
"10541","0800-0859",2018-06-20,107,3,78,185
"10542","0800-0859",2018-06-21,107,4,78,185
"10543","0800-0859",2018-06-22,107,5,78,185
"10544","0800-0859",2018-06-23,91,6,73,164
"10545","0800-0859",2018-06-24,106,7,76,182
"10546","0800-0859",2018-06-25,108,1,78,186
"10547","0800-0859",2018-06-26,109,2,78,187
"10548","0800-0859",2018-06-27,107,3,78,185
"10549","0800-0859",2018-06-28,107,4,78,185
"10550","0800-0859",2018-06-29,106,5,77,183
"10551","0800-0859",2018-06-30,91,6,73,164
"10552","0900-0959",2018-06-01,91,5,66,157
"10553","0900-0959",2018-06-02,85,6,61,146
"10554","0900-0959",2018-06-03,86,7,59,145
"10555","0900-0959",2018-06-04,89,1,66,155
"10556","0900-0959",2018-06-05,86,2,62,148
"10557","0900-0959",2018-06-06,87,3,61,148
"10558","0900-0959",2018-06-07,91,4,64,155
"10559","0900-0959",2018-06-08,90,5,68,158
"10560","0900-0959",2018-06-09,84,6,53,137
"10561","0900-0959",2018-06-10,89,7,63,152
"10562","0900-0959",2018-06-11,89,1,70,159
"10563","0900-0959",2018-06-12,89,2,69,158
"10564","0900-0959",2018-06-13,88,3,67,155
"10565","0900-0959",2018-06-14,91,4,69,160
"10566","0900-0959",2018-06-15,91,5,69,160
"10567","0900-0959",2018-06-16,85,6,54,139
"10568","0900-0959",2018-06-17,90,7,63,153
"10569","0900-0959",2018-06-18,90,1,67,157
"10570","0900-0959",2018-06-19,90,2,68,158
"10571","0900-0959",2018-06-20,88,3,65,153
"10572","0900-0959",2018-06-21,91,4,68,159
"10573","0900-0959",2018-06-22,91,5,67,158
"10574","0900-0959",2018-06-23,85,6,54,139
"10575","0900-0959",2018-06-24,90,7,63,153
"10576","0900-0959",2018-06-25,90,1,67,157
"10577","0900-0959",2018-06-26,90,2,68,158
"10578","0900-0959",2018-06-27,88,3,65,153
"10579","0900-0959",2018-06-28,91,4,68,159
"10580","0900-0959",2018-06-29,92,5,67,159
"10581","0900-0959",2018-06-30,86,6,51,137
"10582","1000-1059",2018-06-01,83,5,66,149
"10583","1000-1059",2018-06-02,70,6,59,129
"10584","1000-1059",2018-06-03,79,7,68,147
"10585","1000-1059",2018-06-04,84,1,68,152
"10586","1000-1059",2018-06-05,82,2,69,151
"10587","1000-1059",2018-06-06,83,3,68,151
"10588","1000-1059",2018-06-07,77,4,75,152
"10589","1000-1059",2018-06-08,79,5,70,149
"10590","1000-1059",2018-06-09,69,6,67,136
"10591","1000-1059",2018-06-10,80,7,71,151
"10592","1000-1059",2018-06-11,79,1,68,147
"10593","1000-1059",2018-06-12,78,2,69,147
"10594","1000-1059",2018-06-13,79,3,69,148
"10595","1000-1059",2018-06-14,77,4,69,146
"10596","1000-1059",2018-06-15,80,5,67,147
"10597","1000-1059",2018-06-16,71,6,65,136
"10598","1000-1059",2018-06-17,80,7,69,149
"10599","1000-1059",2018-06-18,79,1,69,148
"10600","1000-1059",2018-06-19,76,2,67,143
"10601","1000-1059",2018-06-20,78,3,69,147
"10602","1000-1059",2018-06-21,76,4,68,144
"10603","1000-1059",2018-06-22,78,5,69,147
"10604","1000-1059",2018-06-23,72,6,65,137
"10605","1000-1059",2018-06-24,79,7,69,148
"10606","1000-1059",2018-06-25,79,1,69,148
"10607","1000-1059",2018-06-26,77,2,67,144
"10608","1000-1059",2018-06-27,78,3,69,147
"10609","1000-1059",2018-06-28,76,4,68,144
"10610","1000-1059",2018-06-29,79,5,69,148
"10611","1000-1059",2018-06-30,70,6,66,136
"10612","1100-1159",2018-06-01,83,5,79,162
"10613","1100-1159",2018-06-02,72,6,76,148
"10614","1100-1159",2018-06-03,84,7,75,159
"10615","1100-1159",2018-06-04,86,1,78,164
"10616","1100-1159",2018-06-05,80,2,75,155
"10617","1100-1159",2018-06-06,82,3,78,160
"10618","1100-1159",2018-06-07,92,4,79,171
"10619","1100-1159",2018-06-08,89,5,88,177
"10620","1100-1159",2018-06-09,74,6,76,150
"10621","1100-1159",2018-06-10,83,7,80,163
"10622","1100-1159",2018-06-11,89,1,89,178
"10623","1100-1159",2018-06-12,88,2,86,174
"10624","1100-1159",2018-06-13,87,3,86,173
"10625","1100-1159",2018-06-14,88,4,87,175
"10626","1100-1159",2018-06-15,87,5,89,176
"10627","1100-1159",2018-06-16,72,6,75,147
"10628","1100-1159",2018-06-17,79,7,80,159
"10629","1100-1159",2018-06-18,86,1,88,174
"10630","1100-1159",2018-06-19,85,2,85,170
"10631","1100-1159",2018-06-20,85,3,86,171
"10632","1100-1159",2018-06-21,88,4,86,174
"10633","1100-1159",2018-06-22,87,5,87,174
"10634","1100-1159",2018-06-23,72,6,75,147
"10635","1100-1159",2018-06-24,80,7,80,160
"10636","1100-1159",2018-06-25,86,1,89,175
"10637","1100-1159",2018-06-26,84,2,86,170
"10638","1100-1159",2018-06-27,85,3,86,171
"10639","1100-1159",2018-06-28,88,4,86,174
"10640","1100-1159",2018-06-29,86,5,87,173
"10641","1100-1159",2018-06-30,75,6,76,151
"10642","1200-1259",2018-06-01,79,5,75,154
"10643","1200-1259",2018-06-02,70,6,64,134
"10644","1200-1259",2018-06-03,78,7,74,152
"10645","1200-1259",2018-06-04,77,1,76,153
"10646","1200-1259",2018-06-05,76,2,74,150
"10647","1200-1259",2018-06-06,80,3,76,156
"10648","1200-1259",2018-06-07,75,4,75,150
"10649","1200-1259",2018-06-08,78,5,75,153
"10650","1200-1259",2018-06-09,72,6,70,142
"10651","1200-1259",2018-06-10,73,7,71,144
"10652","1200-1259",2018-06-11,79,1,75,154
"10653","1200-1259",2018-06-12,75,2,73,148
"10654","1200-1259",2018-06-13,80,3,73,153
"10655","1200-1259",2018-06-14,78,4,74,152
"10656","1200-1259",2018-06-15,79,5,76,155
"10657","1200-1259",2018-06-16,71,6,71,142
"10658","1200-1259",2018-06-17,74,7,71,145
"10659","1200-1259",2018-06-18,79,1,75,154
"10660","1200-1259",2018-06-19,76,2,73,149
"10661","1200-1259",2018-06-20,81,3,74,155
"10662","1200-1259",2018-06-21,78,4,75,153
"10663","1200-1259",2018-06-22,79,5,76,155
"10664","1200-1259",2018-06-23,71,6,72,143
"10665","1200-1259",2018-06-24,74,7,71,145
"10666","1200-1259",2018-06-25,79,1,75,154
"10667","1200-1259",2018-06-26,76,2,72,148
"10668","1200-1259",2018-06-27,81,3,74,155
"10669","1200-1259",2018-06-28,78,4,75,153
"10670","1200-1259",2018-06-29,78,5,76,154
"10671","1200-1259",2018-06-30,72,6,70,142
"10672","1300-1359",2018-06-01,72,5,64,136
"10673","1300-1359",2018-06-02,59,6,53,112
"10674","1300-1359",2018-06-03,69,7,69,138
"10675","1300-1359",2018-06-04,73,1,63,136
"10676","1300-1359",2018-06-05,74,2,60,134
"10677","1300-1359",2018-06-06,73,3,62,135
"10678","1300-1359",2018-06-07,78,4,62,140
"10679","1300-1359",2018-06-08,78,5,62,140
"10680","1300-1359",2018-06-09,60,6,59,119
"10681","1300-1359",2018-06-10,68,7,62,130
"10682","1300-1359",2018-06-11,78,1,64,142
"10683","1300-1359",2018-06-12,76,2,62,138
"10684","1300-1359",2018-06-13,76,3,64,140
"10685","1300-1359",2018-06-14,76,4,63,139
"10686","1300-1359",2018-06-15,78,5,64,142
"10687","1300-1359",2018-06-16,60,6,60,120
"10688","1300-1359",2018-06-17,68,7,63,131
"10689","1300-1359",2018-06-18,78,1,64,142
"10690","1300-1359",2018-06-19,76,2,62,138
"10691","1300-1359",2018-06-20,76,3,63,139
"10692","1300-1359",2018-06-21,77,4,63,140
"10693","1300-1359",2018-06-22,78,5,64,142
"10694","1300-1359",2018-06-23,61,6,61,122
"10695","1300-1359",2018-06-24,68,7,63,131
"10696","1300-1359",2018-06-25,78,1,64,142
"10697","1300-1359",2018-06-26,76,2,62,138
"10698","1300-1359",2018-06-27,76,3,63,139
"10699","1300-1359",2018-06-28,78,4,63,141
"10700","1300-1359",2018-06-29,80,5,65,145
"10701","1300-1359",2018-06-30,67,6,61,128
"10702","1400-1459",2018-06-01,76,5,92,168
"10703","1400-1459",2018-06-02,68,6,76,144
"10704","1400-1459",2018-06-03,77,7,81,158
"10705","1400-1459",2018-06-04,76,1,93,169
"10706","1400-1459",2018-06-05,70,2,89,159
"10707","1400-1459",2018-06-06,74,3,92,166
"10708","1400-1459",2018-06-07,68,4,95,163
"10709","1400-1459",2018-06-08,74,5,98,172
"10710","1400-1459",2018-06-09,71,6,78,149
"10711","1400-1459",2018-06-10,75,7,83,158
"10712","1400-1459",2018-06-11,75,1,97,172
"10713","1400-1459",2018-06-12,74,2,96,170
"10714","1400-1459",2018-06-13,75,3,97,172
"10715","1400-1459",2018-06-14,74,4,95,169
"10716","1400-1459",2018-06-15,75,5,97,172
"10717","1400-1459",2018-06-16,71,6,77,148
"10718","1400-1459",2018-06-17,75,7,82,157
"10719","1400-1459",2018-06-18,75,1,97,172
"10720","1400-1459",2018-06-19,74,2,95,169
"10721","1400-1459",2018-06-20,75,3,96,171
"10722","1400-1459",2018-06-21,74,4,95,169
"10723","1400-1459",2018-06-22,75,5,97,172
"10724","1400-1459",2018-06-23,71,6,77,148
"10725","1400-1459",2018-06-24,75,7,83,158
"10726","1400-1459",2018-06-25,75,1,97,172
"10727","1400-1459",2018-06-26,74,2,95,169
"10728","1400-1459",2018-06-27,75,3,96,171
"10729","1400-1459",2018-06-28,74,4,95,169
"10730","1400-1459",2018-06-29,74,5,96,170
"10731","1400-1459",2018-06-30,67,6,79,146
"10732","1500-1559",2018-06-01,89,5,69,158
"10733","1500-1559",2018-06-02,73,6,70,143
"10734","1500-1559",2018-06-03,89,7,69,158
"10735","1500-1559",2018-06-04,91,1,68,159
"10736","1500-1559",2018-06-05,87,2,69,156
"10737","1500-1559",2018-06-06,90,3,71,161
"10738","1500-1559",2018-06-07,95,4,66,161
"10739","1500-1559",2018-06-08,91,5,65,156
"10740","1500-1559",2018-06-09,78,6,60,138
"10741","1500-1559",2018-06-10,92,7,73,165
"10742","1500-1559",2018-06-11,93,1,66,159
"10743","1500-1559",2018-06-12,89,2,65,154
"10744","1500-1559",2018-06-13,92,3,68,160
"10745","1500-1559",2018-06-14,91,4,66,157
"10746","1500-1559",2018-06-15,91,5,65,156
"10747","1500-1559",2018-06-16,78,6,60,138
"10748","1500-1559",2018-06-17,91,7,73,164
"10749","1500-1559",2018-06-18,92,1,65,157
"10750","1500-1559",2018-06-19,89,2,65,154
"10751","1500-1559",2018-06-20,91,3,68,159
"10752","1500-1559",2018-06-21,91,4,66,157
"10753","1500-1559",2018-06-22,91,5,65,156
"10754","1500-1559",2018-06-23,78,6,61,139
"10755","1500-1559",2018-06-24,91,7,73,164
"10756","1500-1559",2018-06-25,92,1,65,157
"10757","1500-1559",2018-06-26,89,2,65,154
"10758","1500-1559",2018-06-27,91,3,68,159
"10759","1500-1559",2018-06-28,91,4,66,157
"10760","1500-1559",2018-06-29,92,5,65,157
"10761","1500-1559",2018-06-30,82,6,60,142
"10762","1600-1659",2018-06-01,77,5,88,165
"10763","1600-1659",2018-06-02,66,6,60,126
"10764","1600-1659",2018-06-03,76,7,85,161
"10765","1600-1659",2018-06-04,77,1,88,165
"10766","1600-1659",2018-06-05,75,2,86,161
"10767","1600-1659",2018-06-06,76,3,84,160
"10768","1600-1659",2018-06-07,74,4,93,167
"10769","1600-1659",2018-06-08,76,5,88,164
"10770","1600-1659",2018-06-09,60,6,73,133
"10771","1600-1659",2018-06-10,74,7,86,160
"10772","1600-1659",2018-06-11,75,1,88,163
"10773","1600-1659",2018-06-12,72,2,89,161
"10774","1600-1659",2018-06-13,72,3,86,158
"10775","1600-1659",2018-06-14,75,4,87,162
"10776","1600-1659",2018-06-15,76,5,87,163
"10777","1600-1659",2018-06-16,62,6,72,134
"10778","1600-1659",2018-06-17,73,7,86,159
"10779","1600-1659",2018-06-18,76,1,87,163
"10780","1600-1659",2018-06-19,74,2,87,161
"10781","1600-1659",2018-06-20,74,3,84,158
"10782","1600-1659",2018-06-21,75,4,87,162
"10783","1600-1659",2018-06-22,76,5,86,162
"10784","1600-1659",2018-06-23,62,6,72,134
"10785","1600-1659",2018-06-24,75,7,85,160
"10786","1600-1659",2018-06-25,76,1,87,163
"10787","1600-1659",2018-06-26,74,2,87,161
"10788","1600-1659",2018-06-27,74,3,84,158
"10789","1600-1659",2018-06-28,74,4,88,162
"10790","1600-1659",2018-06-29,76,5,88,164
"10791","1600-1659",2018-06-30,61,6,74,135
"10792","1700-1759",2018-06-01,90,5,88,178
"10793","1700-1759",2018-06-02,80,6,76,156
"10794","1700-1759",2018-06-03,98,7,85,183
"10795","1700-1759",2018-06-04,92,1,90,182
"10796","1700-1759",2018-06-05,90,2,84,174
"10797","1700-1759",2018-06-06,90,3,86,176
"10798","1700-1759",2018-06-07,91,4,81,172
"10799","1700-1759",2018-06-08,96,5,85,181
"10800","1700-1759",2018-06-09,80,6,70,150
"10801","1700-1759",2018-06-10,91,7,80,171
"10802","1700-1759",2018-06-11,96,1,85,181
"10803","1700-1759",2018-06-12,94,2,82,176
"10804","1700-1759",2018-06-13,91,3,81,172
"10805","1700-1759",2018-06-14,92,4,84,176
"10806","1700-1759",2018-06-15,94,5,85,179
"10807","1700-1759",2018-06-16,78,6,69,147
"10808","1700-1759",2018-06-17,89,7,79,168
"10809","1700-1759",2018-06-18,94,1,85,179
"10810","1700-1759",2018-06-19,92,2,84,176
"10811","1700-1759",2018-06-20,91,3,83,174
"10812","1700-1759",2018-06-21,93,4,84,177
"10813","1700-1759",2018-06-22,95,5,86,181
"10814","1700-1759",2018-06-23,79,6,69,148
"10815","1700-1759",2018-06-24,90,7,80,170
"10816","1700-1759",2018-06-25,95,1,85,180
"10817","1700-1759",2018-06-26,93,2,84,177
"10818","1700-1759",2018-06-27,91,3,83,174
"10819","1700-1759",2018-06-28,93,4,84,177
"10820","1700-1759",2018-06-29,95,5,85,180
"10821","1700-1759",2018-06-30,83,6,70,153
"10822","1800-1859",2018-06-01,80,5,77,157
"10823","1800-1859",2018-06-02,65,6,67,132
"10824","1800-1859",2018-06-03,77,7,87,164
"10825","1800-1859",2018-06-04,79,1,76,155
"10826","1800-1859",2018-06-05,75,2,77,152
"10827","1800-1859",2018-06-06,78,3,79,157
"10828","1800-1859",2018-06-07,82,4,91,173
"10829","1800-1859",2018-06-08,81,5,94,175
"10830","1800-1859",2018-06-09,73,6,79,152
"10831","1800-1859",2018-06-10,81,7,90,171
"10832","1800-1859",2018-06-11,82,1,96,178
"10833","1800-1859",2018-06-12,80,2,94,174
"10834","1800-1859",2018-06-13,79,3,94,173
"10835","1800-1859",2018-06-14,82,4,96,178
"10836","1800-1859",2018-06-15,83,5,96,179
"10837","1800-1859",2018-06-16,73,6,81,154
"10838","1800-1859",2018-06-17,82,7,90,172
"10839","1800-1859",2018-06-18,83,1,94,177
"10840","1800-1859",2018-06-19,81,2,93,174
"10841","1800-1859",2018-06-20,80,3,93,173
"10842","1800-1859",2018-06-21,81,4,96,177
"10843","1800-1859",2018-06-22,81,5,95,176
"10844","1800-1859",2018-06-23,72,6,80,152
"10845","1800-1859",2018-06-24,81,7,89,170
"10846","1800-1859",2018-06-25,82,1,94,176
"10847","1800-1859",2018-06-26,80,2,93,173
"10848","1800-1859",2018-06-27,80,3,93,173
"10849","1800-1859",2018-06-28,81,4,94,175
"10850","1800-1859",2018-06-29,83,5,93,176
"10851","1800-1859",2018-06-30,77,6,81,158
"10852","1900-1959",2018-06-01,70,5,94,164
"10853","1900-1959",2018-06-02,61,6,76,137
"10854","1900-1959",2018-06-03,75,7,86,161
"10855","1900-1959",2018-06-04,73,1,96,169
"10856","1900-1959",2018-06-05,72,2,92,164
"10857","1900-1959",2018-06-06,71,3,90,161
"10858","1900-1959",2018-06-07,82,4,88,170
"10859","1900-1959",2018-06-08,83,5,86,169
"10860","1900-1959",2018-06-09,72,6,75,147
"10861","1900-1959",2018-06-10,81,7,87,168
"10862","1900-1959",2018-06-11,83,1,85,168
"10863","1900-1959",2018-06-12,81,2,82,163
"10864","1900-1959",2018-06-13,80,3,83,163
"10865","1900-1959",2018-06-14,85,4,83,168
"10866","1900-1959",2018-06-15,83,5,84,167
"10867","1900-1959",2018-06-16,73,6,77,150
"10868","1900-1959",2018-06-17,82,7,87,169
"10869","1900-1959",2018-06-18,84,1,85,169
"10870","1900-1959",2018-06-19,82,2,81,163
"10871","1900-1959",2018-06-20,81,3,83,164
"10872","1900-1959",2018-06-21,85,4,82,167
"10873","1900-1959",2018-06-22,85,5,83,168
"10874","1900-1959",2018-06-23,73,6,77,150
"10875","1900-1959",2018-06-24,81,7,87,168
"10876","1900-1959",2018-06-25,84,1,85,169
"10877","1900-1959",2018-06-26,82,2,81,163
"10878","1900-1959",2018-06-27,81,3,83,164
"10879","1900-1959",2018-06-28,85,4,83,168
"10880","1900-1959",2018-06-29,84,5,86,170
"10881","1900-1959",2018-06-30,74,6,84,158
"10882","2000-2059",2018-06-01,66,5,89,155
"10883","2000-2059",2018-06-02,45,6,89,134
"10884","2000-2059",2018-06-03,63,7,90,153
"10885","2000-2059",2018-06-04,67,1,88,155
"10886","2000-2059",2018-06-05,62,2,86,148
"10887","2000-2059",2018-06-06,67,3,88,155
"10888","2000-2059",2018-06-07,70,4,93,163
"10889","2000-2059",2018-06-08,69,5,100,169
"10890","2000-2059",2018-06-09,52,6,83,135
"10891","2000-2059",2018-06-10,69,7,94,163
"10892","2000-2059",2018-06-11,69,1,100,169
"10893","2000-2059",2018-06-12,68,2,95,163
"10894","2000-2059",2018-06-13,67,3,96,163
"10895","2000-2059",2018-06-14,70,4,98,168
"10896","2000-2059",2018-06-15,69,5,102,171
"10897","2000-2059",2018-06-16,52,6,82,134
"10898","2000-2059",2018-06-17,70,7,96,166
"10899","2000-2059",2018-06-18,68,1,102,170
"10900","2000-2059",2018-06-19,67,2,97,164
"10901","2000-2059",2018-06-20,67,3,98,165
"10902","2000-2059",2018-06-21,69,4,98,167
"10903","2000-2059",2018-06-22,68,5,103,171
"10904","2000-2059",2018-06-23,51,6,82,133
"10905","2000-2059",2018-06-24,69,7,96,165
"10906","2000-2059",2018-06-25,68,1,102,170
"10907","2000-2059",2018-06-26,68,2,97,165
"10908","2000-2059",2018-06-27,68,3,98,166
"10909","2000-2059",2018-06-28,70,4,97,167
"10910","2000-2059",2018-06-29,69,5,102,171
"10911","2000-2059",2018-06-30,56,6,85,141
"10912","2100-2159",2018-06-01,71,5,98,169
"10913","2100-2159",2018-06-02,49,6,75,124
"10914","2100-2159",2018-06-03,75,7,96,171
"10915","2100-2159",2018-06-04,70,1,100,170
"10916","2100-2159",2018-06-05,69,2,96,165
"10917","2100-2159",2018-06-06,71,3,101,172
"10918","2100-2159",2018-06-07,73,4,89,162
"10919","2100-2159",2018-06-08,72,5,91,163
"10920","2100-2159",2018-06-09,59,6,82,141
"10921","2100-2159",2018-06-10,76,7,95,171
"10922","2100-2159",2018-06-11,73,1,92,165
"10923","2100-2159",2018-06-12,72,2,90,162
"10924","2100-2159",2018-06-13,74,3,90,164
"10925","2100-2159",2018-06-14,73,4,93,166
"10926","2100-2159",2018-06-15,72,5,92,164
"10927","2100-2159",2018-06-16,60,6,82,142
"10928","2100-2159",2018-06-17,75,7,94,169
"10929","2100-2159",2018-06-18,73,1,92,165
"10930","2100-2159",2018-06-19,72,2,91,163
"10931","2100-2159",2018-06-20,75,3,92,167
"10932","2100-2159",2018-06-21,73,4,93,166
"10933","2100-2159",2018-06-22,72,5,91,163
"10934","2100-2159",2018-06-23,60,6,82,142
"10935","2100-2159",2018-06-24,75,7,94,169
"10936","2100-2159",2018-06-25,73,1,92,165
"10937","2100-2159",2018-06-26,71,2,91,162
"10938","2100-2159",2018-06-27,75,3,92,167
"10939","2100-2159",2018-06-28,74,4,94,168
"10940","2100-2159",2018-06-29,69,5,93,162
"10941","2100-2159",2018-06-30,61,6,83,144
"10942","2200-2259",2018-06-01,56,5,64,120
"10943","2200-2259",2018-06-02,32,6,66,98
"10944","2200-2259",2018-06-03,50,7,72,122
"10945","2200-2259",2018-06-04,56,1,65,121
"10946","2200-2259",2018-06-05,51,2,62,113
"10947","2200-2259",2018-06-06,55,3,65,120
"10948","2200-2259",2018-06-07,69,4,81,150
"10949","2200-2259",2018-06-08,68,5,78,146
"10950","2200-2259",2018-06-09,39,6,77,116
"10951","2200-2259",2018-06-10,66,7,77,143
"10952","2200-2259",2018-06-11,66,1,80,146
"10953","2200-2259",2018-06-12,66,2,79,145
"10954","2200-2259",2018-06-13,67,3,81,148
"10955","2200-2259",2018-06-14,68,4,79,147
"10956","2200-2259",2018-06-15,68,5,77,145
"10957","2200-2259",2018-06-16,41,6,76,117
"10958","2200-2259",2018-06-17,66,7,77,143
"10959","2200-2259",2018-06-18,68,1,78,146
"10960","2200-2259",2018-06-19,68,2,76,144
"10961","2200-2259",2018-06-20,68,3,78,146
"10962","2200-2259",2018-06-21,68,4,78,146
"10963","2200-2259",2018-06-22,67,5,77,144
"10964","2200-2259",2018-06-23,40,6,75,115
"10965","2200-2259",2018-06-24,66,7,77,143
"10966","2200-2259",2018-06-25,68,1,78,146
"10967","2200-2259",2018-06-26,68,2,76,144
"10968","2200-2259",2018-06-27,68,3,78,146
"10969","2200-2259",2018-06-28,67,4,78,145
"10970","2200-2259",2018-06-29,69,5,75,144
"10971","2200-2259",2018-06-30,42,6,79,121
"10972","2300-2359",2018-06-01,24,5,84,108
"10973","2300-2359",2018-06-02,25,6,49,74
"10974","2300-2359",2018-06-03,28,7,88,116
"10975","2300-2359",2018-06-04,26,1,85,111
"10976","2300-2359",2018-06-05,23,2,79,102
"10977","2300-2359",2018-06-06,26,3,85,111
"10978","2300-2359",2018-06-07,30,4,88,118
"10979","2300-2359",2018-06-08,30,5,85,115
"10980","2300-2359",2018-06-09,25,6,64,89
"10981","2300-2359",2018-06-10,30,7,86,116
"10982","2300-2359",2018-06-11,30,1,84,114
"10983","2300-2359",2018-06-12,28,2,83,111
"10984","2300-2359",2018-06-13,27,3,82,109
"10985","2300-2359",2018-06-14,29,4,88,117
"10986","2300-2359",2018-06-15,29,5,87,116
"10987","2300-2359",2018-06-16,24,6,66,90
"10988","2300-2359",2018-06-17,29,7,87,116
"10989","2300-2359",2018-06-18,29,1,87,116
"10990","2300-2359",2018-06-19,26,2,86,112
"10991","2300-2359",2018-06-20,26,3,87,113
"10992","2300-2359",2018-06-21,29,4,88,117
"10993","2300-2359",2018-06-22,29,5,87,116
"10994","2300-2359",2018-06-23,25,6,65,90
"10995","2300-2359",2018-06-24,28,7,86,114
"10996","2300-2359",2018-06-25,29,1,87,116
"10997","2300-2359",2018-06-26,26,2,86,112
"10998","2300-2359",2018-06-27,26,3,87,113
"10999","2300-2359",2018-06-28,28,4,88,116
"11000","2300-2359",2018-06-29,29,5,87,116
"11001","2300-2359",2018-06-30,27,6,66,93
"11002","0001-0559",2020-01-01,18,3,90,108
"11003","0001-0559",2020-01-02,32,4,85,117
"11004","0001-0559",2020-01-03,35,5,86,121
"11005","0001-0559",2020-01-04,17,6,75,92
"11006","0001-0559",2020-01-05,24,7,93,117
"11007","0001-0559",2020-01-06,28,1,73,101
"11008","0001-0559",2020-01-07,22,2,62,84
"11009","0001-0559",2020-01-08,21,3,68,89
"11010","0001-0559",2020-01-09,21,4,71,92
"11011","0001-0559",2020-01-10,21,5,70,91
"11012","0001-0559",2020-01-11,13,6,48,61
"11013","0001-0559",2020-01-12,16,7,65,81
"11014","0001-0559",2020-01-13,21,1,68,89
"11015","0001-0559",2020-01-14,21,2,62,83
"11016","0001-0559",2020-01-15,21,3,64,85
"11017","0001-0559",2020-01-16,21,4,71,92
"11018","0001-0559",2020-01-17,21,5,70,91
"11019","0001-0559",2020-01-18,13,6,44,57
"11020","0001-0559",2020-01-19,15,7,60,75
"11021","0001-0559",2020-01-20,19,1,65,84
"11022","0001-0559",2020-01-21,21,2,62,83
"11023","0001-0559",2020-01-22,21,3,64,85
"11024","0001-0559",2020-01-23,21,4,71,92
"11025","0001-0559",2020-01-24,21,5,70,91
"11026","0001-0559",2020-01-25,13,6,47,60
"11027","0001-0559",2020-01-26,16,7,65,81
"11028","0001-0559",2020-01-27,21,1,68,89
"11029","0001-0559",2020-01-28,21,2,62,83
"11030","0001-0559",2020-01-29,21,3,64,85
"11031","0001-0559",2020-01-30,21,4,70,91
"11032","0001-0559",2020-01-31,21,5,69,90
"11033","0600-0659",2020-01-01,87,3,28,115
"11034","0600-0659",2020-01-02,112,4,39,151
"11035","0600-0659",2020-01-03,113,5,40,153
"11036","0600-0659",2020-01-04,96,6,29,125
"11037","0600-0659",2020-01-05,107,7,34,141
"11038","0600-0659",2020-01-06,113,1,33,146
"11039","0600-0659",2020-01-07,99,2,23,122
"11040","0600-0659",2020-01-08,91,3,22,113
"11041","0600-0659",2020-01-09,100,4,25,125
"11042","0600-0659",2020-01-10,101,5,26,127
"11043","0600-0659",2020-01-11,82,6,23,105
"11044","0600-0659",2020-01-12,75,7,22,97
"11045","0600-0659",2020-01-13,101,1,25,126
"11046","0600-0659",2020-01-14,98,2,24,122
"11047","0600-0659",2020-01-15,93,3,24,117
"11048","0600-0659",2020-01-16,100,4,25,125
"11049","0600-0659",2020-01-17,101,5,26,127
"11050","0600-0659",2020-01-18,79,6,23,102
"11051","0600-0659",2020-01-19,74,7,21,95
"11052","0600-0659",2020-01-20,93,1,25,118
"11053","0600-0659",2020-01-21,97,2,24,121
"11054","0600-0659",2020-01-22,93,3,24,117
"11055","0600-0659",2020-01-23,100,4,25,125
"11056","0600-0659",2020-01-24,101,5,26,127
"11057","0600-0659",2020-01-25,80,6,23,103
"11058","0600-0659",2020-01-26,74,7,21,95
"11059","0600-0659",2020-01-27,101,1,24,125
"11060","0600-0659",2020-01-28,98,2,23,121
"11061","0600-0659",2020-01-29,93,3,23,116
"11062","0600-0659",2020-01-30,100,4,24,124
"11063","0600-0659",2020-01-31,100,5,25,125
"11064","0700-0759",2020-01-01,91,3,43,134
"11065","0700-0759",2020-01-02,100,4,56,156
"11066","0700-0759",2020-01-03,101,5,57,158
"11067","0700-0759",2020-01-04,93,6,45,138
"11068","0700-0759",2020-01-05,99,7,59,158
"11069","0700-0759",2020-01-06,99,1,52,151
"11070","0700-0759",2020-01-07,87,2,51,138
"11071","0700-0759",2020-01-08,89,3,49,138
"11072","0700-0759",2020-01-09,96,4,52,148
"11073","0700-0759",2020-01-10,97,5,54,151
"11074","0700-0759",2020-01-11,80,6,40,120
"11075","0700-0759",2020-01-12,79,7,46,125
"11076","0700-0759",2020-01-13,96,1,52,148
"11077","0700-0759",2020-01-14,90,2,51,141
"11078","0700-0759",2020-01-15,88,3,49,137
"11079","0700-0759",2020-01-16,94,4,51,145
"11080","0700-0759",2020-01-17,96,5,52,148
"11081","0700-0759",2020-01-18,78,6,38,116
"11082","0700-0759",2020-01-19,74,7,42,116
"11083","0700-0759",2020-01-20,91,1,50,141
"11084","0700-0759",2020-01-21,90,2,51,141
"11085","0700-0759",2020-01-22,89,3,49,138
"11086","0700-0759",2020-01-23,95,4,51,146
"11087","0700-0759",2020-01-24,97,5,52,149
"11088","0700-0759",2020-01-25,79,6,39,118
"11089","0700-0759",2020-01-26,80,7,46,126
"11090","0700-0759",2020-01-27,97,1,52,149
"11091","0700-0759",2020-01-28,90,2,51,141
"11092","0700-0759",2020-01-29,89,3,49,138
"11093","0700-0759",2020-01-30,93,4,51,144
"11094","0700-0759",2020-01-31,95,5,52,147
"11095","0800-0859",2020-01-01,101,3,59,160
"11096","0800-0859",2020-01-02,115,4,68,183
"11097","0800-0859",2020-01-03,112,5,70,182
"11098","0800-0859",2020-01-04,103,6,65,168
"11099","0800-0859",2020-01-05,112,7,62,174
"11100","0800-0859",2020-01-06,103,1,70,173
"11101","0800-0859",2020-01-07,98,2,61,159
"11102","0800-0859",2020-01-08,97,3,57,154
"11103","0800-0859",2020-01-09,104,4,60,164
"11104","0800-0859",2020-01-10,105,5,60,165
"11105","0800-0859",2020-01-11,98,6,55,153
"11106","0800-0859",2020-01-12,106,7,42,148
"11107","0800-0859",2020-01-13,103,1,61,164
"11108","0800-0859",2020-01-14,98,2,59,157
"11109","0800-0859",2020-01-15,98,3,56,154
"11110","0800-0859",2020-01-16,104,4,60,164
"11111","0800-0859",2020-01-17,104,5,61,165
"11112","0800-0859",2020-01-18,98,6,52,150
"11113","0800-0859",2020-01-19,108,7,42,150
"11114","0800-0859",2020-01-20,103,1,56,159
"11115","0800-0859",2020-01-21,98,2,59,157
"11116","0800-0859",2020-01-22,96,3,56,152
"11117","0800-0859",2020-01-23,105,4,61,166
"11118","0800-0859",2020-01-24,103,5,61,164
"11119","0800-0859",2020-01-25,99,6,53,152
"11120","0800-0859",2020-01-26,107,7,42,149
"11121","0800-0859",2020-01-27,102,1,62,164
"11122","0800-0859",2020-01-28,98,2,60,158
"11123","0800-0859",2020-01-29,97,3,57,154
"11124","0800-0859",2020-01-30,105,4,61,166
"11125","0800-0859",2020-01-31,104,5,62,166
"11126","0900-0959",2020-01-01,78,3,52,130
"11127","0900-0959",2020-01-02,81,4,62,143
"11128","0900-0959",2020-01-03,81,5,63,144
"11129","0900-0959",2020-01-04,78,6,53,131
"11130","0900-0959",2020-01-05,83,7,66,149
"11131","0900-0959",2020-01-06,84,1,62,146
"11132","0900-0959",2020-01-07,78,2,58,136
"11133","0900-0959",2020-01-08,80,3,58,138
"11134","0900-0959",2020-01-09,86,4,65,151
"11135","0900-0959",2020-01-10,84,5,65,149
"11136","0900-0959",2020-01-11,81,6,53,134
"11137","0900-0959",2020-01-12,77,7,57,134
"11138","0900-0959",2020-01-13,84,1,64,148
"11139","0900-0959",2020-01-14,78,2,59,137
"11140","0900-0959",2020-01-15,79,3,59,138
"11141","0900-0959",2020-01-16,85,4,64,149
"11142","0900-0959",2020-01-17,85,5,64,149
"11143","0900-0959",2020-01-18,78,6,51,129
"11144","0900-0959",2020-01-19,72,7,55,127
"11145","0900-0959",2020-01-20,82,1,59,141
"11146","0900-0959",2020-01-21,77,2,58,135
"11147","0900-0959",2020-01-22,79,3,59,138
"11148","0900-0959",2020-01-23,85,4,64,149
"11149","0900-0959",2020-01-24,84,5,64,148
"11150","0900-0959",2020-01-25,76,6,52,128
"11151","0900-0959",2020-01-26,76,7,56,132
"11152","0900-0959",2020-01-27,84,1,63,147
"11153","0900-0959",2020-01-28,78,2,58,136
"11154","0900-0959",2020-01-29,79,3,58,137
"11155","0900-0959",2020-01-30,85,4,63,148
"11156","0900-0959",2020-01-31,84,5,62,146
"11157","1000-1059",2020-01-01,73,3,64,137
"11158","1000-1059",2020-01-02,78,4,69,147
"11159","1000-1059",2020-01-03,77,5,70,147
"11160","1000-1059",2020-01-04,64,6,63,127
"11161","1000-1059",2020-01-05,77,7,64,141
"11162","1000-1059",2020-01-06,79,1,66,145
"11163","1000-1059",2020-01-07,62,2,61,123
"11164","1000-1059",2020-01-08,65,3,64,129
"11165","1000-1059",2020-01-09,72,4,68,140
"11166","1000-1059",2020-01-10,72,5,68,140
"11167","1000-1059",2020-01-11,57,6,65,122
"11168","1000-1059",2020-01-12,68,7,64,132
"11169","1000-1059",2020-01-13,72,1,68,140
"11170","1000-1059",2020-01-14,63,2,63,126
"11171","1000-1059",2020-01-15,66,3,64,130
"11172","1000-1059",2020-01-16,72,4,68,140
"11173","1000-1059",2020-01-17,72,5,68,140
"11174","1000-1059",2020-01-18,57,6,63,120
"11175","1000-1059",2020-01-19,64,7,62,126
"11176","1000-1059",2020-01-20,72,1,68,140
"11177","1000-1059",2020-01-21,62,2,63,125
"11178","1000-1059",2020-01-22,66,3,64,130
"11179","1000-1059",2020-01-23,72,4,68,140
"11180","1000-1059",2020-01-24,72,5,68,140
"11181","1000-1059",2020-01-25,58,6,64,122
"11182","1000-1059",2020-01-26,67,7,65,132
"11183","1000-1059",2020-01-27,71,1,68,139
"11184","1000-1059",2020-01-28,62,2,63,125
"11185","1000-1059",2020-01-29,65,3,64,129
"11186","1000-1059",2020-01-30,71,4,67,138
"11187","1000-1059",2020-01-31,71,5,67,138
"11188","1100-1159",2020-01-01,85,3,62,147
"11189","1100-1159",2020-01-02,84,4,73,157
"11190","1100-1159",2020-01-03,85,5,72,157
"11191","1100-1159",2020-01-04,81,6,65,146
"11192","1100-1159",2020-01-05,81,7,71,152
"11193","1100-1159",2020-01-06,81,1,73,154
"11194","1100-1159",2020-01-07,75,2,59,134
"11195","1100-1159",2020-01-08,75,3,56,131
"11196","1100-1159",2020-01-09,77,4,63,140
"11197","1100-1159",2020-01-10,79,5,63,142
"11198","1100-1159",2020-01-11,73,6,57,130
"11199","1100-1159",2020-01-12,80,7,62,142
"11200","1100-1159",2020-01-13,78,1,63,141
"11201","1100-1159",2020-01-14,76,2,58,134
"11202","1100-1159",2020-01-15,75,3,55,130
"11203","1100-1159",2020-01-16,79,4,63,142
"11204","1100-1159",2020-01-17,78,5,63,141
"11205","1100-1159",2020-01-18,71,6,58,129
"11206","1100-1159",2020-01-19,76,7,60,136
"11207","1100-1159",2020-01-20,78,1,62,140
"11208","1100-1159",2020-01-21,76,2,58,134
"11209","1100-1159",2020-01-22,75,3,54,129
"11210","1100-1159",2020-01-23,79,4,63,142
"11211","1100-1159",2020-01-24,78,5,63,141
"11212","1100-1159",2020-01-25,73,6,57,130
"11213","1100-1159",2020-01-26,81,7,62,143
"11214","1100-1159",2020-01-27,78,1,63,141
"11215","1100-1159",2020-01-28,76,2,58,134
"11216","1100-1159",2020-01-29,75,3,55,130
"11217","1100-1159",2020-01-30,78,4,63,141
"11218","1100-1159",2020-01-31,77,5,63,140
"11219","1200-1259",2020-01-01,74,3,81,155
"11220","1200-1259",2020-01-02,77,4,88,165
"11221","1200-1259",2020-01-03,78,5,85,163
"11222","1200-1259",2020-01-04,66,6,73,139
"11223","1200-1259",2020-01-05,74,7,85,159
"11224","1200-1259",2020-01-06,82,1,78,160
"11225","1200-1259",2020-01-07,74,2,75,149
"11226","1200-1259",2020-01-08,73,3,74,147
"11227","1200-1259",2020-01-09,77,4,76,153
"11228","1200-1259",2020-01-10,74,5,78,152
"11229","1200-1259",2020-01-11,58,6,66,124
"11230","1200-1259",2020-01-12,70,7,71,141
"11231","1200-1259",2020-01-13,77,1,77,154
"11232","1200-1259",2020-01-14,74,2,74,148
"11233","1200-1259",2020-01-15,73,3,74,147
"11234","1200-1259",2020-01-16,76,4,78,154
"11235","1200-1259",2020-01-17,76,5,79,155
"11236","1200-1259",2020-01-18,57,6,66,123
"11237","1200-1259",2020-01-19,63,7,69,132
"11238","1200-1259",2020-01-20,77,1,75,152
"11239","1200-1259",2020-01-21,75,2,74,149
"11240","1200-1259",2020-01-22,73,3,75,148
"11241","1200-1259",2020-01-23,76,4,80,156
"11242","1200-1259",2020-01-24,76,5,79,155
"11243","1200-1259",2020-01-25,57,6,67,124
"11244","1200-1259",2020-01-26,70,7,72,142
"11245","1200-1259",2020-01-27,78,1,78,156
"11246","1200-1259",2020-01-28,74,2,74,148
"11247","1200-1259",2020-01-29,73,3,74,147
"11248","1200-1259",2020-01-30,76,4,79,155
"11249","1200-1259",2020-01-31,76,5,78,154
"11250","1300-1359",2020-01-01,69,3,65,134
"11251","1300-1359",2020-01-02,74,4,67,141
"11252","1300-1359",2020-01-03,71,5,67,138
"11253","1300-1359",2020-01-04,67,6,65,132
"11254","1300-1359",2020-01-05,71,7,68,139
"11255","1300-1359",2020-01-06,66,1,76,142
"11256","1300-1359",2020-01-07,69,2,60,129
"11257","1300-1359",2020-01-08,69,3,63,132
"11258","1300-1359",2020-01-09,68,4,66,134
"11259","1300-1359",2020-01-10,74,5,65,139
"11260","1300-1359",2020-01-11,63,6,59,122
"11261","1300-1359",2020-01-12,68,7,56,124
"11262","1300-1359",2020-01-13,69,1,65,134
"11263","1300-1359",2020-01-14,68,2,60,128
"11264","1300-1359",2020-01-15,68,3,64,132
"11265","1300-1359",2020-01-16,70,4,64,134
"11266","1300-1359",2020-01-17,71,5,64,135
"11267","1300-1359",2020-01-18,63,6,58,121
"11268","1300-1359",2020-01-19,63,7,55,118
"11269","1300-1359",2020-01-20,69,1,63,132
"11270","1300-1359",2020-01-21,67,2,60,127
"11271","1300-1359",2020-01-22,68,3,63,131
"11272","1300-1359",2020-01-23,71,4,63,134
"11273","1300-1359",2020-01-24,71,5,63,134
"11274","1300-1359",2020-01-25,64,6,57,121
"11275","1300-1359",2020-01-26,69,7,55,124
"11276","1300-1359",2020-01-27,68,1,63,131
"11277","1300-1359",2020-01-28,68,2,59,127
"11278","1300-1359",2020-01-29,68,3,63,131
"11279","1300-1359",2020-01-30,71,4,63,134
"11280","1300-1359",2020-01-31,71,5,64,135
"11281","1400-1459",2020-01-01,79,3,86,165
"11282","1400-1459",2020-01-02,77,4,90,167
"11283","1400-1459",2020-01-03,77,5,93,170
"11284","1400-1459",2020-01-04,72,6,82,154
"11285","1400-1459",2020-01-05,75,7,84,159
"11286","1400-1459",2020-01-06,78,1,83,161
"11287","1400-1459",2020-01-07,65,2,80,145
"11288","1400-1459",2020-01-08,64,3,77,141
"11289","1400-1459",2020-01-09,68,4,80,148
"11290","1400-1459",2020-01-10,66,5,83,149
"11291","1400-1459",2020-01-11,60,6,69,129
"11292","1400-1459",2020-01-12,64,7,73,137
"11293","1400-1459",2020-01-13,66,1,81,147
"11294","1400-1459",2020-01-14,65,2,78,143
"11295","1400-1459",2020-01-15,65,3,77,142
"11296","1400-1459",2020-01-16,67,4,80,147
"11297","1400-1459",2020-01-17,66,5,82,148
"11298","1400-1459",2020-01-18,58,6,67,125
"11299","1400-1459",2020-01-19,68,7,70,138
"11300","1400-1459",2020-01-20,64,1,81,145
"11301","1400-1459",2020-01-21,65,2,77,142
"11302","1400-1459",2020-01-22,63,3,77,140
"11303","1400-1459",2020-01-23,66,4,80,146
"11304","1400-1459",2020-01-24,65,5,82,147
"11305","1400-1459",2020-01-25,58,6,67,125
"11306","1400-1459",2020-01-26,63,7,73,136
"11307","1400-1459",2020-01-27,66,1,81,147
"11308","1400-1459",2020-01-28,65,2,78,143
"11309","1400-1459",2020-01-29,65,3,77,142
"11310","1400-1459",2020-01-30,66,4,80,146
"11311","1400-1459",2020-01-31,66,5,81,147
"11312","1500-1559",2020-01-01,78,3,76,154
"11313","1500-1559",2020-01-02,83,4,82,165
"11314","1500-1559",2020-01-03,84,5,80,164
"11315","1500-1559",2020-01-04,73,6,72,145
"11316","1500-1559",2020-01-05,77,7,82,159
"11317","1500-1559",2020-01-06,75,1,80,155
"11318","1500-1559",2020-01-07,67,2,72,139
"11319","1500-1559",2020-01-08,71,3,76,147
"11320","1500-1559",2020-01-09,72,4,79,151
"11321","1500-1559",2020-01-10,71,5,77,148
"11322","1500-1559",2020-01-11,57,6,74,131
"11323","1500-1559",2020-01-12,67,7,80,147
"11324","1500-1559",2020-01-13,72,1,79,151
"11325","1500-1559",2020-01-14,67,2,76,143
"11326","1500-1559",2020-01-15,70,3,77,147
"11327","1500-1559",2020-01-16,71,4,81,152
"11328","1500-1559",2020-01-17,72,5,79,151
"11329","1500-1559",2020-01-18,56,6,74,130
"11330","1500-1559",2020-01-19,60,7,77,137
"11331","1500-1559",2020-01-20,72,1,78,150
"11332","1500-1559",2020-01-21,67,2,76,143
"11333","1500-1559",2020-01-22,71,3,76,147
"11334","1500-1559",2020-01-23,71,4,81,152
"11335","1500-1559",2020-01-24,72,5,79,151
"11336","1500-1559",2020-01-25,57,6,75,132
"11337","1500-1559",2020-01-26,67,7,80,147
"11338","1500-1559",2020-01-27,72,1,79,151
"11339","1500-1559",2020-01-28,67,2,76,143
"11340","1500-1559",2020-01-29,70,3,77,147
"11341","1500-1559",2020-01-30,71,4,80,151
"11342","1500-1559",2020-01-31,72,5,79,151
"11343","1600-1659",2020-01-01,84,3,79,163
"11344","1600-1659",2020-01-02,82,4,80,162
"11345","1600-1659",2020-01-03,81,5,81,162
"11346","1600-1659",2020-01-04,82,6,75,157
"11347","1600-1659",2020-01-05,81,7,76,157
"11348","1600-1659",2020-01-06,74,1,82,156
"11349","1600-1659",2020-01-07,62,2,77,139
"11350","1600-1659",2020-01-08,64,3,76,140
"11351","1600-1659",2020-01-09,71,4,80,151
"11352","1600-1659",2020-01-10,70,5,81,151
"11353","1600-1659",2020-01-11,64,6,62,126
"11354","1600-1659",2020-01-12,69,7,75,144
"11355","1600-1659",2020-01-13,68,1,81,149
"11356","1600-1659",2020-01-14,64,2,78,142
"11357","1600-1659",2020-01-15,66,3,76,142
"11358","1600-1659",2020-01-16,69,4,80,149
"11359","1600-1659",2020-01-17,68,5,80,148
"11360","1600-1659",2020-01-18,60,6,60,120
"11361","1600-1659",2020-01-19,65,7,69,134
"11362","1600-1659",2020-01-20,67,1,80,147
"11363","1600-1659",2020-01-21,64,2,78,142
"11364","1600-1659",2020-01-22,66,3,77,143
"11365","1600-1659",2020-01-23,69,4,80,149
"11366","1600-1659",2020-01-24,69,5,80,149
"11367","1600-1659",2020-01-25,62,6,62,124
"11368","1600-1659",2020-01-26,69,7,75,144
"11369","1600-1659",2020-01-27,67,1,82,149
"11370","1600-1659",2020-01-28,65,2,79,144
"11371","1600-1659",2020-01-29,66,3,77,143
"11372","1600-1659",2020-01-30,69,4,81,150
"11373","1600-1659",2020-01-31,69,5,81,150
"11374","1700-1759",2020-01-01,75,3,80,155
"11375","1700-1759",2020-01-02,80,4,76,156
"11376","1700-1759",2020-01-03,80,5,75,155
"11377","1700-1759",2020-01-04,77,6,73,150
"11378","1700-1759",2020-01-05,81,7,75,156
"11379","1700-1759",2020-01-06,89,1,81,170
"11380","1700-1759",2020-01-07,85,2,67,152
"11381","1700-1759",2020-01-08,88,3,72,160
"11382","1700-1759",2020-01-09,91,4,80,171
"11383","1700-1759",2020-01-10,92,5,75,167
"11384","1700-1759",2020-01-11,69,6,55,124
"11385","1700-1759",2020-01-12,85,7,72,157
"11386","1700-1759",2020-01-13,89,1,75,164
"11387","1700-1759",2020-01-14,84,2,68,152
"11388","1700-1759",2020-01-15,87,3,73,160
"11389","1700-1759",2020-01-16,92,4,77,169
"11390","1700-1759",2020-01-17,91,5,75,166
"11391","1700-1759",2020-01-18,67,6,54,121
"11392","1700-1759",2020-01-19,75,7,65,140
"11393","1700-1759",2020-01-20,88,1,75,163
"11394","1700-1759",2020-01-21,86,2,68,154
"11395","1700-1759",2020-01-22,87,3,73,160
"11396","1700-1759",2020-01-23,92,4,77,169
"11397","1700-1759",2020-01-24,91,5,75,166
"11398","1700-1759",2020-01-25,69,6,54,123
"11399","1700-1759",2020-01-26,85,7,71,156
"11400","1700-1759",2020-01-27,90,1,74,164
"11401","1700-1759",2020-01-28,85,2,67,152
"11402","1700-1759",2020-01-29,87,3,72,159
"11403","1700-1759",2020-01-30,92,4,75,167
"11404","1700-1759",2020-01-31,90,5,73,163
"11405","1800-1859",2020-01-01,88,3,78,166
"11406","1800-1859",2020-01-02,85,4,83,168
"11407","1800-1859",2020-01-03,85,5,83,168
"11408","1800-1859",2020-01-04,77,6,74,151
"11409","1800-1859",2020-01-05,87,7,84,171
"11410","1800-1859",2020-01-06,78,1,81,159
"11411","1800-1859",2020-01-07,66,2,74,140
"11412","1800-1859",2020-01-08,73,3,74,147
"11413","1800-1859",2020-01-09,80,4,76,156
"11414","1800-1859",2020-01-10,80,5,79,159
"11415","1800-1859",2020-01-11,61,6,69,130
"11416","1800-1859",2020-01-12,74,7,81,155
"11417","1800-1859",2020-01-13,79,1,77,156
"11418","1800-1859",2020-01-14,68,2,73,141
"11419","1800-1859",2020-01-15,72,3,73,145
"11420","1800-1859",2020-01-16,78,4,76,154
"11421","1800-1859",2020-01-17,78,5,76,154
"11422","1800-1859",2020-01-18,57,6,67,124
"11423","1800-1859",2020-01-19,67,7,73,140
"11424","1800-1859",2020-01-20,79,1,76,155
"11425","1800-1859",2020-01-21,66,2,73,139
"11426","1800-1859",2020-01-22,72,3,73,145
"11427","1800-1859",2020-01-23,78,4,76,154
"11428","1800-1859",2020-01-24,78,5,77,155
"11429","1800-1859",2020-01-25,58,6,67,125
"11430","1800-1859",2020-01-26,74,7,82,156
"11431","1800-1859",2020-01-27,77,1,77,154
"11432","1800-1859",2020-01-28,66,2,74,140
"11433","1800-1859",2020-01-29,72,3,73,145
"11434","1800-1859",2020-01-30,77,4,76,153
"11435","1800-1859",2020-01-31,77,5,75,152
"11436","1900-1959",2020-01-01,75,3,81,156
"11437","1900-1959",2020-01-02,80,4,78,158
"11438","1900-1959",2020-01-03,82,5,78,160
"11439","1900-1959",2020-01-04,73,6,81,154
"11440","1900-1959",2020-01-05,79,7,75,154
"11441","1900-1959",2020-01-06,82,1,82,164
"11442","1900-1959",2020-01-07,73,2,77,150
"11443","1900-1959",2020-01-08,76,3,77,153
"11444","1900-1959",2020-01-09,82,4,80,162
"11445","1900-1959",2020-01-10,83,5,80,163
"11446","1900-1959",2020-01-11,66,6,67,133
"11447","1900-1959",2020-01-12,80,7,68,148
"11448","1900-1959",2020-01-13,83,1,81,164
"11449","1900-1959",2020-01-14,75,2,77,152
"11450","1900-1959",2020-01-15,75,3,77,152
"11451","1900-1959",2020-01-16,82,4,81,163
"11452","1900-1959",2020-01-17,82,5,79,161
"11453","1900-1959",2020-01-18,64,6,63,127
"11454","1900-1959",2020-01-19,71,7,64,135
"11455","1900-1959",2020-01-20,81,1,80,161
"11456","1900-1959",2020-01-21,75,2,76,151
"11457","1900-1959",2020-01-22,75,3,77,152
"11458","1900-1959",2020-01-23,82,4,81,163
"11459","1900-1959",2020-01-24,82,5,79,161
"11460","1900-1959",2020-01-25,66,6,67,133
"11461","1900-1959",2020-01-26,80,7,68,148
"11462","1900-1959",2020-01-27,84,1,79,163
"11463","1900-1959",2020-01-28,75,2,76,151
"11464","1900-1959",2020-01-29,75,3,77,152
"11465","1900-1959",2020-01-30,82,4,81,163
"11466","1900-1959",2020-01-31,81,5,79,160
"11467","2000-2059",2020-01-01,56,3,90,146
"11468","2000-2059",2020-01-02,57,4,97,154
"11469","2000-2059",2020-01-03,57,5,96,153
"11470","2000-2059",2020-01-04,55,6,86,141
"11471","2000-2059",2020-01-05,64,7,99,163
"11472","2000-2059",2020-01-06,55,1,86,141
"11473","2000-2059",2020-01-07,55,2,76,131
"11474","2000-2059",2020-01-08,54,3,83,137
"11475","2000-2059",2020-01-09,56,4,88,144
"11476","2000-2059",2020-01-10,56,5,92,148
"11477","2000-2059",2020-01-11,37,6,76,113
"11478","2000-2059",2020-01-12,55,7,86,141
"11479","2000-2059",2020-01-13,56,1,84,140
"11480","2000-2059",2020-01-14,53,2,77,130
"11481","2000-2059",2020-01-15,54,3,82,136
"11482","2000-2059",2020-01-16,55,4,85,140
"11483","2000-2059",2020-01-17,54,5,89,143
"11484","2000-2059",2020-01-18,34,6,72,106
"11485","2000-2059",2020-01-19,47,7,80,127
"11486","2000-2059",2020-01-20,56,1,83,139
"11487","2000-2059",2020-01-21,52,2,76,128
"11488","2000-2059",2020-01-22,54,3,82,136
"11489","2000-2059",2020-01-23,55,4,85,140
"11490","2000-2059",2020-01-24,54,5,89,143
"11491","2000-2059",2020-01-25,36,6,73,109
"11492","2000-2059",2020-01-26,54,7,86,140
"11493","2000-2059",2020-01-27,55,1,85,140
"11494","2000-2059",2020-01-28,52,2,77,129
"11495","2000-2059",2020-01-29,54,3,82,136
"11496","2000-2059",2020-01-30,55,4,85,140
"11497","2000-2059",2020-01-31,54,5,89,143
"11498","2100-2159",2020-01-01,59,3,87,146
"11499","2100-2159",2020-01-02,64,4,95,159
"11500","2100-2159",2020-01-03,64,5,95,159
"11501","2100-2159",2020-01-04,52,6,84,136
"11502","2100-2159",2020-01-05,68,7,94,162
"11503","2100-2159",2020-01-06,62,1,80,142
"11504","2100-2159",2020-01-07,56,2,75,131
"11505","2100-2159",2020-01-08,60,3,75,135
"11506","2100-2159",2020-01-09,67,4,83,150
"11507","2100-2159",2020-01-10,66,5,83,149
"11508","2100-2159",2020-01-11,34,6,65,99
"11509","2100-2159",2020-01-12,57,7,80,137
"11510","2100-2159",2020-01-13,66,1,82,148
"11511","2100-2159",2020-01-14,58,2,75,133
"11512","2100-2159",2020-01-15,61,3,74,135
"11513","2100-2159",2020-01-16,66,4,82,148
"11514","2100-2159",2020-01-17,66,5,82,148
"11515","2100-2159",2020-01-18,31,6,64,95
"11516","2100-2159",2020-01-19,52,7,74,126
"11517","2100-2159",2020-01-20,64,1,81,145
"11518","2100-2159",2020-01-21,58,2,74,132
"11519","2100-2159",2020-01-22,61,3,74,135
"11520","2100-2159",2020-01-23,66,4,83,149
"11521","2100-2159",2020-01-24,66,5,82,148
"11522","2100-2159",2020-01-25,35,6,65,100
"11523","2100-2159",2020-01-26,57,7,80,137
"11524","2100-2159",2020-01-27,66,1,81,147
"11525","2100-2159",2020-01-28,58,2,74,132
"11526","2100-2159",2020-01-29,61,3,74,135
"11527","2100-2159",2020-01-30,65,4,82,147
"11528","2100-2159",2020-01-31,65,5,81,146
"11529","2200-2259",2020-01-01,52,3,74,126
"11530","2200-2259",2020-01-02,57,4,74,131
"11531","2200-2259",2020-01-03,58,5,75,133
"11532","2200-2259",2020-01-04,44,6,71,115
"11533","2200-2259",2020-01-05,59,7,75,134
"11534","2200-2259",2020-01-06,48,1,89,137
"11535","2200-2259",2020-01-07,39,2,81,120
"11536","2200-2259",2020-01-08,40,3,83,123
"11537","2200-2259",2020-01-09,45,4,85,130
"11538","2200-2259",2020-01-10,46,5,86,132
"11539","2200-2259",2020-01-11,35,6,55,90
"11540","2200-2259",2020-01-12,47,7,83,130
"11541","2200-2259",2020-01-13,44,1,86,130
"11542","2200-2259",2020-01-14,38,2,79,117
"11543","2200-2259",2020-01-15,39,3,83,122
"11544","2200-2259",2020-01-16,45,4,86,131
"11545","2200-2259",2020-01-17,45,5,86,131
"11546","2200-2259",2020-01-18,35,6,52,87
"11547","2200-2259",2020-01-19,43,7,71,114
"11548","2200-2259",2020-01-20,44,1,86,130
"11549","2200-2259",2020-01-21,38,2,81,119
"11550","2200-2259",2020-01-22,39,3,82,121
"11551","2200-2259",2020-01-23,45,4,85,130
"11552","2200-2259",2020-01-24,45,5,85,130
"11553","2200-2259",2020-01-25,34,6,56,90
"11554","2200-2259",2020-01-26,47,7,83,130
"11555","2200-2259",2020-01-27,44,1,87,131
"11556","2200-2259",2020-01-28,38,2,80,118
"11557","2200-2259",2020-01-29,39,3,83,122
"11558","2200-2259",2020-01-30,45,4,86,131
"11559","2200-2259",2020-01-31,45,5,85,130
"11560","2300-2359",2020-01-01,30,3,77,107
"11561","2300-2359",2020-01-02,30,4,86,116
"11562","2300-2359",2020-01-03,32,5,87,119
"11563","2300-2359",2020-01-04,31,6,70,101
"11564","2300-2359",2020-01-05,34,7,87,121
"11565","2300-2359",2020-01-06,21,1,70,91
"11566","2300-2359",2020-01-07,18,2,61,79
"11567","2300-2359",2020-01-08,19,3,65,84
"11568","2300-2359",2020-01-09,18,4,74,92
"11569","2300-2359",2020-01-10,19,5,71,90
"11570","2300-2359",2020-01-11,17,6,47,64
"11571","2300-2359",2020-01-12,17,7,71,88
"11572","2300-2359",2020-01-13,18,1,73,91
"11573","2300-2359",2020-01-14,17,2,64,81
"11574","2300-2359",2020-01-15,18,3,67,85
"11575","2300-2359",2020-01-16,18,4,72,90
"11576","2300-2359",2020-01-17,19,5,70,89
"11577","2300-2359",2020-01-18,15,6,45,60
"11578","2300-2359",2020-01-19,15,7,63,78
"11579","2300-2359",2020-01-20,16,1,72,88
"11580","2300-2359",2020-01-21,17,2,63,80
"11581","2300-2359",2020-01-22,18,3,67,85
"11582","2300-2359",2020-01-23,18,4,72,90
"11583","2300-2359",2020-01-24,19,5,70,89
"11584","2300-2359",2020-01-25,17,6,46,63
"11585","2300-2359",2020-01-26,16,7,70,86
"11586","2300-2359",2020-01-27,17,1,72,89
"11587","2300-2359",2020-01-28,16,2,63,79
"11588","2300-2359",2020-01-29,17,3,67,84
"11589","2300-2359",2020-01-30,17,4,72,89
"11590","2300-2359",2020-01-31,18,5,71,89
"11591","0001-0559",2020-02-01,13,6,47,60
"11592","0001-0559",2020-02-02,17,7,66,83
"11593","0001-0559",2020-02-03,23,1,69,92
"11594","0001-0559",2020-02-04,21,2,63,84
"11595","0001-0559",2020-02-05,21,3,65,86
"11596","0001-0559",2020-02-06,21,4,72,93
"11597","0001-0559",2020-02-07,21,5,71,92
"11598","0001-0559",2020-02-08,13,6,48,61
"11599","0001-0559",2020-02-09,17,7,68,85
"11600","0001-0559",2020-02-10,23,1,68,91
"11601","0001-0559",2020-02-11,23,2,62,85
"11602","0001-0559",2020-02-12,23,3,65,88
"11603","0001-0559",2020-02-13,25,4,70,95
"11604","0001-0559",2020-02-14,25,5,68,93
"11605","0001-0559",2020-02-15,15,6,46,61
"11606","0001-0559",2020-02-16,19,7,62,81
"11607","0001-0559",2020-02-17,23,1,64,87
"11608","0001-0559",2020-02-18,25,2,64,89
"11609","0001-0559",2020-02-19,25,3,67,92
"11610","0001-0559",2020-02-20,25,4,70,95
"11611","0001-0559",2020-02-21,25,5,67,92
"11612","0001-0559",2020-02-22,17,6,48,65
"11613","0001-0559",2020-02-23,19,7,67,86
"11614","0001-0559",2020-02-24,25,1,66,91
"11615","0001-0559",2020-02-25,25,2,63,88
"11616","0001-0559",2020-02-26,25,3,66,91
"11617","0001-0559",2020-02-27,25,4,69,94
"11618","0001-0559",2020-02-28,25,5,66,91
"11619","0001-0559",2020-02-29,16,6,48,64
"11620","0600-0659",2020-02-01,80,6,22,102
"11621","0600-0659",2020-02-02,76,7,19,95
"11622","0600-0659",2020-02-03,100,1,23,123
"11623","0600-0659",2020-02-04,98,2,22,120
"11624","0600-0659",2020-02-05,93,3,22,115
"11625","0600-0659",2020-02-06,100,4,23,123
"11626","0600-0659",2020-02-07,101,5,24,125
"11627","0600-0659",2020-02-08,80,6,22,102
"11628","0600-0659",2020-02-09,76,7,20,96
"11629","0600-0659",2020-02-10,103,1,24,127
"11630","0600-0659",2020-02-11,100,2,23,123
"11631","0600-0659",2020-02-12,95,3,22,117
"11632","0600-0659",2020-02-13,104,4,25,129
"11633","0600-0659",2020-02-14,103,5,26,129
"11634","0600-0659",2020-02-15,85,6,22,107
"11635","0600-0659",2020-02-16,82,7,19,101
"11636","0600-0659",2020-02-17,95,1,24,119
"11637","0600-0659",2020-02-18,101,2,24,125
"11638","0600-0659",2020-02-19,101,3,24,125
"11639","0600-0659",2020-02-20,104,4,25,129
"11640","0600-0659",2020-02-21,103,5,27,130
"11641","0600-0659",2020-02-22,86,6,24,110
"11642","0600-0659",2020-02-23,81,7,20,101
"11643","0600-0659",2020-02-24,103,1,25,128
"11644","0600-0659",2020-02-25,101,2,25,126
"11645","0600-0659",2020-02-26,102,3,25,127
"11646","0600-0659",2020-02-27,104,4,26,130
"11647","0600-0659",2020-02-28,103,5,28,131
"11648","0600-0659",2020-02-29,86,6,25,111
"11649","0700-0759",2020-02-01,79,6,39,118
"11650","0700-0759",2020-02-02,77,7,46,123
"11651","0700-0759",2020-02-03,95,1,52,147
"11652","0700-0759",2020-02-04,91,2,52,143
"11653","0700-0759",2020-02-05,89,3,49,138
"11654","0700-0759",2020-02-06,94,4,51,145
"11655","0700-0759",2020-02-07,96,5,52,148
"11656","0700-0759",2020-02-08,79,6,39,118
"11657","0700-0759",2020-02-09,79,7,45,124
"11658","0700-0759",2020-02-10,94,1,53,147
"11659","0700-0759",2020-02-11,88,2,52,140
"11660","0700-0759",2020-02-12,86,3,51,137
"11661","0700-0759",2020-02-13,94,4,58,152
"11662","0700-0759",2020-02-14,96,5,61,157
"11663","0700-0759",2020-02-15,83,6,46,129
"11664","0700-0759",2020-02-16,82,7,47,129
"11665","0700-0759",2020-02-17,95,1,59,154
"11666","0700-0759",2020-02-18,92,2,59,151
"11667","0700-0759",2020-02-19,92,3,59,151
"11668","0700-0759",2020-02-20,95,4,60,155
"11669","0700-0759",2020-02-21,97,5,60,157
"11670","0700-0759",2020-02-22,83,6,47,130
"11671","0700-0759",2020-02-23,88,7,49,137
"11672","0700-0759",2020-02-24,97,1,59,156
"11673","0700-0759",2020-02-25,91,2,59,150
"11674","0700-0759",2020-02-26,92,3,58,150
"11675","0700-0759",2020-02-27,95,4,60,155
"11676","0700-0759",2020-02-28,97,5,61,158
"11677","0700-0759",2020-02-29,84,6,47,131
"11678","0800-0859",2020-02-01,97,6,54,151
"11679","0800-0859",2020-02-02,105,7,45,150
"11680","0800-0859",2020-02-03,103,1,63,166
"11681","0800-0859",2020-02-04,98,2,60,158
"11682","0800-0859",2020-02-05,97,3,57,154
"11683","0800-0859",2020-02-06,105,4,61,166
"11684","0800-0859",2020-02-07,104,5,62,166
"11685","0800-0859",2020-02-08,99,6,54,153
"11686","0800-0859",2020-02-09,105,7,44,149
"11687","0800-0859",2020-02-10,106,1,63,169
"11688","0800-0859",2020-02-11,101,2,61,162
"11689","0800-0859",2020-02-12,101,3,58,159
"11690","0800-0859",2020-02-13,113,4,64,177
"11691","0800-0859",2020-02-14,113,5,63,176
"11692","0800-0859",2020-02-15,106,6,55,161
"11693","0800-0859",2020-02-16,107,7,51,158
"11694","0800-0859",2020-02-17,111,1,59,170
"11695","0800-0859",2020-02-18,111,2,61,172
"11696","0800-0859",2020-02-19,111,3,63,174
"11697","0800-0859",2020-02-20,115,4,63,178
"11698","0800-0859",2020-02-21,112,5,64,176
"11699","0800-0859",2020-02-22,106,6,56,162
"11700","0800-0859",2020-02-23,106,7,50,156
"11701","0800-0859",2020-02-24,110,1,64,174
"11702","0800-0859",2020-02-25,111,2,60,171
"11703","0800-0859",2020-02-26,110,3,63,173
"11704","0800-0859",2020-02-27,114,4,62,176
"11705","0800-0859",2020-02-28,111,5,62,173
"11706","0800-0859",2020-02-29,106,6,55,161
"11707","0900-0959",2020-02-01,78,6,51,129
"11708","0900-0959",2020-02-02,76,7,55,131
"11709","0900-0959",2020-02-03,83,1,62,145
"11710","0900-0959",2020-02-04,78,2,58,136
"11711","0900-0959",2020-02-05,79,3,58,137
"11712","0900-0959",2020-02-06,85,4,64,149
"11713","0900-0959",2020-02-07,85,5,64,149
"11714","0900-0959",2020-02-08,77,6,52,129
"11715","0900-0959",2020-02-09,78,7,57,135
"11716","0900-0959",2020-02-10,81,1,64,145
"11717","0900-0959",2020-02-11,75,2,58,133
"11718","0900-0959",2020-02-12,76,3,58,134
"11719","0900-0959",2020-02-13,81,4,66,147
"11720","0900-0959",2020-02-14,80,5,68,148
"11721","0900-0959",2020-02-15,74,6,60,134
"11722","0900-0959",2020-02-16,74,7,57,131
"11723","0900-0959",2020-02-17,77,1,63,140
"11724","0900-0959",2020-02-18,76,2,66,142
"11725","0900-0959",2020-02-19,79,3,66,145
"11726","0900-0959",2020-02-20,81,4,67,148
"11727","0900-0959",2020-02-21,80,5,68,148
"11728","0900-0959",2020-02-22,74,6,61,135
"11729","0900-0959",2020-02-23,78,7,58,136
"11730","0900-0959",2020-02-24,79,1,68,147
"11731","0900-0959",2020-02-25,76,2,67,143
"11732","0900-0959",2020-02-26,78,3,67,145
"11733","0900-0959",2020-02-27,81,4,69,150
"11734","0900-0959",2020-02-28,80,5,69,149
"11735","0900-0959",2020-02-29,74,6,62,136
"11736","1000-1059",2020-02-01,56,6,63,119
"11737","1000-1059",2020-02-02,68,7,63,131
"11738","1000-1059",2020-02-03,71,1,66,137
"11739","1000-1059",2020-02-04,62,2,62,124
"11740","1000-1059",2020-02-05,65,3,63,128
"11741","1000-1059",2020-02-06,71,4,66,137
"11742","1000-1059",2020-02-07,71,5,66,137
"11743","1000-1059",2020-02-08,57,6,62,119
"11744","1000-1059",2020-02-09,66,7,63,129
"11745","1000-1059",2020-02-10,73,1,68,141
"11746","1000-1059",2020-02-11,64,2,64,128
"11747","1000-1059",2020-02-12,67,3,65,132
"11748","1000-1059",2020-02-13,77,4,68,145
"11749","1000-1059",2020-02-14,77,5,65,142
"11750","1000-1059",2020-02-15,66,6,55,121
"11751","1000-1059",2020-02-16,69,7,62,131
"11752","1000-1059",2020-02-17,79,1,65,144
"11753","1000-1059",2020-02-18,71,2,63,134
"11754","1000-1059",2020-02-19,74,3,63,137
"11755","1000-1059",2020-02-20,77,4,67,144
"11756","1000-1059",2020-02-21,78,5,65,143
"11757","1000-1059",2020-02-22,65,6,55,120
"11758","1000-1059",2020-02-23,70,7,66,136
"11759","1000-1059",2020-02-24,78,1,65,143
"11760","1000-1059",2020-02-25,71,2,63,134
"11761","1000-1059",2020-02-26,74,3,63,137
"11762","1000-1059",2020-02-27,77,4,66,143
"11763","1000-1059",2020-02-28,78,5,65,143
"11764","1000-1059",2020-02-29,66,6,55,121
"11765","1100-1159",2020-02-01,72,6,56,128
"11766","1100-1159",2020-02-02,74,7,60,134
"11767","1100-1159",2020-02-03,74,1,62,136
"11768","1100-1159",2020-02-04,76,2,58,134
"11769","1100-1159",2020-02-05,75,3,55,130
"11770","1100-1159",2020-02-06,79,4,63,142
"11771","1100-1159",2020-02-07,78,5,63,141
"11772","1100-1159",2020-02-08,73,6,57,130
"11773","1100-1159",2020-02-09,80,7,61,141
"11774","1100-1159",2020-02-10,77,1,63,140
"11775","1100-1159",2020-02-11,75,2,58,133
"11776","1100-1159",2020-02-12,74,3,55,129
"11777","1100-1159",2020-02-13,76,4,58,134
"11778","1100-1159",2020-02-14,75,5,61,136
"11779","1100-1159",2020-02-15,65,6,60,125
"11780","1100-1159",2020-02-16,72,7,55,127
"11781","1100-1159",2020-02-17,76,1,62,138
"11782","1100-1159",2020-02-18,75,2,59,134
"11783","1100-1159",2020-02-19,75,3,59,134
"11784","1100-1159",2020-02-20,76,4,60,136
"11785","1100-1159",2020-02-21,74,5,61,135
"11786","1100-1159",2020-02-22,66,6,61,127
"11787","1100-1159",2020-02-23,79,7,57,136
"11788","1100-1159",2020-02-24,75,1,60,135
"11789","1100-1159",2020-02-25,75,2,59,134
"11790","1100-1159",2020-02-26,75,3,59,134
"11791","1100-1159",2020-02-27,76,4,60,136
"11792","1100-1159",2020-02-28,74,5,61,135
"11793","1100-1159",2020-02-29,65,6,61,126
"11794","1200-1259",2020-02-01,56,6,68,124
"11795","1200-1259",2020-02-02,67,7,70,137
"11796","1200-1259",2020-02-03,78,1,79,157
"11797","1200-1259",2020-02-04,74,2,74,148
"11798","1200-1259",2020-02-05,73,3,74,147
"11799","1200-1259",2020-02-06,78,4,79,157
"11800","1200-1259",2020-02-07,77,5,79,156
"11801","1200-1259",2020-02-08,57,6,69,126
"11802","1200-1259",2020-02-09,70,7,72,142
"11803","1200-1259",2020-02-10,80,1,76,156
"11804","1200-1259",2020-02-11,77,2,73,150
"11805","1200-1259",2020-02-12,76,3,73,149
"11806","1200-1259",2020-02-13,70,4,85,155
"11807","1200-1259",2020-02-14,69,5,83,152
"11808","1200-1259",2020-02-15,55,6,75,130
"11809","1200-1259",2020-02-16,58,7,80,138
"11810","1200-1259",2020-02-17,69,1,80,149
"11811","1200-1259",2020-02-18,69,2,80,149
"11812","1200-1259",2020-02-19,69,3,83,152
"11813","1200-1259",2020-02-20,71,4,85,156
"11814","1200-1259",2020-02-21,70,5,84,154
"11815","1200-1259",2020-02-22,56,6,73,129
"11816","1200-1259",2020-02-23,62,7,81,143
"11817","1200-1259",2020-02-24,70,1,83,153
"11818","1200-1259",2020-02-25,68,2,79,147
"11819","1200-1259",2020-02-26,68,3,82,150
"11820","1200-1259",2020-02-27,70,4,84,154
"11821","1200-1259",2020-02-28,69,5,83,152
"11822","1200-1259",2020-02-29,57,6,74,131
"11823","1300-1359",2020-02-01,63,6,57,120
"11824","1300-1359",2020-02-02,62,7,55,117
"11825","1300-1359",2020-02-03,69,1,63,132
"11826","1300-1359",2020-02-04,68,2,60,128
"11827","1300-1359",2020-02-05,70,3,64,134
"11828","1300-1359",2020-02-06,71,4,65,136
"11829","1300-1359",2020-02-07,71,5,64,135
"11830","1300-1359",2020-02-08,63,6,56,119
"11831","1300-1359",2020-02-09,68,7,56,124
"11832","1300-1359",2020-02-10,67,1,63,130
"11833","1300-1359",2020-02-11,66,2,58,124
"11834","1300-1359",2020-02-12,66,3,62,128
"11835","1300-1359",2020-02-13,78,4,66,144
"11836","1300-1359",2020-02-14,78,5,67,145
"11837","1300-1359",2020-02-15,68,6,60,128
"11838","1300-1359",2020-02-16,71,7,59,130
"11839","1300-1359",2020-02-17,77,1,66,143
"11840","1300-1359",2020-02-18,74,2,65,139
"11841","1300-1359",2020-02-19,75,3,65,140
"11842","1300-1359",2020-02-20,79,4,66,145
"11843","1300-1359",2020-02-21,79,5,67,146
"11844","1300-1359",2020-02-22,69,6,61,130
"11845","1300-1359",2020-02-23,77,7,63,140
"11846","1300-1359",2020-02-24,78,1,67,145
"11847","1300-1359",2020-02-25,74,2,65,139
"11848","1300-1359",2020-02-26,75,3,65,140
"11849","1300-1359",2020-02-27,79,4,66,145
"11850","1300-1359",2020-02-28,79,5,67,146
"11851","1300-1359",2020-02-29,68,6,60,128
"11852","1400-1459",2020-02-01,58,6,66,124
"11853","1400-1459",2020-02-02,65,7,72,137
"11854","1400-1459",2020-02-03,66,1,79,145
"11855","1400-1459",2020-02-04,65,2,78,143
"11856","1400-1459",2020-02-05,63,3,78,141
"11857","1400-1459",2020-02-06,65,4,80,145
"11858","1400-1459",2020-02-07,65,5,81,146
"11859","1400-1459",2020-02-08,58,6,66,124
"11860","1400-1459",2020-02-09,65,7,72,137
"11861","1400-1459",2020-02-10,66,1,80,146
"11862","1400-1459",2020-02-11,65,2,78,143
"11863","1400-1459",2020-02-12,65,3,77,142
"11864","1400-1459",2020-02-13,66,4,80,146
"11865","1400-1459",2020-02-14,64,5,80,144
"11866","1400-1459",2020-02-15,54,6,66,120
"11867","1400-1459",2020-02-16,67,7,68,135
"11868","1400-1459",2020-02-17,65,1,79,144
"11869","1400-1459",2020-02-18,65,2,76,141
"11870","1400-1459",2020-02-19,64,3,78,142
"11871","1400-1459",2020-02-20,65,4,81,146
"11872","1400-1459",2020-02-21,64,5,81,145
"11873","1400-1459",2020-02-22,56,6,65,121
"11874","1400-1459",2020-02-23,64,7,71,135
"11875","1400-1459",2020-02-24,65,1,81,146
"11876","1400-1459",2020-02-25,65,2,77,142
"11877","1400-1459",2020-02-26,64,3,79,143
"11878","1400-1459",2020-02-27,65,4,81,146
"11879","1400-1459",2020-02-28,64,5,81,145
"11880","1400-1459",2020-02-29,56,6,65,121
"11881","1500-1559",2020-02-01,58,6,75,133
"11882","1500-1559",2020-02-02,60,7,76,136
"11883","1500-1559",2020-02-03,72,1,79,151
"11884","1500-1559",2020-02-04,67,2,76,143
"11885","1500-1559",2020-02-05,72,3,76,148
"11886","1500-1559",2020-02-06,71,4,80,151
"11887","1500-1559",2020-02-07,72,5,80,152
"11888","1500-1559",2020-02-08,57,6,75,132
"11889","1500-1559",2020-02-09,67,7,82,149
"11890","1500-1559",2020-02-10,73,1,81,154
"11891","1500-1559",2020-02-11,68,2,77,145
"11892","1500-1559",2020-02-12,71,3,78,149
"11893","1500-1559",2020-02-13,78,4,79,157
"11894","1500-1559",2020-02-14,79,5,79,158
"11895","1500-1559",2020-02-15,66,6,67,133
"11896","1500-1559",2020-02-16,67,7,78,145
"11897","1500-1559",2020-02-17,79,1,77,156
"11898","1500-1559",2020-02-18,75,2,76,151
"11899","1500-1559",2020-02-19,77,3,78,155
"11900","1500-1559",2020-02-20,81,4,78,159
"11901","1500-1559",2020-02-21,82,5,78,160
"11902","1500-1559",2020-02-22,68,6,70,138
"11903","1500-1559",2020-02-23,76,7,80,156
"11904","1500-1559",2020-02-24,80,1,78,158
"11905","1500-1559",2020-02-25,75,2,75,150
"11906","1500-1559",2020-02-26,78,3,77,155
"11907","1500-1559",2020-02-27,80,4,78,158
"11908","1500-1559",2020-02-28,81,5,78,159
"11909","1500-1559",2020-02-29,67,6,70,137
"11910","1600-1659",2020-02-01,62,6,61,123
"11911","1600-1659",2020-02-02,71,7,70,141
"11912","1600-1659",2020-02-03,69,1,82,151
"11913","1600-1659",2020-02-04,65,2,79,144
"11914","1600-1659",2020-02-05,67,3,78,145
"11915","1600-1659",2020-02-06,70,4,81,151
"11916","1600-1659",2020-02-07,69,5,80,149
"11917","1600-1659",2020-02-08,63,6,61,124
"11918","1600-1659",2020-02-09,72,7,75,147
"11919","1600-1659",2020-02-10,67,1,81,148
"11920","1600-1659",2020-02-11,64,2,78,142
"11921","1600-1659",2020-02-12,67,3,76,143
"11922","1600-1659",2020-02-13,79,4,80,159
"11923","1600-1659",2020-02-14,76,5,78,154
"11924","1600-1659",2020-02-15,66,6,71,137
"11925","1600-1659",2020-02-16,75,7,64,139
"11926","1600-1659",2020-02-17,76,1,79,155
"11927","1600-1659",2020-02-18,74,2,77,151
"11928","1600-1659",2020-02-19,73,3,74,147
"11929","1600-1659",2020-02-20,77,4,80,157
"11930","1600-1659",2020-02-21,74,5,78,152
"11931","1600-1659",2020-02-22,65,6,71,136
"11932","1600-1659",2020-02-23,77,7,73,150
"11933","1600-1659",2020-02-24,75,1,79,154
"11934","1600-1659",2020-02-25,74,2,77,151
"11935","1600-1659",2020-02-26,72,3,74,146
"11936","1600-1659",2020-02-27,78,4,80,158
"11937","1600-1659",2020-02-28,75,5,78,153
"11938","1600-1659",2020-02-29,66,6,71,137
"11939","1700-1759",2020-02-01,68,6,52,120
"11940","1700-1759",2020-02-02,78,7,66,144
"11941","1700-1759",2020-02-03,89,1,73,162
"11942","1700-1759",2020-02-04,84,2,67,151
"11943","1700-1759",2020-02-05,87,3,72,159
"11944","1700-1759",2020-02-06,91,4,78,169
"11945","1700-1759",2020-02-07,90,5,77,167
"11946","1700-1759",2020-02-08,68,6,56,124
"11947","1700-1759",2020-02-09,85,7,75,160
"11948","1700-1759",2020-02-10,91,1,78,169
"11949","1700-1759",2020-02-11,86,2,71,157
"11950","1700-1759",2020-02-12,88,3,76,164
"11951","1700-1759",2020-02-13,86,4,85,171
"11952","1700-1759",2020-02-14,89,5,83,172
"11953","1700-1759",2020-02-15,69,6,58,127
"11954","1700-1759",2020-02-16,72,7,78,150
"11955","1700-1759",2020-02-17,84,1,85,169
"11956","1700-1759",2020-02-18,82,2,82,164
"11957","1700-1759",2020-02-19,85,3,86,171
"11958","1700-1759",2020-02-20,86,4,86,172
"11959","1700-1759",2020-02-21,89,5,83,172
"11960","1700-1759",2020-02-22,73,6,60,133
"11961","1700-1759",2020-02-23,81,7,81,162
"11962","1700-1759",2020-02-24,85,1,84,169
"11963","1700-1759",2020-02-25,82,2,81,163
"11964","1700-1759",2020-02-26,86,3,85,171
"11965","1700-1759",2020-02-27,86,4,85,171
"11966","1700-1759",2020-02-28,89,5,82,171
"11967","1700-1759",2020-02-29,73,6,60,133
"11968","1800-1859",2020-02-01,56,6,65,121
"11969","1800-1859",2020-02-02,69,7,76,145
"11970","1800-1859",2020-02-03,76,1,77,153
"11971","1800-1859",2020-02-04,66,2,73,139
"11972","1800-1859",2020-02-05,72,3,75,147
"11973","1800-1859",2020-02-06,78,4,75,153
"11974","1800-1859",2020-02-07,78,5,75,153
"11975","1800-1859",2020-02-08,58,6,66,124
"11976","1800-1859",2020-02-09,76,7,80,156
"11977","1800-1859",2020-02-10,76,1,76,152
"11978","1800-1859",2020-02-11,65,2,73,138
"11979","1800-1859",2020-02-12,73,3,73,146
"11980","1800-1859",2020-02-13,89,4,75,164
"11981","1800-1859",2020-02-14,85,5,73,158
"11982","1800-1859",2020-02-15,67,6,62,129
"11983","1800-1859",2020-02-16,81,7,72,153
"11984","1800-1859",2020-02-17,88,1,74,162
"11985","1800-1859",2020-02-18,82,2,73,155
"11986","1800-1859",2020-02-19,84,3,73,157
"11987","1800-1859",2020-02-20,89,4,75,164
"11988","1800-1859",2020-02-21,85,5,74,159
"11989","1800-1859",2020-02-22,68,6,63,131
"11990","1800-1859",2020-02-23,88,7,79,167
"11991","1800-1859",2020-02-24,88,1,74,162
"11992","1800-1859",2020-02-25,82,2,73,155
"11993","1800-1859",2020-02-26,83,3,74,157
"11994","1800-1859",2020-02-27,89,4,75,164
"11995","1800-1859",2020-02-28,85,5,75,160
"11996","1800-1859",2020-02-29,68,6,64,132
"11997","1900-1959",2020-02-01,64,6,65,129
"11998","1900-1959",2020-02-02,76,7,62,138
"11999","1900-1959",2020-02-03,82,1,80,162
"12000","1900-1959",2020-02-04,74,2,76,150
"12001","1900-1959",2020-02-05,75,3,77,152
"12002","1900-1959",2020-02-06,82,4,80,162
"12003","1900-1959",2020-02-07,82,5,78,160
"12004","1900-1959",2020-02-08,65,6,65,130
"12005","1900-1959",2020-02-09,81,7,67,148
"12006","1900-1959",2020-02-10,85,1,79,164
"12007","1900-1959",2020-02-11,76,2,75,151
"12008","1900-1959",2020-02-12,76,3,78,154
"12009","1900-1959",2020-02-13,82,4,83,165
"12010","1900-1959",2020-02-14,83,5,82,165
"12011","1900-1959",2020-02-15,65,6,69,134
"12012","1900-1959",2020-02-16,71,7,68,139
"12013","1900-1959",2020-02-17,81,1,83,164
"12014","1900-1959",2020-02-18,78,2,82,160
"12015","1900-1959",2020-02-19,77,3,82,159
"12016","1900-1959",2020-02-20,83,4,84,167
"12017","1900-1959",2020-02-21,84,5,83,167
"12018","1900-1959",2020-02-22,67,6,72,139
"12019","1900-1959",2020-02-23,78,7,72,150
"12020","1900-1959",2020-02-24,81,1,85,166
"12021","1900-1959",2020-02-25,77,2,83,160
"12022","1900-1959",2020-02-26,77,3,82,159
"12023","1900-1959",2020-02-27,83,4,84,167
"12024","1900-1959",2020-02-28,83,5,82,165
"12025","1900-1959",2020-02-29,67,6,71,138
"12026","2000-2059",2020-02-01,36,6,73,109
"12027","2000-2059",2020-02-02,52,7,85,137
"12028","2000-2059",2020-02-03,57,1,84,141
"12029","2000-2059",2020-02-04,53,2,77,130
"12030","2000-2059",2020-02-05,54,3,81,135
"12031","2000-2059",2020-02-06,55,4,85,140
"12032","2000-2059",2020-02-07,54,5,89,143
"12033","2000-2059",2020-02-08,36,6,74,110
"12034","2000-2059",2020-02-09,53,7,87,140
"12035","2000-2059",2020-02-10,53,1,84,137
"12036","2000-2059",2020-02-11,51,2,77,128
"12037","2000-2059",2020-02-12,51,3,84,135
"12038","2000-2059",2020-02-13,62,4,88,150
"12039","2000-2059",2020-02-14,64,5,89,153
"12040","2000-2059",2020-02-15,41,6,75,116
"12041","2000-2059",2020-02-16,55,7,82,137
"12042","2000-2059",2020-02-17,64,1,85,149
"12043","2000-2059",2020-02-18,56,2,85,141
"12044","2000-2059",2020-02-19,61,3,84,145
"12045","2000-2059",2020-02-20,62,4,86,148
"12046","2000-2059",2020-02-21,64,5,87,151
"12047","2000-2059",2020-02-22,43,6,76,119
"12048","2000-2059",2020-02-23,61,7,86,147
"12049","2000-2059",2020-02-24,64,1,84,148
"12050","2000-2059",2020-02-25,56,2,83,139
"12051","2000-2059",2020-02-26,60,3,83,143
"12052","2000-2059",2020-02-27,61,4,87,148
"12053","2000-2059",2020-02-28,64,5,88,152
"12054","2000-2059",2020-02-29,43,6,76,119
"12055","2100-2159",2020-02-01,32,6,63,95
"12056","2100-2159",2020-02-02,52,7,75,127
"12057","2100-2159",2020-02-03,66,1,80,146
"12058","2100-2159",2020-02-04,58,2,74,132
"12059","2100-2159",2020-02-05,61,3,75,136
"12060","2100-2159",2020-02-06,66,4,83,149
"12061","2100-2159",2020-02-07,66,5,82,148
"12062","2100-2159",2020-02-08,34,6,64,98
"12063","2100-2159",2020-02-09,58,7,81,139
"12064","2100-2159",2020-02-10,65,1,80,145
"12065","2100-2159",2020-02-11,57,2,73,130
"12066","2100-2159",2020-02-12,62,3,72,134
"12067","2100-2159",2020-02-13,60,4,90,150
"12068","2100-2159",2020-02-14,59,5,89,148
"12069","2100-2159",2020-02-15,29,6,74,103
"12070","2100-2159",2020-02-16,50,7,84,134
"12071","2100-2159",2020-02-17,56,1,88,144
"12072","2100-2159",2020-02-18,55,2,78,133
"12073","2100-2159",2020-02-19,58,3,82,140
"12074","2100-2159",2020-02-20,60,4,90,150
"12075","2100-2159",2020-02-21,59,5,89,148
"12076","2100-2159",2020-02-22,31,6,74,105
"12077","2100-2159",2020-02-23,54,7,89,143
"12078","2100-2159",2020-02-24,58,1,88,146
"12079","2100-2159",2020-02-25,57,2,78,135
"12080","2100-2159",2020-02-26,60,3,82,142
"12081","2100-2159",2020-02-27,62,4,90,152
"12082","2100-2159",2020-02-28,61,5,89,150
"12083","2100-2159",2020-02-29,33,6,75,108
"12084","2200-2259",2020-02-01,35,6,56,91
"12085","2200-2259",2020-02-02,45,7,77,122
"12086","2200-2259",2020-02-03,44,1,87,131
"12087","2200-2259",2020-02-04,38,2,80,118
"12088","2200-2259",2020-02-05,39,3,83,122
"12089","2200-2259",2020-02-06,45,4,86,131
"12090","2200-2259",2020-02-07,45,5,85,130
"12091","2200-2259",2020-02-08,35,6,56,91
"12092","2200-2259",2020-02-09,49,7,83,132
"12093","2200-2259",2020-02-10,44,1,86,130
"12094","2200-2259",2020-02-11,38,2,80,118
"12095","2200-2259",2020-02-12,40,3,82,122
"12096","2200-2259",2020-02-13,47,4,89,136
"12097","2200-2259",2020-02-14,48,5,91,139
"12098","2200-2259",2020-02-15,37,6,60,97
"12099","2200-2259",2020-02-16,47,7,75,122
"12100","2200-2259",2020-02-17,46,1,89,135
"12101","2200-2259",2020-02-18,45,2,85,130
"12102","2200-2259",2020-02-19,45,3,87,132
"12103","2200-2259",2020-02-20,47,4,89,136
"12104","2200-2259",2020-02-21,48,5,91,139
"12105","2200-2259",2020-02-22,39,6,64,103
"12106","2200-2259",2020-02-23,51,7,85,136
"12107","2200-2259",2020-02-24,46,1,89,135
"12108","2200-2259",2020-02-25,44,2,84,128
"12109","2200-2259",2020-02-26,44,3,87,131
"12110","2200-2259",2020-02-27,46,4,89,135
"12111","2200-2259",2020-02-28,47,5,91,138
"12112","2200-2259",2020-02-29,38,6,64,102
"12113","2300-2359",2020-02-01,16,6,46,62
"12114","2300-2359",2020-02-02,16,7,68,84
"12115","2300-2359",2020-02-03,17,1,74,91
"12116","2300-2359",2020-02-04,16,2,63,79
"12117","2300-2359",2020-02-05,17,3,67,84
"12118","2300-2359",2020-02-06,17,4,72,89
"12119","2300-2359",2020-02-07,18,5,71,89
"12120","2300-2359",2020-02-08,16,6,46,62
"12121","2300-2359",2020-02-09,16,7,73,89
"12122","2300-2359",2020-02-10,17,1,74,91
"12123","2300-2359",2020-02-11,16,2,64,80
"12124","2300-2359",2020-02-12,16,3,68,84
"12125","2300-2359",2020-02-13,23,4,81,104
"12126","2300-2359",2020-02-14,25,5,82,107
"12127","2300-2359",2020-02-15,22,6,52,74
"12128","2300-2359",2020-02-16,20,7,78,98
"12129","2300-2359",2020-02-17,21,1,81,102
"12130","2300-2359",2020-02-18,22,2,73,95
"12131","2300-2359",2020-02-19,23,3,75,98
"12132","2300-2359",2020-02-20,23,4,84,107
"12133","2300-2359",2020-02-21,25,5,85,110
"12134","2300-2359",2020-02-22,22,6,53,75
"12135","2300-2359",2020-02-23,22,7,85,107
"12136","2300-2359",2020-02-24,23,1,81,104
"12137","2300-2359",2020-02-25,22,2,75,97
"12138","2300-2359",2020-02-26,23,3,75,98
"12139","2300-2359",2020-02-27,23,4,83,106
"12140","2300-2359",2020-02-28,25,5,84,109
"12141","2300-2359",2020-02-29,22,6,52,74
"12142","0001-0559",2020-03-01,20,7,69,89
"12143","0001-0559",2020-03-02,25,1,68,93
"12144","0001-0559",2020-03-03,25,2,66,91
"12145","0001-0559",2020-03-04,25,3,68,93
"12146","0001-0559",2020-03-05,28,4,79,107
"12147","0001-0559",2020-03-06,29,5,78,107
"12148","0001-0559",2020-03-07,26,6,50,76
"12149","0001-0559",2020-03-08,25,7,83,108
"12150","0001-0559",2020-03-09,30,1,83,113
"12151","0001-0559",2020-03-10,30,2,80,110
"12152","0001-0559",2020-03-11,30,3,83,113
"12153","0001-0559",2020-03-12,30,4,88,118
"12154","0001-0559",2020-03-13,30,5,85,115
"12155","0001-0559",2020-03-14,31,6,56,87
"12156","0001-0559",2020-03-15,25,7,83,108
"12157","0001-0559",2020-03-16,29,1,84,113
"12158","0001-0559",2020-03-17,29,2,81,110
"12159","0001-0559",2020-03-18,29,3,82,111
"12160","0001-0559",2020-03-19,30,4,84,114
"12161","0001-0559",2020-03-20,30,5,81,111
"12162","0001-0559",2020-03-21,31,6,56,87
"12163","0001-0559",2020-03-22,26,7,79,105
"12164","0001-0559",2020-03-23,28,1,81,109
"12165","0001-0559",2020-03-24,27,2,78,105
"12166","0001-0559",2020-03-25,26,3,76,102
"12167","0001-0559",2020-03-26,26,4,82,108
"12168","0001-0559",2020-03-27,26,5,79,105
"12169","0001-0559",2020-03-28,30,6,56,86
"12170","0001-0559",2020-03-29,21,7,77,98
"12171","0001-0559",2020-03-30,24,1,73,97
"12172","0001-0559",2020-03-31,23,2,67,90
"12173","0600-0659",2020-03-01,81,7,21,102
"12174","0600-0659",2020-03-02,103,1,26,129
"12175","0600-0659",2020-03-03,101,2,25,126
"12176","0600-0659",2020-03-04,101,3,25,126
"12177","0600-0659",2020-03-05,102,4,29,131
"12178","0600-0659",2020-03-06,103,5,33,136
"12179","0600-0659",2020-03-07,89,6,36,125
"12180","0600-0659",2020-03-08,85,7,26,111
"12181","0600-0659",2020-03-09,104,1,36,140
"12182","0600-0659",2020-03-10,102,2,36,138
"12183","0600-0659",2020-03-11,102,3,34,136
"12184","0600-0659",2020-03-12,103,4,37,140
"12185","0600-0659",2020-03-13,100,5,37,137
"12186","0600-0659",2020-03-14,85,6,31,116
"12187","0600-0659",2020-03-15,86,7,30,116
"12188","0600-0659",2020-03-16,101,1,37,138
"12189","0600-0659",2020-03-17,99,2,37,136
"12190","0600-0659",2020-03-18,99,3,37,136
"12191","0600-0659",2020-03-19,99,4,39,138
"12192","0600-0659",2020-03-20,100,5,39,139
"12193","0600-0659",2020-03-21,85,6,34,119
"12194","0600-0659",2020-03-22,84,7,32,116
"12195","0600-0659",2020-03-23,100,1,39,139
"12196","0600-0659",2020-03-24,98,2,39,137
"12197","0600-0659",2020-03-25,95,3,38,133
"12198","0600-0659",2020-03-26,100,4,38,138
"12199","0600-0659",2020-03-27,98,5,38,136
"12200","0600-0659",2020-03-28,82,6,34,116
"12201","0600-0659",2020-03-29,81,7,27,108
"12202","0600-0659",2020-03-30,99,1,34,133
"12203","0600-0659",2020-03-31,96,2,29,125
"12204","0700-0759",2020-03-01,87,7,50,137
"12205","0700-0759",2020-03-02,97,1,60,157
"12206","0700-0759",2020-03-03,91,2,60,151
"12207","0700-0759",2020-03-04,92,3,58,150
"12208","0700-0759",2020-03-05,98,4,58,156
"12209","0700-0759",2020-03-06,98,5,60,158
"12210","0700-0759",2020-03-07,85,6,58,143
"12211","0700-0759",2020-03-08,86,7,49,135
"12212","0700-0759",2020-03-09,101,1,54,155
"12213","0700-0759",2020-03-10,97,2,53,150
"12214","0700-0759",2020-03-11,97,3,54,151
"12215","0700-0759",2020-03-12,99,4,59,158
"12216","0700-0759",2020-03-13,105,5,61,166
"12217","0700-0759",2020-03-14,83,6,58,141
"12218","0700-0759",2020-03-15,88,7,49,137
"12219","0700-0759",2020-03-16,104,1,54,158
"12220","0700-0759",2020-03-17,99,2,53,152
"12221","0700-0759",2020-03-18,100,3,54,154
"12222","0700-0759",2020-03-19,109,4,53,162
"12223","0700-0759",2020-03-20,111,5,59,170
"12224","0700-0759",2020-03-21,89,6,56,145
"12225","0700-0759",2020-03-22,96,7,48,144
"12226","0700-0759",2020-03-23,110,1,53,163
"12227","0700-0759",2020-03-24,106,2,53,159
"12228","0700-0759",2020-03-25,103,3,48,151
"12229","0700-0759",2020-03-26,105,4,52,157
"12230","0700-0759",2020-03-27,108,5,57,165
"12231","0700-0759",2020-03-28,89,6,54,143
"12232","0700-0759",2020-03-29,99,7,47,146
"12233","0700-0759",2020-03-30,107,1,53,160
"12234","0700-0759",2020-03-31,104,2,50,154
"12235","0800-0859",2020-03-01,107,7,48,155
"12236","0800-0859",2020-03-02,110,1,62,172
"12237","0800-0859",2020-03-03,111,2,60,171
"12238","0800-0859",2020-03-04,110,3,63,173
"12239","0800-0859",2020-03-05,110,4,63,173
"12240","0800-0859",2020-03-06,111,5,62,173
"12241","0800-0859",2020-03-07,108,6,58,166
"12242","0800-0859",2020-03-08,106,7,49,155
"12243","0800-0859",2020-03-09,105,1,68,173
"12244","0800-0859",2020-03-10,104,2,67,171
"12245","0800-0859",2020-03-11,105,3,67,172
"12246","0800-0859",2020-03-12,111,4,65,176
"12247","0800-0859",2020-03-13,109,5,67,176
"12248","0800-0859",2020-03-14,107,6,54,161
"12249","0800-0859",2020-03-15,106,7,53,159
"12250","0800-0859",2020-03-16,108,1,68,176
"12251","0800-0859",2020-03-17,107,2,67,174
"12252","0800-0859",2020-03-18,109,3,68,177
"12253","0800-0859",2020-03-19,107,4,72,179
"12254","0800-0859",2020-03-20,105,5,71,176
"12255","0800-0859",2020-03-21,103,6,58,161
"12256","0800-0859",2020-03-22,99,7,56,155
"12257","0800-0859",2020-03-23,104,1,70,174
"12258","0800-0859",2020-03-24,104,2,68,172
"12259","0800-0859",2020-03-25,105,3,69,174
"12260","0800-0859",2020-03-26,104,4,70,174
"12261","0800-0859",2020-03-27,103,5,67,170
"12262","0800-0859",2020-03-28,97,6,57,154
"12263","0800-0859",2020-03-29,92,7,56,148
"12264","0800-0859",2020-03-30,89,1,69,158
"12265","0800-0859",2020-03-31,89,2,69,158
"12266","0900-0959",2020-03-01,78,7,62,140
"12267","0900-0959",2020-03-02,79,1,69,148
"12268","0900-0959",2020-03-03,75,2,66,141
"12269","0900-0959",2020-03-04,78,3,66,144
"12270","0900-0959",2020-03-05,82,4,67,149
"12271","0900-0959",2020-03-06,81,5,67,148
"12272","0900-0959",2020-03-07,70,6,58,128
"12273","0900-0959",2020-03-08,83,7,66,149
"12274","0900-0959",2020-03-09,87,1,68,155
"12275","0900-0959",2020-03-10,85,2,67,152
"12276","0900-0959",2020-03-11,85,3,68,153
"12277","0900-0959",2020-03-12,89,4,68,157
"12278","0900-0959",2020-03-13,88,5,68,156
"12279","0900-0959",2020-03-14,74,6,60,134
"12280","0900-0959",2020-03-15,85,7,63,148
"12281","0900-0959",2020-03-16,88,1,69,157
"12282","0900-0959",2020-03-17,85,2,66,151
"12283","0900-0959",2020-03-18,85,3,68,153
"12284","0900-0959",2020-03-19,95,4,71,166
"12285","0900-0959",2020-03-20,93,5,71,164
"12286","0900-0959",2020-03-21,80,6,62,142
"12287","0900-0959",2020-03-22,88,7,64,152
"12288","0900-0959",2020-03-23,92,1,70,162
"12289","0900-0959",2020-03-24,91,2,66,157
"12290","0900-0959",2020-03-25,88,3,67,155
"12291","0900-0959",2020-03-26,92,4,68,160
"12292","0900-0959",2020-03-27,89,5,68,157
"12293","0900-0959",2020-03-28,78,6,62,140
"12294","0900-0959",2020-03-29,84,7,64,148
"12295","0900-0959",2020-03-30,83,1,66,149
"12296","0900-0959",2020-03-31,81,2,64,145
"12297","1000-1059",2020-03-01,69,7,64,133
"12298","1000-1059",2020-03-02,77,1,65,142
"12299","1000-1059",2020-03-03,70,2,63,133
"12300","1000-1059",2020-03-04,73,3,62,135
"12301","1000-1059",2020-03-05,74,4,65,139
"12302","1000-1059",2020-03-06,74,5,67,141
"12303","1000-1059",2020-03-07,62,6,63,125
"12304","1000-1059",2020-03-08,68,7,65,133
"12305","1000-1059",2020-03-09,71,1,65,136
"12306","1000-1059",2020-03-10,69,2,62,131
"12307","1000-1059",2020-03-11,72,3,61,133
"12308","1000-1059",2020-03-12,75,4,65,140
"12309","1000-1059",2020-03-13,74,5,67,141
"12310","1000-1059",2020-03-14,61,6,65,126
"12311","1000-1059",2020-03-15,70,7,65,135
"12312","1000-1059",2020-03-16,74,1,65,139
"12313","1000-1059",2020-03-17,71,2,63,134
"12314","1000-1059",2020-03-18,74,3,63,137
"12315","1000-1059",2020-03-19,71,4,65,136
"12316","1000-1059",2020-03-20,71,5,65,136
"12317","1000-1059",2020-03-21,57,6,64,121
"12318","1000-1059",2020-03-22,67,7,63,130
"12319","1000-1059",2020-03-23,70,1,64,134
"12320","1000-1059",2020-03-24,67,2,63,130
"12321","1000-1059",2020-03-25,68,3,60,128
"12322","1000-1059",2020-03-26,66,4,61,127
"12323","1000-1059",2020-03-27,66,5,62,128
"12324","1000-1059",2020-03-28,53,6,60,113
"12325","1000-1059",2020-03-29,61,7,60,121
"12326","1000-1059",2020-03-30,67,1,55,122
"12327","1000-1059",2020-03-31,66,2,54,120
"12328","1100-1159",2020-03-01,80,7,59,139
"12329","1100-1159",2020-03-02,76,1,62,138
"12330","1100-1159",2020-03-03,76,2,60,136
"12331","1100-1159",2020-03-04,75,3,59,134
"12332","1100-1159",2020-03-05,77,4,63,140
"12333","1100-1159",2020-03-06,76,5,63,139
"12334","1100-1159",2020-03-07,71,6,52,123
"12335","1100-1159",2020-03-08,78,7,66,144
"12336","1100-1159",2020-03-09,80,1,70,150
"12337","1100-1159",2020-03-10,78,2,68,146
"12338","1100-1159",2020-03-11,73,3,68,141
"12339","1100-1159",2020-03-12,79,4,69,148
"12340","1100-1159",2020-03-13,79,5,68,147
"12341","1100-1159",2020-03-14,77,6,59,136
"12342","1100-1159",2020-03-15,78,7,66,144
"12343","1100-1159",2020-03-16,79,1,68,147
"12344","1100-1159",2020-03-17,78,2,66,144
"12345","1100-1159",2020-03-18,75,3,66,141
"12346","1100-1159",2020-03-19,80,4,73,153
"12347","1100-1159",2020-03-20,81,5,73,154
"12348","1100-1159",2020-03-21,77,6,66,143
"12349","1100-1159",2020-03-22,79,7,70,149
"12350","1100-1159",2020-03-23,80,1,73,153
"12351","1100-1159",2020-03-24,77,2,72,149
"12352","1100-1159",2020-03-25,72,3,71,143
"12353","1100-1159",2020-03-26,74,4,70,144
"12354","1100-1159",2020-03-27,76,5,72,148
"12355","1100-1159",2020-03-28,74,6,62,136
"12356","1100-1159",2020-03-29,75,7,69,144
"12357","1100-1159",2020-03-30,69,1,71,140
"12358","1100-1159",2020-03-31,66,2,70,136
"12359","1200-1259",2020-03-01,62,7,79,141
"12360","1200-1259",2020-03-02,70,1,81,151
"12361","1200-1259",2020-03-03,68,2,78,146
"12362","1200-1259",2020-03-04,68,3,81,149
"12363","1200-1259",2020-03-05,73,4,77,150
"12364","1200-1259",2020-03-06,72,5,77,149
"12365","1200-1259",2020-03-07,54,6,75,129
"12366","1200-1259",2020-03-08,62,7,71,133
"12367","1200-1259",2020-03-09,66,1,77,143
"12368","1200-1259",2020-03-10,65,2,76,141
"12369","1200-1259",2020-03-11,66,3,76,142
"12370","1200-1259",2020-03-12,67,4,80,147
"12371","1200-1259",2020-03-13,68,5,81,149
"12372","1200-1259",2020-03-14,55,6,64,119
"12373","1200-1259",2020-03-15,62,7,72,134
"12374","1200-1259",2020-03-16,68,1,81,149
"12375","1200-1259",2020-03-17,66,2,79,145
"12376","1200-1259",2020-03-18,67,3,80,147
"12377","1200-1259",2020-03-19,68,4,79,147
"12378","1200-1259",2020-03-20,68,5,78,146
"12379","1200-1259",2020-03-21,53,6,60,113
"12380","1200-1259",2020-03-22,60,7,69,129
"12381","1200-1259",2020-03-23,67,1,78,145
"12382","1200-1259",2020-03-24,62,2,77,139
"12383","1200-1259",2020-03-25,59,3,73,132
"12384","1200-1259",2020-03-26,62,4,75,137
"12385","1200-1259",2020-03-27,63,5,73,136
"12386","1200-1259",2020-03-28,50,6,59,109
"12387","1200-1259",2020-03-29,54,7,59,113
"12388","1200-1259",2020-03-30,59,1,65,124
"12389","1200-1259",2020-03-31,59,2,64,123
"12390","1300-1359",2020-03-01,77,7,63,140
"12391","1300-1359",2020-03-02,78,1,67,145
"12392","1300-1359",2020-03-03,74,2,64,138
"12393","1300-1359",2020-03-04,77,3,66,143
"12394","1300-1359",2020-03-05,78,4,69,147
"12395","1300-1359",2020-03-06,77,5,70,147
"12396","1300-1359",2020-03-07,71,6,60,131
"12397","1300-1359",2020-03-08,77,7,60,137
"12398","1300-1359",2020-03-09,77,1,58,135
"12399","1300-1359",2020-03-10,73,2,57,130
"12400","1300-1359",2020-03-11,74,3,60,134
"12401","1300-1359",2020-03-12,73,4,58,131
"12402","1300-1359",2020-03-13,72,5,58,130
"12403","1300-1359",2020-03-14,69,6,61,130
"12404","1300-1359",2020-03-15,76,7,59,135
"12405","1300-1359",2020-03-16,75,1,57,132
"12406","1300-1359",2020-03-17,71,2,55,126
"12407","1300-1359",2020-03-18,71,3,56,127
"12408","1300-1359",2020-03-19,71,4,55,126
"12409","1300-1359",2020-03-20,68,5,57,125
"12410","1300-1359",2020-03-21,64,6,57,121
"12411","1300-1359",2020-03-22,73,7,57,130
"12412","1300-1359",2020-03-23,69,1,54,123
"12413","1300-1359",2020-03-24,65,2,51,116
"12414","1300-1359",2020-03-25,67,3,50,117
"12415","1300-1359",2020-03-26,71,4,49,120
"12416","1300-1359",2020-03-27,68,5,49,117
"12417","1300-1359",2020-03-28,63,6,53,116
"12418","1300-1359",2020-03-29,65,7,51,116
"12419","1300-1359",2020-03-30,60,1,45,105
"12420","1300-1359",2020-03-31,56,2,40,96
"12421","1400-1459",2020-03-01,64,7,70,134
"12422","1400-1459",2020-03-02,65,1,81,146
"12423","1400-1459",2020-03-03,64,2,76,140
"12424","1400-1459",2020-03-04,63,3,78,141
"12425","1400-1459",2020-03-05,61,4,80,141
"12426","1400-1459",2020-03-06,62,5,80,142
"12427","1400-1459",2020-03-07,51,6,71,122
"12428","1400-1459",2020-03-08,53,7,74,127
"12429","1400-1459",2020-03-09,51,1,83,134
"12430","1400-1459",2020-03-10,52,2,80,132
"12431","1400-1459",2020-03-11,53,3,80,133
"12432","1400-1459",2020-03-12,56,4,84,140
"12433","1400-1459",2020-03-13,56,5,84,140
"12434","1400-1459",2020-03-14,50,6,76,126
"12435","1400-1459",2020-03-15,55,7,76,131
"12436","1400-1459",2020-03-16,53,1,86,139
"12437","1400-1459",2020-03-17,52,2,83,135
"12438","1400-1459",2020-03-18,53,3,83,136
"12439","1400-1459",2020-03-19,56,4,86,142
"12440","1400-1459",2020-03-20,59,5,86,145
"12441","1400-1459",2020-03-21,54,6,77,131
"12442","1400-1459",2020-03-22,57,7,77,134
"12443","1400-1459",2020-03-23,56,1,87,143
"12444","1400-1459",2020-03-24,54,2,82,136
"12445","1400-1459",2020-03-25,55,3,79,134
"12446","1400-1459",2020-03-26,55,4,81,136
"12447","1400-1459",2020-03-27,57,5,81,138
"12448","1400-1459",2020-03-28,54,6,74,128
"12449","1400-1459",2020-03-29,55,7,72,127
"12450","1400-1459",2020-03-30,54,1,81,135
"12451","1400-1459",2020-03-31,50,2,81,131
"12452","1500-1559",2020-03-01,76,7,82,158
"12453","1500-1559",2020-03-02,79,1,79,158
"12454","1500-1559",2020-03-03,75,2,77,152
"12455","1500-1559",2020-03-04,77,3,79,156
"12456","1500-1559",2020-03-05,80,4,82,162
"12457","1500-1559",2020-03-06,78,5,81,159
"12458","1500-1559",2020-03-07,64,6,74,138
"12459","1500-1559",2020-03-08,82,7,77,159
"12460","1500-1559",2020-03-09,79,1,75,154
"12461","1500-1559",2020-03-10,76,2,75,151
"12462","1500-1559",2020-03-11,78,3,75,153
"12463","1500-1559",2020-03-12,83,4,71,154
"12464","1500-1559",2020-03-13,81,5,71,152
"12465","1500-1559",2020-03-14,77,6,67,144
"12466","1500-1559",2020-03-15,86,7,71,157
"12467","1500-1559",2020-03-16,84,1,71,155
"12468","1500-1559",2020-03-17,81,2,70,151
"12469","1500-1559",2020-03-18,82,3,69,151
"12470","1500-1559",2020-03-19,84,4,69,153
"12471","1500-1559",2020-03-20,82,5,69,151
"12472","1500-1559",2020-03-21,77,6,63,140
"12473","1500-1559",2020-03-22,85,7,69,154
"12474","1500-1559",2020-03-23,84,1,68,152
"12475","1500-1559",2020-03-24,80,2,67,147
"12476","1500-1559",2020-03-25,77,3,66,143
"12477","1500-1559",2020-03-26,77,4,68,145
"12478","1500-1559",2020-03-27,73,5,70,143
"12479","1500-1559",2020-03-28,68,6,60,128
"12480","1500-1559",2020-03-29,81,7,63,144
"12481","1500-1559",2020-03-30,72,1,65,137
"12482","1500-1559",2020-03-31,72,2,62,134
"12483","1600-1659",2020-03-01,77,7,72,149
"12484","1600-1659",2020-03-02,76,1,78,154
"12485","1600-1659",2020-03-03,74,2,76,150
"12486","1600-1659",2020-03-04,72,3,74,146
"12487","1600-1659",2020-03-05,77,4,82,159
"12488","1600-1659",2020-03-06,78,5,80,158
"12489","1600-1659",2020-03-07,76,6,68,144
"12490","1600-1659",2020-03-08,75,7,73,148
"12491","1600-1659",2020-03-09,73,1,81,154
"12492","1600-1659",2020-03-10,72,2,79,151
"12493","1600-1659",2020-03-11,71,3,76,147
"12494","1600-1659",2020-03-12,73,4,84,157
"12495","1600-1659",2020-03-13,70,5,81,151
"12496","1600-1659",2020-03-14,64,6,70,134
"12497","1600-1659",2020-03-15,73,7,78,151
"12498","1600-1659",2020-03-16,71,1,82,153
"12499","1600-1659",2020-03-17,71,2,79,150
"12500","1600-1659",2020-03-18,70,3,78,148
"12501","1600-1659",2020-03-19,74,4,84,158
"12502","1600-1659",2020-03-20,72,5,81,153
"12503","1600-1659",2020-03-21,62,6,68,130
"12504","1600-1659",2020-03-22,74,7,75,149
"12505","1600-1659",2020-03-23,71,1,80,151
"12506","1600-1659",2020-03-24,69,2,76,145
"12507","1600-1659",2020-03-25,68,3,78,146
"12508","1600-1659",2020-03-26,71,4,80,151
"12509","1600-1659",2020-03-27,69,5,76,145
"12510","1600-1659",2020-03-28,57,6,65,122
"12511","1600-1659",2020-03-29,67,7,73,140
"12512","1600-1659",2020-03-30,62,1,73,135
"12513","1600-1659",2020-03-31,58,2,70,128
"12514","1700-1759",2020-03-01,84,7,81,165
"12515","1700-1759",2020-03-02,86,1,84,170
"12516","1700-1759",2020-03-03,84,2,81,165
"12517","1700-1759",2020-03-04,86,3,85,171
"12518","1700-1759",2020-03-05,94,4,76,170
"12519","1700-1759",2020-03-06,92,5,75,167
"12520","1700-1759",2020-03-07,67,6,60,127
"12521","1700-1759",2020-03-08,86,7,80,166
"12522","1700-1759",2020-03-09,91,1,71,162
"12523","1700-1759",2020-03-10,84,2,68,152
"12524","1700-1759",2020-03-11,85,3,71,156
"12525","1700-1759",2020-03-12,92,4,75,167
"12526","1700-1759",2020-03-13,94,5,75,169
"12527","1700-1759",2020-03-14,74,6,65,139
"12528","1700-1759",2020-03-15,87,7,80,167
"12529","1700-1759",2020-03-16,90,1,75,165
"12530","1700-1759",2020-03-17,83,2,71,154
"12531","1700-1759",2020-03-18,87,3,74,161
"12532","1700-1759",2020-03-19,88,4,74,162
"12533","1700-1759",2020-03-20,88,5,75,163
"12534","1700-1759",2020-03-21,74,6,64,138
"12535","1700-1759",2020-03-22,81,7,80,161
"12536","1700-1759",2020-03-23,87,1,73,160
"12537","1700-1759",2020-03-24,78,2,66,144
"12538","1700-1759",2020-03-25,78,3,67,145
"12539","1700-1759",2020-03-26,82,4,71,153
"12540","1700-1759",2020-03-27,81,5,72,153
"12541","1700-1759",2020-03-28,67,6,60,127
"12542","1700-1759",2020-03-29,73,7,73,146
"12543","1700-1759",2020-03-30,76,1,61,137
"12544","1700-1759",2020-03-31,70,2,56,126
"12545","1800-1859",2020-03-01,84,7,80,164
"12546","1800-1859",2020-03-02,86,1,74,160
"12547","1800-1859",2020-03-03,80,2,73,153
"12548","1800-1859",2020-03-04,80,3,73,153
"12549","1800-1859",2020-03-05,84,4,84,168
"12550","1800-1859",2020-03-06,83,5,81,164
"12551","1800-1859",2020-03-07,73,6,63,136
"12552","1800-1859",2020-03-08,88,7,77,165
"12553","1800-1859",2020-03-09,85,1,81,166
"12554","1800-1859",2020-03-10,79,2,79,158
"12555","1800-1859",2020-03-11,82,3,79,161
"12556","1800-1859",2020-03-12,91,4,88,179
"12557","1800-1859",2020-03-13,89,5,84,173
"12558","1800-1859",2020-03-14,77,6,69,146
"12559","1800-1859",2020-03-15,94,7,85,179
"12560","1800-1859",2020-03-16,92,1,88,180
"12561","1800-1859",2020-03-17,87,2,87,174
"12562","1800-1859",2020-03-18,90,3,87,177
"12563","1800-1859",2020-03-19,94,4,90,184
"12564","1800-1859",2020-03-20,94,5,86,180
"12565","1800-1859",2020-03-21,80,6,72,152
"12566","1800-1859",2020-03-22,100,7,87,187
"12567","1800-1859",2020-03-23,94,1,89,183
"12568","1800-1859",2020-03-24,89,2,87,176
"12569","1800-1859",2020-03-25,88,3,83,171
"12570","1800-1859",2020-03-26,90,4,82,172
"12571","1800-1859",2020-03-27,89,5,78,167
"12572","1800-1859",2020-03-28,79,6,65,144
"12573","1800-1859",2020-03-29,95,7,80,175
"12574","1800-1859",2020-03-30,85,1,82,167
"12575","1800-1859",2020-03-31,73,2,82,155
"12576","1900-1959",2020-03-01,80,7,72,152
"12577","1900-1959",2020-03-02,82,1,86,168
"12578","1900-1959",2020-03-03,77,2,84,161
"12579","1900-1959",2020-03-04,80,3,84,164
"12580","1900-1959",2020-03-05,92,4,86,178
"12581","1900-1959",2020-03-06,89,5,83,172
"12582","1900-1959",2020-03-07,68,6,75,143
"12583","1900-1959",2020-03-08,78,7,84,162
"12584","1900-1959",2020-03-09,84,1,81,165
"12585","1900-1959",2020-03-10,81,2,80,161
"12586","1900-1959",2020-03-11,83,3,78,161
"12587","1900-1959",2020-03-12,87,4,77,164
"12588","1900-1959",2020-03-13,86,5,76,162
"12589","1900-1959",2020-03-14,64,6,71,135
"12590","1900-1959",2020-03-15,79,7,79,158
"12591","1900-1959",2020-03-16,86,1,74,160
"12592","1900-1959",2020-03-17,84,2,74,158
"12593","1900-1959",2020-03-18,87,3,73,160
"12594","1900-1959",2020-03-19,86,4,76,162
"12595","1900-1959",2020-03-20,83,5,74,157
"12596","1900-1959",2020-03-21,65,6,72,137
"12597","1900-1959",2020-03-22,77,7,79,156
"12598","1900-1959",2020-03-23,85,1,76,161
"12599","1900-1959",2020-03-24,81,2,74,155
"12600","1900-1959",2020-03-25,83,3,73,156
"12601","1900-1959",2020-03-26,83,4,73,156
"12602","1900-1959",2020-03-27,80,5,70,150
"12603","1900-1959",2020-03-28,62,6,70,132
"12604","1900-1959",2020-03-29,67,7,73,140
"12605","1900-1959",2020-03-30,77,1,67,144
"12606","1900-1959",2020-03-31,73,2,61,134
"12607","2000-2059",2020-03-01,58,7,87,145
"12608","2000-2059",2020-03-02,63,1,84,147
"12609","2000-2059",2020-03-03,56,2,83,139
"12610","2000-2059",2020-03-04,59,3,83,142
"12611","2000-2059",2020-03-05,53,4,85,138
"12612","2000-2059",2020-03-06,57,5,88,145
"12613","2000-2059",2020-03-07,51,6,71,122
"12614","2000-2059",2020-03-08,67,7,78,145
"12615","2000-2059",2020-03-09,64,1,83,147
"12616","2000-2059",2020-03-10,57,2,78,135
"12617","2000-2059",2020-03-11,62,3,81,143
"12618","2000-2059",2020-03-12,63,4,84,147
"12619","2000-2059",2020-03-13,67,5,87,154
"12620","2000-2059",2020-03-14,52,6,71,123
"12621","2000-2059",2020-03-15,67,7,77,144
"12622","2000-2059",2020-03-16,64,1,84,148
"12623","2000-2059",2020-03-17,57,2,80,137
"12624","2000-2059",2020-03-18,60,3,84,144
"12625","2000-2059",2020-03-19,64,4,84,148
"12626","2000-2059",2020-03-20,68,5,88,156
"12627","2000-2059",2020-03-21,58,6,70,128
"12628","2000-2059",2020-03-22,69,7,76,145
"12629","2000-2059",2020-03-23,67,1,83,150
"12630","2000-2059",2020-03-24,60,2,78,138
"12631","2000-2059",2020-03-25,61,3,78,139
"12632","2000-2059",2020-03-26,63,4,81,144
"12633","2000-2059",2020-03-27,66,5,86,152
"12634","2000-2059",2020-03-28,61,6,66,127
"12635","2000-2059",2020-03-29,70,7,77,147
"12636","2000-2059",2020-03-30,68,1,81,149
"12637","2000-2059",2020-03-31,59,2,76,135
"12638","2100-2159",2020-03-01,56,7,88,144
"12639","2100-2159",2020-03-02,60,1,87,147
"12640","2100-2159",2020-03-03,57,2,77,134
"12641","2100-2159",2020-03-04,59,3,82,141
"12642","2100-2159",2020-03-05,63,4,83,146
"12643","2100-2159",2020-03-06,61,5,82,143
"12644","2100-2159",2020-03-07,54,6,72,126
"12645","2100-2159",2020-03-08,62,7,94,156
"12646","2100-2159",2020-03-09,64,1,91,155
"12647","2100-2159",2020-03-10,61,2,83,144
"12648","2100-2159",2020-03-11,63,3,87,150
"12649","2100-2159",2020-03-12,67,4,94,161
"12650","2100-2159",2020-03-13,65,5,92,157
"12651","2100-2159",2020-03-14,49,6,76,125
"12652","2100-2159",2020-03-15,62,7,99,161
"12653","2100-2159",2020-03-16,64,1,94,158
"12654","2100-2159",2020-03-17,60,2,87,147
"12655","2100-2159",2020-03-18,62,3,91,153
"12656","2100-2159",2020-03-19,66,4,97,163
"12657","2100-2159",2020-03-20,65,5,96,161
"12658","2100-2159",2020-03-21,53,6,80,133
"12659","2100-2159",2020-03-22,61,7,100,161
"12660","2100-2159",2020-03-23,63,1,95,158
"12661","2100-2159",2020-03-24,60,2,87,147
"12662","2100-2159",2020-03-25,58,3,91,149
"12663","2100-2159",2020-03-26,62,4,94,156
"12664","2100-2159",2020-03-27,63,5,91,154
"12665","2100-2159",2020-03-28,53,6,81,134
"12666","2100-2159",2020-03-29,59,7,90,149
"12667","2100-2159",2020-03-30,55,1,80,135
"12668","2100-2159",2020-03-31,49,2,76,125
"12669","2200-2259",2020-03-01,50,7,86,136
"12670","2200-2259",2020-03-02,45,1,89,134
"12671","2200-2259",2020-03-03,44,2,84,128
"12672","2200-2259",2020-03-04,44,3,83,127
"12673","2200-2259",2020-03-05,46,4,91,137
"12674","2200-2259",2020-03-06,50,5,92,142
"12675","2200-2259",2020-03-07,31,6,71,102
"12676","2200-2259",2020-03-08,49,7,84,133
"12677","2200-2259",2020-03-09,54,1,84,138
"12678","2200-2259",2020-03-10,51,2,81,132
"12679","2200-2259",2020-03-11,52,3,82,134
"12680","2200-2259",2020-03-12,57,4,84,141
"12681","2200-2259",2020-03-13,60,5,86,146
"12682","2200-2259",2020-03-14,40,6,70,110
"12683","2200-2259",2020-03-15,52,7,82,134
"12684","2200-2259",2020-03-16,56,1,82,138
"12685","2200-2259",2020-03-17,53,2,77,130
"12686","2200-2259",2020-03-18,54,3,77,131
"12687","2200-2259",2020-03-19,57,4,85,142
"12688","2200-2259",2020-03-20,60,5,85,145
"12689","2200-2259",2020-03-21,39,6,76,115
"12690","2200-2259",2020-03-22,51,7,85,136
"12691","2200-2259",2020-03-23,56,1,85,141
"12692","2200-2259",2020-03-24,52,2,77,129
"12693","2200-2259",2020-03-25,52,3,74,126
"12694","2200-2259",2020-03-26,56,4,81,137
"12695","2200-2259",2020-03-27,59,5,80,139
"12696","2200-2259",2020-03-28,38,6,75,113
"12697","2200-2259",2020-03-29,54,7,73,127
"12698","2200-2259",2020-03-30,57,1,76,133
"12699","2200-2259",2020-03-31,48,2,66,114
"12700","2300-2359",2020-03-01,22,7,79,101
"12701","2300-2359",2020-03-02,23,1,78,101
"12702","2300-2359",2020-03-03,22,2,71,93
"12703","2300-2359",2020-03-04,21,3,71,92
"12704","2300-2359",2020-03-05,25,4,78,103
"12705","2300-2359",2020-03-06,26,5,78,104
"12706","2300-2359",2020-03-07,20,6,56,76
"12707","2300-2359",2020-03-08,20,7,74,94
"12708","2300-2359",2020-03-09,20,1,77,97
"12709","2300-2359",2020-03-10,20,2,67,87
"12710","2300-2359",2020-03-11,21,3,74,95
"12711","2300-2359",2020-03-12,21,4,86,107
"12712","2300-2359",2020-03-13,22,5,87,109
"12713","2300-2359",2020-03-14,19,6,65,84
"12714","2300-2359",2020-03-15,20,7,84,104
"12715","2300-2359",2020-03-16,19,1,86,105
"12716","2300-2359",2020-03-17,19,2,77,96
"12717","2300-2359",2020-03-18,21,3,85,106
"12718","2300-2359",2020-03-19,21,4,84,105
"12719","2300-2359",2020-03-20,22,5,86,108
"12720","2300-2359",2020-03-21,19,6,65,84
"12721","2300-2359",2020-03-22,20,7,81,101
"12722","2300-2359",2020-03-23,19,1,84,103
"12723","2300-2359",2020-03-24,19,2,78,97
"12724","2300-2359",2020-03-25,19,3,81,100
"12725","2300-2359",2020-03-26,19,4,82,101
"12726","2300-2359",2020-03-27,20,5,85,105
"12727","2300-2359",2020-03-28,21,6,63,84
"12728","2300-2359",2020-03-29,18,7,87,105
"12729","2300-2359",2020-03-30,18,1,84,102
"12730","2300-2359",2020-03-31,17,2,72,89
"12731","0001-0559",2020-04-01,20,3,62,82
"12732","0001-0559",2020-04-02,19,4,57,76
"12733","0001-0559",2020-04-03,18,5,55,73
"12734","0001-0559",2020-04-04,19,6,38,57
"12735","0001-0559",2020-04-05,15,7,48,63
"12736","0001-0559",2020-04-06,18,1,46,64
"12737","0001-0559",2020-04-07,15,2,39,54
"12738","0001-0559",2020-04-08,14,3,37,51
"12739","0001-0559",2020-04-09,14,4,35,49
"12740","0001-0559",2020-04-10,14,5,32,46
"12741","0001-0559",2020-04-11,17,6,21,38
"12742","0001-0559",2020-04-12,8,7,26,34
"12743","0001-0559",2020-04-13,10,1,27,37
"12744","0001-0559",2020-04-14,8,2,16,24
"12745","0001-0559",2020-04-15,8,3,17,25
"12746","0001-0559",2020-04-16,8,4,14,22
"12747","0001-0559",2020-04-17,8,5,15,23
"12748","0001-0559",2020-04-18,4,6,10,14
"12749","0001-0559",2020-04-19,3,7,17,20
"12750","0001-0559",2020-04-20,7,1,13,20
"12751","0001-0559",2020-04-21,7,2,14,21
"12752","0001-0559",2020-04-22,7,3,16,23
"12753","0001-0559",2020-04-23,7,4,13,20
"12754","0001-0559",2020-04-24,7,5,16,23
"12755","0001-0559",2020-04-25,5,6,7,12
"12756","0001-0559",2020-04-26,3,7,17,20
"12757","0001-0559",2020-04-27,7,1,15,22
"12758","0001-0559",2020-04-28,7,2,15,22
"12759","0001-0559",2020-04-29,7,3,15,22
"12760","0001-0559",2020-04-30,7,4,14,21
"12761","0600-0659",2020-04-01,73,3,21,94
"12762","0600-0659",2020-04-02,72,4,21,93
"12763","0600-0659",2020-04-03,73,5,23,96
"12764","0600-0659",2020-04-04,56,6,15,71
"12765","0600-0659",2020-04-05,64,7,15,79
"12766","0600-0659",2020-04-06,68,1,18,86
"12767","0600-0659",2020-04-07,55,2,17,72
"12768","0600-0659",2020-04-08,47,3,14,61
"12769","0600-0659",2020-04-09,47,4,14,61
"12770","0600-0659",2020-04-10,43,5,14,57
"12771","0600-0659",2020-04-11,31,6,9,40
"12772","0600-0659",2020-04-12,33,7,7,40
"12773","0600-0659",2020-04-13,37,1,11,48
"12774","0600-0659",2020-04-14,25,2,5,30
"12775","0600-0659",2020-04-15,25,3,5,30
"12776","0600-0659",2020-04-16,24,4,6,30
"12777","0600-0659",2020-04-17,24,5,5,29
"12778","0600-0659",2020-04-18,21,6,4,25
"12779","0600-0659",2020-04-19,22,7,5,27
"12780","0600-0659",2020-04-20,22,1,4,26
"12781","0600-0659",2020-04-21,22,2,6,28
"12782","0600-0659",2020-04-22,22,3,5,27
"12783","0600-0659",2020-04-23,23,4,6,29
"12784","0600-0659",2020-04-24,23,5,5,28
"12785","0600-0659",2020-04-25,21,6,4,25
"12786","0600-0659",2020-04-26,22,7,5,27
"12787","0600-0659",2020-04-27,22,1,5,27
"12788","0600-0659",2020-04-28,22,2,4,26
"12789","0600-0659",2020-04-29,22,3,6,28
"12790","0600-0659",2020-04-30,23,4,6,29
"12791","0700-0759",2020-04-01,88,3,44,132
"12792","0700-0759",2020-04-02,81,4,45,126
"12793","0700-0759",2020-04-03,82,5,48,130
"12794","0700-0759",2020-04-04,69,6,44,113
"12795","0700-0759",2020-04-05,75,7,42,117
"12796","0700-0759",2020-04-06,77,1,46,123
"12797","0700-0759",2020-04-07,52,2,35,87
"12798","0700-0759",2020-04-08,41,3,26,67
"12799","0700-0759",2020-04-09,40,4,27,67
"12800","0700-0759",2020-04-10,34,5,24,58
"12801","0700-0759",2020-04-11,26,6,24,50
"12802","0700-0759",2020-04-12,21,7,23,44
"12803","0700-0759",2020-04-13,28,1,22,50
"12804","0700-0759",2020-04-14,19,2,20,39
"12805","0700-0759",2020-04-15,19,3,19,38
"12806","0700-0759",2020-04-16,20,4,19,39
"12807","0700-0759",2020-04-17,21,5,18,39
"12808","0700-0759",2020-04-18,17,6,12,29
"12809","0700-0759",2020-04-19,15,7,15,30
"12810","0700-0759",2020-04-20,20,1,17,37
"12811","0700-0759",2020-04-21,19,2,17,36
"12812","0700-0759",2020-04-22,18,3,17,35
"12813","0700-0759",2020-04-23,18,4,18,36
"12814","0700-0759",2020-04-24,19,5,16,35
"12815","0700-0759",2020-04-25,16,6,10,26
"12816","0700-0759",2020-04-26,17,7,15,32
"12817","0700-0759",2020-04-27,18,1,16,34
"12818","0700-0759",2020-04-28,19,2,17,36
"12819","0700-0759",2020-04-29,19,3,17,36
"12820","0700-0759",2020-04-30,18,4,18,36
"12821","0800-0859",2020-04-01,77,3,52,129
"12822","0800-0859",2020-04-02,81,4,47,128
"12823","0800-0859",2020-04-03,79,5,47,126
"12824","0800-0859",2020-04-04,75,6,36,111
"12825","0800-0859",2020-04-05,79,7,41,120
"12826","0800-0859",2020-04-06,77,1,46,123
"12827","0800-0859",2020-04-07,58,2,33,91
"12828","0800-0859",2020-04-08,46,3,27,73
"12829","0800-0859",2020-04-09,44,4,25,69
"12830","0800-0859",2020-04-10,47,5,24,71
"12831","0800-0859",2020-04-11,46,6,14,60
"12832","0800-0859",2020-04-12,43,7,12,55
"12833","0800-0859",2020-04-13,44,1,22,66
"12834","0800-0859",2020-04-14,46,2,11,57
"12835","0800-0859",2020-04-15,42,3,10,52
"12836","0800-0859",2020-04-16,44,4,10,54
"12837","0800-0859",2020-04-17,40,5,12,52
"12838","0800-0859",2020-04-18,36,6,15,51
"12839","0800-0859",2020-04-19,39,7,13,52
"12840","0800-0859",2020-04-20,42,1,11,53
"12841","0800-0859",2020-04-21,41,2,11,52
"12842","0800-0859",2020-04-22,40,3,9,49
"12843","0800-0859",2020-04-23,43,4,10,53
"12844","0800-0859",2020-04-24,40,5,11,51
"12845","0800-0859",2020-04-25,34,6,15,49
"12846","0800-0859",2020-04-26,37,7,13,50
"12847","0800-0859",2020-04-27,39,1,10,49
"12848","0800-0859",2020-04-28,37,2,10,47
"12849","0800-0859",2020-04-29,37,3,9,46
"12850","0800-0859",2020-04-30,38,4,9,47
"12851","0900-0959",2020-04-01,68,3,50,118
"12852","0900-0959",2020-04-02,67,4,46,113
"12853","0900-0959",2020-04-03,67,5,45,112
"12854","0900-0959",2020-04-04,55,6,40,95
"12855","0900-0959",2020-04-05,61,7,46,107
"12856","0900-0959",2020-04-06,63,1,44,107
"12857","0900-0959",2020-04-07,48,2,29,77
"12858","0900-0959",2020-04-08,38,3,25,63
"12859","0900-0959",2020-04-09,35,4,26,61
"12860","0900-0959",2020-04-10,34,5,23,57
"12861","0900-0959",2020-04-11,25,6,18,43
"12862","0900-0959",2020-04-12,28,7,22,50
"12863","0900-0959",2020-04-13,33,1,21,54
"12864","0900-0959",2020-04-14,24,2,21,45
"12865","0900-0959",2020-04-15,21,3,21,42
"12866","0900-0959",2020-04-16,20,4,21,41
"12867","0900-0959",2020-04-17,21,5,21,42
"12868","0900-0959",2020-04-18,18,6,13,31
"12869","0900-0959",2020-04-19,17,7,14,31
"12870","0900-0959",2020-04-20,21,1,20,41
"12871","0900-0959",2020-04-21,21,2,20,41
"12872","0900-0959",2020-04-22,20,3,19,39
"12873","0900-0959",2020-04-23,20,4,20,40
"12874","0900-0959",2020-04-24,21,5,21,42
"12875","0900-0959",2020-04-25,19,6,13,32
"12876","0900-0959",2020-04-26,17,7,14,31
"12877","0900-0959",2020-04-27,20,1,20,40
"12878","0900-0959",2020-04-28,20,2,20,40
"12879","0900-0959",2020-04-29,19,3,20,39
"12880","0900-0959",2020-04-30,20,4,19,39
"12881","1000-1059",2020-04-01,58,3,42,100
"12882","1000-1059",2020-04-02,57,4,45,102
"12883","1000-1059",2020-04-03,55,5,45,100
"12884","1000-1059",2020-04-04,45,6,43,88
"12885","1000-1059",2020-04-05,49,7,42,91
"12886","1000-1059",2020-04-06,53,1,42,95
"12887","1000-1059",2020-04-07,38,2,29,67
"12888","1000-1059",2020-04-08,30,3,25,55
"12889","1000-1059",2020-04-09,29,4,26,55
"12890","1000-1059",2020-04-10,29,5,27,56
"12891","1000-1059",2020-04-11,24,6,29,53
"12892","1000-1059",2020-04-12,22,7,23,45
"12893","1000-1059",2020-04-13,24,1,23,47
"12894","1000-1059",2020-04-14,20,2,15,35
"12895","1000-1059",2020-04-15,20,3,15,35
"12896","1000-1059",2020-04-16,21,4,13,34
"12897","1000-1059",2020-04-17,22,5,12,34
"12898","1000-1059",2020-04-18,14,6,19,33
"12899","1000-1059",2020-04-19,13,7,12,25
"12900","1000-1059",2020-04-20,16,1,13,29
"12901","1000-1059",2020-04-21,16,2,14,30
"12902","1000-1059",2020-04-22,16,3,13,29
"12903","1000-1059",2020-04-23,17,4,14,31
"12904","1000-1059",2020-04-24,19,5,12,31
"12905","1000-1059",2020-04-25,14,6,17,31
"12906","1000-1059",2020-04-26,13,7,13,26
"12907","1000-1059",2020-04-27,17,1,13,30
"12908","1000-1059",2020-04-28,16,2,12,28
"12909","1000-1059",2020-04-29,15,3,12,27
"12910","1000-1059",2020-04-30,16,4,12,28
"12911","1100-1159",2020-04-01,53,3,63,116
"12912","1100-1159",2020-04-02,56,4,69,125
"12913","1100-1159",2020-04-03,58,5,67,125
"12914","1100-1159",2020-04-04,53,6,59,112
"12915","1100-1159",2020-04-05,56,7,64,120
"12916","1100-1159",2020-04-06,59,1,65,124
"12917","1100-1159",2020-04-07,43,2,51,94
"12918","1100-1159",2020-04-08,37,3,37,74
"12919","1100-1159",2020-04-09,37,4,35,72
"12920","1100-1159",2020-04-10,37,5,34,71
"12921","1100-1159",2020-04-11,30,6,28,58
"12922","1100-1159",2020-04-12,28,7,28,56
"12923","1100-1159",2020-04-13,30,1,29,59
"12924","1100-1159",2020-04-14,30,2,28,58
"12925","1100-1159",2020-04-15,29,3,26,55
"12926","1100-1159",2020-04-16,28,4,27,55
"12927","1100-1159",2020-04-17,28,5,26,54
"12928","1100-1159",2020-04-18,24,6,22,46
"12929","1100-1159",2020-04-19,24,7,18,42
"12930","1100-1159",2020-04-20,30,1,23,53
"12931","1100-1159",2020-04-21,28,2,24,52
"12932","1100-1159",2020-04-22,28,3,23,51
"12933","1100-1159",2020-04-23,29,4,23,52
"12934","1100-1159",2020-04-24,29,5,22,51
"12935","1100-1159",2020-04-25,24,6,21,45
"12936","1100-1159",2020-04-26,26,7,18,44
"12937","1100-1159",2020-04-27,28,1,22,50
"12938","1100-1159",2020-04-28,27,2,22,49
"12939","1100-1159",2020-04-29,28,3,21,49
"12940","1100-1159",2020-04-30,27,4,22,49
"12941","1200-1259",2020-04-01,47,3,57,104
"12942","1200-1259",2020-04-02,42,4,54,96
"12943","1200-1259",2020-04-03,42,5,54,96
"12944","1200-1259",2020-04-04,35,6,43,78
"12945","1200-1259",2020-04-05,37,7,47,84
"12946","1200-1259",2020-04-06,39,1,52,91
"12947","1200-1259",2020-04-07,32,2,42,74
"12948","1200-1259",2020-04-08,27,3,37,64
"12949","1200-1259",2020-04-09,26,4,35,61
"12950","1200-1259",2020-04-10,31,5,35,66
"12951","1200-1259",2020-04-11,25,6,25,50
"12952","1200-1259",2020-04-12,23,7,24,47
"12953","1200-1259",2020-04-13,26,1,32,58
"12954","1200-1259",2020-04-14,26,2,24,50
"12955","1200-1259",2020-04-15,24,3,22,46
"12956","1200-1259",2020-04-16,25,4,23,48
"12957","1200-1259",2020-04-17,27,5,22,49
"12958","1200-1259",2020-04-18,17,6,17,34
"12959","1200-1259",2020-04-19,19,7,18,37
"12960","1200-1259",2020-04-20,24,1,23,47
"12961","1200-1259",2020-04-21,24,2,22,46
"12962","1200-1259",2020-04-22,24,3,22,46
"12963","1200-1259",2020-04-23,23,4,23,46
"12964","1200-1259",2020-04-24,23,5,24,47
"12965","1200-1259",2020-04-25,18,6,19,37
"12966","1200-1259",2020-04-26,19,7,19,38
"12967","1200-1259",2020-04-27,24,1,23,47
"12968","1200-1259",2020-04-28,24,2,22,46
"12969","1200-1259",2020-04-29,23,3,24,47
"12970","1200-1259",2020-04-30,23,4,23,46
"12971","1300-1359",2020-04-01,53,3,39,92
"12972","1300-1359",2020-04-02,54,4,40,94
"12973","1300-1359",2020-04-03,51,5,41,92
"12974","1300-1359",2020-04-04,42,6,40,82
"12975","1300-1359",2020-04-05,48,7,43,91
"12976","1300-1359",2020-04-06,49,1,41,90
"12977","1300-1359",2020-04-07,33,2,27,60
"12978","1300-1359",2020-04-08,29,3,26,55
"12979","1300-1359",2020-04-09,28,4,24,52
"12980","1300-1359",2020-04-10,26,5,28,54
"12981","1300-1359",2020-04-11,22,6,28,50
"12982","1300-1359",2020-04-12,25,7,25,50
"12983","1300-1359",2020-04-13,24,1,25,49
"12984","1300-1359",2020-04-14,17,2,26,43
"12985","1300-1359",2020-04-15,15,3,25,40
"12986","1300-1359",2020-04-16,17,4,26,43
"12987","1300-1359",2020-04-17,14,5,30,44
"12988","1300-1359",2020-04-18,14,6,22,36
"12989","1300-1359",2020-04-19,16,7,23,39
"12990","1300-1359",2020-04-20,15,1,27,42
"12991","1300-1359",2020-04-21,15,2,25,40
"12992","1300-1359",2020-04-22,16,3,27,43
"12993","1300-1359",2020-04-23,16,4,27,43
"12994","1300-1359",2020-04-24,15,5,30,45
"12995","1300-1359",2020-04-25,16,6,23,39
"12996","1300-1359",2020-04-26,16,7,23,39
"12997","1300-1359",2020-04-27,15,1,27,42
"12998","1300-1359",2020-04-28,13,2,25,38
"12999","1300-1359",2020-04-29,16,3,26,42
"13000","1300-1359",2020-04-30,14,4,26,40
"13001","1400-1459",2020-04-01,42,3,65,107
"13002","1400-1459",2020-04-02,39,4,58,97
"13003","1400-1459",2020-04-03,41,5,61,102
"13004","1400-1459",2020-04-04,34,6,53,87
"13005","1400-1459",2020-04-05,40,7,54,94
"13006","1400-1459",2020-04-06,37,1,59,96
"13007","1400-1459",2020-04-07,25,2,48,73
"13008","1400-1459",2020-04-08,20,3,38,58
"13009","1400-1459",2020-04-09,19,4,39,58
"13010","1400-1459",2020-04-10,21,5,37,58
"13011","1400-1459",2020-04-11,20,6,28,48
"13012","1400-1459",2020-04-12,18,7,27,45
"13013","1400-1459",2020-04-13,15,1,32,47
"13014","1400-1459",2020-04-14,21,2,29,50
"13015","1400-1459",2020-04-15,22,3,27,49
"13016","1400-1459",2020-04-16,19,4,27,46
"13017","1400-1459",2020-04-17,20,5,28,48
"13018","1400-1459",2020-04-18,17,6,24,41
"13019","1400-1459",2020-04-19,19,7,23,42
"13020","1400-1459",2020-04-20,22,1,28,50
"13021","1400-1459",2020-04-21,21,2,25,46
"13022","1400-1459",2020-04-22,19,3,27,46
"13023","1400-1459",2020-04-23,19,4,25,44
"13024","1400-1459",2020-04-24,18,5,26,44
"13025","1400-1459",2020-04-25,15,6,22,37
"13026","1400-1459",2020-04-26,17,7,25,42
"13027","1400-1459",2020-04-27,19,1,26,45
"13028","1400-1459",2020-04-28,21,2,25,46
"13029","1400-1459",2020-04-29,20,3,25,45
"13030","1400-1459",2020-04-30,19,4,24,43
"13031","1500-1559",2020-04-01,63,3,53,116
"13032","1500-1559",2020-04-02,59,4,51,110
"13033","1500-1559",2020-04-03,59,5,50,109
"13034","1500-1559",2020-04-04,49,6,39,88
"13035","1500-1559",2020-04-05,59,7,47,106
"13036","1500-1559",2020-04-06,51,1,46,97
"13037","1500-1559",2020-04-07,43,2,34,77
"13038","1500-1559",2020-04-08,34,3,29,63
"13039","1500-1559",2020-04-09,31,4,24,55
"13040","1500-1559",2020-04-10,31,5,25,56
"13041","1500-1559",2020-04-11,22,6,20,42
"13042","1500-1559",2020-04-12,27,7,21,48
"13043","1500-1559",2020-04-13,25,1,21,46
"13044","1500-1559",2020-04-14,25,2,14,39
"13045","1500-1559",2020-04-15,23,3,16,39
"13046","1500-1559",2020-04-16,24,4,15,39
"13047","1500-1559",2020-04-17,23,5,17,40
"13048","1500-1559",2020-04-18,14,6,12,26
"13049","1500-1559",2020-04-19,13,7,14,27
"13050","1500-1559",2020-04-20,21,1,15,36
"13051","1500-1559",2020-04-21,21,2,13,34
"13052","1500-1559",2020-04-22,20,3,16,36
"13053","1500-1559",2020-04-23,19,4,15,34
"13054","1500-1559",2020-04-24,21,5,15,36
"13055","1500-1559",2020-04-25,13,6,11,24
"13056","1500-1559",2020-04-26,13,7,14,27
"13057","1500-1559",2020-04-27,23,1,15,38
"13058","1500-1559",2020-04-28,21,2,13,34
"13059","1500-1559",2020-04-29,21,3,15,36
"13060","1500-1559",2020-04-30,21,4,15,36
"13061","1600-1659",2020-04-01,50,3,58,108
"13062","1600-1659",2020-04-02,49,4,61,110
"13063","1600-1659",2020-04-03,47,5,59,106
"13064","1600-1659",2020-04-04,43,6,48,91
"13065","1600-1659",2020-04-05,48,7,53,101
"13066","1600-1659",2020-04-06,45,1,55,100
"13067","1600-1659",2020-04-07,33,2,40,73
"13068","1600-1659",2020-04-08,28,3,33,61
"13069","1600-1659",2020-04-09,25,4,32,57
"13070","1600-1659",2020-04-10,24,5,32,56
"13071","1600-1659",2020-04-11,21,6,27,48
"13072","1600-1659",2020-04-12,22,7,25,47
"13073","1600-1659",2020-04-13,23,1,25,48
"13074","1600-1659",2020-04-14,16,2,30,46
"13075","1600-1659",2020-04-15,15,3,27,42
"13076","1600-1659",2020-04-16,16,4,27,43
"13077","1600-1659",2020-04-17,14,5,23,37
"13078","1600-1659",2020-04-18,17,6,11,28
"13079","1600-1659",2020-04-19,19,7,20,39
"13080","1600-1659",2020-04-20,13,1,25,38
"13081","1600-1659",2020-04-21,14,2,24,38
"13082","1600-1659",2020-04-22,15,3,20,35
"13083","1600-1659",2020-04-23,17,4,24,41
"13084","1600-1659",2020-04-24,13,5,22,35
"13085","1600-1659",2020-04-25,17,6,15,32
"13086","1600-1659",2020-04-26,20,7,17,37
"13087","1600-1659",2020-04-27,12,1,22,34
"13088","1600-1659",2020-04-28,13,2,23,36
"13089","1600-1659",2020-04-29,13,3,20,33
"13090","1600-1659",2020-04-30,13,4,22,35
"13091","1700-1759",2020-04-01,60,3,60,120
"13092","1700-1759",2020-04-02,61,4,52,113
"13093","1700-1759",2020-04-03,60,5,53,113
"13094","1700-1759",2020-04-04,51,6,46,97
"13095","1700-1759",2020-04-05,53,7,57,110
"13096","1700-1759",2020-04-06,54,1,49,103
"13097","1700-1759",2020-04-07,37,2,35,72
"13098","1700-1759",2020-04-08,27,3,23,50
"13099","1700-1759",2020-04-09,27,4,23,50
"13100","1700-1759",2020-04-10,29,5,25,54
"13101","1700-1759",2020-04-11,24,6,24,48
"13102","1700-1759",2020-04-12,25,7,29,54
"13103","1700-1759",2020-04-13,26,1,20,46
"13104","1700-1759",2020-04-14,25,2,19,44
"13105","1700-1759",2020-04-15,24,3,16,40
"13106","1700-1759",2020-04-16,23,4,15,38
"13107","1700-1759",2020-04-17,23,5,15,38
"13108","1700-1759",2020-04-18,21,6,9,30
"13109","1700-1759",2020-04-19,24,7,14,38
"13110","1700-1759",2020-04-20,25,1,14,39
"13111","1700-1759",2020-04-21,24,2,17,41
"13112","1700-1759",2020-04-22,23,3,15,38
"13113","1700-1759",2020-04-23,24,4,15,39
"13114","1700-1759",2020-04-24,24,5,13,37
"13115","1700-1759",2020-04-25,18,6,7,25
"13116","1700-1759",2020-04-26,22,7,13,35
"13117","1700-1759",2020-04-27,23,1,16,39
"13118","1700-1759",2020-04-28,23,2,16,39
"13119","1700-1759",2020-04-29,23,3,15,38
"13120","1700-1759",2020-04-30,23,4,14,37
"13121","1800-1859",2020-04-01,63,3,58,121
"13122","1800-1859",2020-04-02,59,4,52,111
"13123","1800-1859",2020-04-03,61,5,48,109
"13124","1800-1859",2020-04-04,57,6,45,102
"13125","1800-1859",2020-04-05,68,7,47,115
"13126","1800-1859",2020-04-06,57,1,48,105
"13127","1800-1859",2020-04-07,36,2,33,69
"13128","1800-1859",2020-04-08,34,3,26,60
"13129","1800-1859",2020-04-09,33,4,27,60
"13130","1800-1859",2020-04-10,32,5,25,57
"13131","1800-1859",2020-04-11,35,6,21,56
"13132","1800-1859",2020-04-12,30,7,22,52
"13133","1800-1859",2020-04-13,24,1,23,47
"13134","1800-1859",2020-04-14,24,2,23,47
"13135","1800-1859",2020-04-15,25,3,23,48
"13136","1800-1859",2020-04-16,28,4,25,53
"13137","1800-1859",2020-04-17,24,5,22,46
"13138","1800-1859",2020-04-18,19,6,22,41
"13139","1800-1859",2020-04-19,18,7,21,39
"13140","1800-1859",2020-04-20,22,1,22,44
"13141","1800-1859",2020-04-21,21,2,22,43
"13142","1800-1859",2020-04-22,21,3,21,42
"13143","1800-1859",2020-04-23,24,4,24,48
"13144","1800-1859",2020-04-24,19,5,20,39
"13145","1800-1859",2020-04-25,18,6,20,38
"13146","1800-1859",2020-04-26,16,7,21,37
"13147","1800-1859",2020-04-27,20,1,20,40
"13148","1800-1859",2020-04-28,20,2,20,40
"13149","1800-1859",2020-04-29,18,3,20,38
"13150","1800-1859",2020-04-30,21,4,22,43
"13151","1900-1959",2020-04-01,68,3,55,123
"13152","1900-1959",2020-04-02,61,4,62,123
"13153","1900-1959",2020-04-03,58,5,62,120
"13154","1900-1959",2020-04-04,46,6,58,104
"13155","1900-1959",2020-04-05,50,7,64,114
"13156","1900-1959",2020-04-06,52,1,58,110
"13157","1900-1959",2020-04-07,44,2,38,82
"13158","1900-1959",2020-04-08,42,3,37,79
"13159","1900-1959",2020-04-09,38,4,33,71
"13160","1900-1959",2020-04-10,34,5,33,67
"13161","1900-1959",2020-04-11,25,6,35,60
"13162","1900-1959",2020-04-12,26,7,31,57
"13163","1900-1959",2020-04-13,29,1,28,57
"13164","1900-1959",2020-04-14,26,2,27,53
"13165","1900-1959",2020-04-15,26,3,26,52
"13166","1900-1959",2020-04-16,26,4,26,52
"13167","1900-1959",2020-04-17,26,5,28,54
"13168","1900-1959",2020-04-18,21,6,29,50
"13169","1900-1959",2020-04-19,26,7,26,52
"13170","1900-1959",2020-04-20,24,1,25,49
"13171","1900-1959",2020-04-21,23,2,26,49
"13172","1900-1959",2020-04-22,24,3,26,50
"13173","1900-1959",2020-04-23,25,4,25,50
"13174","1900-1959",2020-04-24,26,5,26,52
"13175","1900-1959",2020-04-25,21,6,29,50
"13176","1900-1959",2020-04-26,27,7,28,55
"13177","1900-1959",2020-04-27,25,1,23,48
"13178","1900-1959",2020-04-28,24,2,27,51
"13179","1900-1959",2020-04-29,24,3,23,47
"13180","1900-1959",2020-04-30,25,4,23,48
"13181","2000-2059",2020-04-01,53,3,67,120
"13182","2000-2059",2020-04-02,53,4,60,113
"13183","2000-2059",2020-04-03,60,5,63,123
"13184","2000-2059",2020-04-04,52,6,47,99
"13185","2000-2059",2020-04-05,55,7,52,107
"13186","2000-2059",2020-04-06,51,1,53,104
"13187","2000-2059",2020-04-07,32,2,45,77
"13188","2000-2059",2020-04-08,34,3,37,71
"13189","2000-2059",2020-04-09,30,4,36,66
"13190","2000-2059",2020-04-10,35,5,33,68
"13191","2000-2059",2020-04-11,29,6,26,55
"13192","2000-2059",2020-04-12,31,7,18,49
"13193","2000-2059",2020-04-13,31,1,23,54
"13194","2000-2059",2020-04-14,16,2,22,38
"13195","2000-2059",2020-04-15,21,3,22,43
"13196","2000-2059",2020-04-16,18,4,24,42
"13197","2000-2059",2020-04-17,24,5,21,45
"13198","2000-2059",2020-04-18,17,6,16,33
"13199","2000-2059",2020-04-19,19,7,17,36
"13200","2000-2059",2020-04-20,17,1,22,39
"13201","2000-2059",2020-04-21,15,2,18,33
"13202","2000-2059",2020-04-22,19,3,19,38
"13203","2000-2059",2020-04-23,18,4,19,37
"13204","2000-2059",2020-04-24,18,5,17,35
"13205","2000-2059",2020-04-25,17,6,15,32
"13206","2000-2059",2020-04-26,19,7,14,33
"13207","2000-2059",2020-04-27,19,1,19,38
"13208","2000-2059",2020-04-28,15,2,18,33
"13209","2000-2059",2020-04-29,20,3,19,39
"13210","2000-2059",2020-04-30,19,4,18,37
"13211","2100-2159",2020-04-01,42,3,64,106
"13212","2100-2159",2020-04-02,39,4,66,105
"13213","2100-2159",2020-04-03,37,5,67,104
"13214","2100-2159",2020-04-04,33,6,61,94
"13215","2100-2159",2020-04-05,36,7,67,103
"13216","2100-2159",2020-04-06,29,1,58,87
"13217","2100-2159",2020-04-07,27,2,45,72
"13218","2100-2159",2020-04-08,24,3,44,68
"13219","2100-2159",2020-04-09,26,4,40,66
"13220","2100-2159",2020-04-10,20,5,46,66
"13221","2100-2159",2020-04-11,16,6,40,56
"13222","2100-2159",2020-04-12,20,7,43,63
"13223","2100-2159",2020-04-13,21,1,40,61
"13224","2100-2159",2020-04-14,9,2,34,43
"13225","2100-2159",2020-04-15,9,3,34,43
"13226","2100-2159",2020-04-16,10,4,36,46
"13227","2100-2159",2020-04-17,9,5,34,43
"13228","2100-2159",2020-04-18,5,6,32,37
"13229","2100-2159",2020-04-19,13,7,32,45
"13230","2100-2159",2020-04-20,9,1,30,39
"13231","2100-2159",2020-04-21,10,2,30,40
"13232","2100-2159",2020-04-22,9,3,30,39
"13233","2100-2159",2020-04-23,10,4,31,41
"13234","2100-2159",2020-04-24,9,5,31,40
"13235","2100-2159",2020-04-25,4,6,33,37
"13236","2100-2159",2020-04-26,15,7,31,46
"13237","2100-2159",2020-04-27,10,1,29,39
"13238","2100-2159",2020-04-28,9,2,28,37
"13239","2100-2159",2020-04-29,9,3,29,38
"13240","2100-2159",2020-04-30,11,4,29,40
"13241","2200-2259",2020-04-01,41,3,57,98
"13242","2200-2259",2020-04-02,37,4,57,94
"13243","2200-2259",2020-04-03,40,5,56,96
"13244","2200-2259",2020-04-04,24,6,49,73
"13245","2200-2259",2020-04-05,30,7,54,84
"13246","2200-2259",2020-04-06,31,1,48,79
"13247","2200-2259",2020-04-07,28,2,36,64
"13248","2200-2259",2020-04-08,24,3,33,57
"13249","2200-2259",2020-04-09,23,4,33,56
"13250","2200-2259",2020-04-10,25,5,29,54
"13251","2200-2259",2020-04-11,14,6,23,37
"13252","2200-2259",2020-04-12,16,7,24,40
"13253","2200-2259",2020-04-13,16,1,26,42
"13254","2200-2259",2020-04-14,9,2,14,23
"13255","2200-2259",2020-04-15,8,3,17,25
"13256","2200-2259",2020-04-16,9,4,17,26
"13257","2200-2259",2020-04-17,9,5,19,28
"13258","2200-2259",2020-04-18,5,6,14,19
"13259","2200-2259",2020-04-19,8,7,20,28
"13260","2200-2259",2020-04-20,5,1,16,21
"13261","2200-2259",2020-04-21,7,2,14,21
"13262","2200-2259",2020-04-22,6,3,16,22
"13263","2200-2259",2020-04-23,7,4,19,26
"13264","2200-2259",2020-04-24,7,5,16,23
"13265","2200-2259",2020-04-25,4,6,13,17
"13266","2200-2259",2020-04-26,8,7,21,29
"13267","2200-2259",2020-04-27,6,1,17,23
"13268","2200-2259",2020-04-28,5,2,13,18
"13269","2200-2259",2020-04-29,7,3,17,24
"13270","2200-2259",2020-04-30,7,4,18,25
"13271","2300-2359",2020-04-01,17,3,69,86
"13272","2300-2359",2020-04-02,18,4,61,79
"13273","2300-2359",2020-04-03,19,5,63,82
"13274","2300-2359",2020-04-04,17,6,51,68
"13275","2300-2359",2020-04-05,18,7,58,76
"13276","2300-2359",2020-04-06,16,1,52,68
"13277","2300-2359",2020-04-07,14,2,37,51
"13278","2300-2359",2020-04-08,11,3,33,44
"13279","2300-2359",2020-04-09,10,4,28,38
"13280","2300-2359",2020-04-10,7,5,27,34
"13281","2300-2359",2020-04-11,7,6,19,26
"13282","2300-2359",2020-04-12,6,7,22,28
"13283","2300-2359",2020-04-13,5,1,21,26
"13284","2300-2359",2020-04-14,7,2,15,22
"13285","2300-2359",2020-04-15,7,3,15,22
"13286","2300-2359",2020-04-16,6,4,15,21
"13287","2300-2359",2020-04-17,5,5,14,19
"13288","2300-2359",2020-04-18,6,6,4,10
"13289","2300-2359",2020-04-19,6,7,11,17
"13290","2300-2359",2020-04-20,5,1,12,17
"13291","2300-2359",2020-04-21,5,2,12,17
"13292","2300-2359",2020-04-22,6,3,12,18
"13293","2300-2359",2020-04-23,5,4,13,18
"13294","2300-2359",2020-04-24,3,5,11,14
"13295","2300-2359",2020-04-25,3,6,3,6
"13296","2300-2359",2020-04-26,5,7,11,16
"13297","2300-2359",2020-04-27,4,1,13,17
"13298","2300-2359",2020-04-28,6,2,12,18
"13299","2300-2359",2020-04-29,4,3,12,16
"13300","2300-2359",2020-04-30,4,4,15,19
"13301","0001-0559",2020-05-01,7,5,12,19
"13302","0001-0559",2020-05-02,5,6,5,10
"13303","0001-0559",2020-05-04,2,1,5,7
"13304","0001-0559",2020-05-05,3,2,5,8
"13305","0001-0559",2020-05-06,2,3,7,9
"13306","0001-0559",2020-05-07,3,4,2,5
"13307","0001-0559",2020-05-08,4,5,4,8
"13308","0001-0559",2020-05-09,3,6,3,6
"13309","0001-0559",2020-05-10,3,7,3,6
"13310","0001-0559",2020-05-11,4,1,3,7
"13311","0001-0559",2020-05-12,3,2,2,5
"13312","0001-0559",2020-05-13,3,3,3,6
"13313","0001-0559",2020-05-14,3,4,2,5
"13314","0001-0559",2020-05-15,4,5,4,8
"13315","0001-0559",2020-05-16,3,6,3,6
"13316","0001-0559",2020-05-17,3,7,3,6
"13317","0001-0559",2020-05-18,4,1,3,7
"13318","0001-0559",2020-05-19,3,2,2,5
"13319","0001-0559",2020-05-20,3,3,3,6
"13320","0001-0559",2020-05-21,3,4,2,5
"13321","0001-0559",2020-05-22,4,5,4,8
"13322","0001-0559",2020-05-23,4,6,4,8
"13323","0001-0559",2020-05-24,3,7,3,6
"13324","0001-0559",2020-05-25,4,1,3,7
"13325","0001-0559",2020-05-26,3,2,2,5
"13326","0001-0559",2020-05-27,3,3,3,6
"13327","0001-0559",2020-05-28,3,4,2,5
"13328","0001-0559",2020-05-29,4,5,4,8
"13329","0001-0559",2020-05-30,4,6,4,8
"13330","0001-0559",2020-05-31,3,7,3,6
"13331","0600-0659",2020-05-01,23,5,5,28
"13332","0600-0659",2020-05-02,15,6,2,17
"13333","0600-0659",2020-05-03,10,7,3,13
"13334","0600-0659",2020-05-04,8,1,4,12
"13335","0600-0659",2020-05-05,7,2,4,11
"13336","0600-0659",2020-05-06,6,3,6,12
"13337","0600-0659",2020-05-07,10,4,3,13
"13338","0600-0659",2020-05-08,10,5,3,13
"13339","0600-0659",2020-05-09,9,6,3,12
"13340","0600-0659",2020-05-10,11,7,4,15
"13341","0600-0659",2020-05-11,11,1,4,15
"13342","0600-0659",2020-05-12,10,2,4,14
"13343","0600-0659",2020-05-13,10,3,4,14
"13344","0600-0659",2020-05-14,10,4,4,14
"13345","0600-0659",2020-05-15,10,5,4,14
"13346","0600-0659",2020-05-16,10,6,4,14
"13347","0600-0659",2020-05-17,9,7,4,13
"13348","0600-0659",2020-05-18,8,1,4,12
"13349","0600-0659",2020-05-19,8,2,4,12
"13350","0600-0659",2020-05-20,8,3,4,12
"13351","0600-0659",2020-05-21,8,4,4,12
"13352","0600-0659",2020-05-22,9,5,4,13
"13353","0600-0659",2020-05-23,8,6,4,12
"13354","0600-0659",2020-05-24,8,7,4,12
"13355","0600-0659",2020-05-25,9,1,4,13
"13356","0600-0659",2020-05-26,8,2,4,12
"13357","0600-0659",2020-05-27,8,3,4,12
"13358","0600-0659",2020-05-28,8,4,4,12
"13359","0600-0659",2020-05-29,9,5,4,13
"13360","0600-0659",2020-05-30,8,6,4,12
"13361","0600-0659",2020-05-31,8,7,4,12
"13362","0700-0759",2020-05-01,20,5,17,37
"13363","0700-0759",2020-05-02,16,6,7,23
"13364","0700-0759",2020-05-03,22,7,5,27
"13365","0700-0759",2020-05-04,19,1,4,23
"13366","0700-0759",2020-05-05,22,2,3,25
"13367","0700-0759",2020-05-06,22,3,3,25
"13368","0700-0759",2020-05-07,22,4,5,27
"13369","0700-0759",2020-05-08,22,5,4,26
"13370","0700-0759",2020-05-09,22,6,4,26
"13371","0700-0759",2020-05-10,23,7,4,27
"13372","0700-0759",2020-05-11,22,1,4,26
"13373","0700-0759",2020-05-12,22,2,4,26
"13374","0700-0759",2020-05-13,22,3,4,26
"13375","0700-0759",2020-05-14,23,4,5,28
"13376","0700-0759",2020-05-15,24,5,5,29
"13377","0700-0759",2020-05-16,22,6,4,26
"13378","0700-0759",2020-05-17,23,7,4,27
"13379","0700-0759",2020-05-18,24,1,3,27
"13380","0700-0759",2020-05-19,22,2,2,24
"13381","0700-0759",2020-05-20,22,3,2,24
"13382","0700-0759",2020-05-21,23,4,3,26
"13383","0700-0759",2020-05-22,23,5,3,26
"13384","0700-0759",2020-05-23,22,6,2,24
"13385","0700-0759",2020-05-24,23,7,3,26
"13386","0700-0759",2020-05-25,23,1,3,26
"13387","0700-0759",2020-05-26,22,2,2,24
"13388","0700-0759",2020-05-27,23,3,2,25
"13389","0700-0759",2020-05-28,24,4,3,27
"13390","0700-0759",2020-05-29,23,5,3,26
"13391","0700-0759",2020-05-30,23,6,2,25
"13392","0700-0759",2020-05-31,23,7,3,26
"13393","0800-0859",2020-05-01,35,5,10,45
"13394","0800-0859",2020-05-02,31,6,12,43
"13395","0800-0859",2020-05-03,22,7,10,32
"13396","0800-0859",2020-05-04,19,1,10,29
"13397","0800-0859",2020-05-05,20,2,10,30
"13398","0800-0859",2020-05-06,22,3,10,32
"13399","0800-0859",2020-05-07,25,4,12,37
"13400","0800-0859",2020-05-08,27,5,13,40
"13401","0800-0859",2020-05-09,23,6,13,36
"13402","0800-0859",2020-05-10,26,7,13,39
"13403","0800-0859",2020-05-11,26,1,13,39
"13404","0800-0859",2020-05-12,24,2,13,37
"13405","0800-0859",2020-05-13,26,3,13,39
"13406","0800-0859",2020-05-14,27,4,13,40
"13407","0800-0859",2020-05-15,26,5,13,39
"13408","0800-0859",2020-05-16,23,6,13,36
"13409","0800-0859",2020-05-17,28,7,13,41
"13410","0800-0859",2020-05-18,25,1,13,38
"13411","0800-0859",2020-05-19,24,2,13,37
"13412","0800-0859",2020-05-20,27,3,13,40
"13413","0800-0859",2020-05-21,30,4,13,43
"13414","0800-0859",2020-05-22,28,5,13,41
"13415","0800-0859",2020-05-23,23,6,13,36
"13416","0800-0859",2020-05-24,28,7,13,41
"13417","0800-0859",2020-05-25,26,1,13,39
"13418","0800-0859",2020-05-26,24,2,13,37
"13419","0800-0859",2020-05-27,25,3,13,38
"13420","0800-0859",2020-05-28,26,4,13,39
"13421","0800-0859",2020-05-29,27,5,13,40
"13422","0800-0859",2020-05-30,22,6,13,35
"13423","0800-0859",2020-05-31,30,7,13,43
"13424","0900-0959",2020-05-01,21,5,19,40
"13425","0900-0959",2020-05-02,20,6,14,34
"13426","0900-0959",2020-05-03,25,7,12,37
"13427","0900-0959",2020-05-04,24,1,10,34
"13428","0900-0959",2020-05-05,23,2,10,33
"13429","0900-0959",2020-05-06,22,3,10,32
"13430","0900-0959",2020-05-07,23,4,12,35
"13431","0900-0959",2020-05-08,23,5,11,34
"13432","0900-0959",2020-05-09,24,6,10,34
"13433","0900-0959",2020-05-10,24,7,12,36
"13434","0900-0959",2020-05-11,23,1,11,34
"13435","0900-0959",2020-05-12,23,2,10,33
"13436","0900-0959",2020-05-13,23,3,10,33
"13437","0900-0959",2020-05-14,23,4,10,33
"13438","0900-0959",2020-05-15,23,5,12,35
"13439","0900-0959",2020-05-16,24,6,10,34
"13440","0900-0959",2020-05-17,24,7,10,34
"13441","0900-0959",2020-05-18,24,1,12,36
"13442","0900-0959",2020-05-19,23,2,10,33
"13443","0900-0959",2020-05-20,23,3,10,33
"13444","0900-0959",2020-05-21,23,4,11,34
"13445","0900-0959",2020-05-22,24,5,12,36
"13446","0900-0959",2020-05-23,26,6,10,36
"13447","0900-0959",2020-05-24,23,7,11,34
"13448","0900-0959",2020-05-25,23,1,12,35
"13449","0900-0959",2020-05-26,24,2,10,34
"13450","0900-0959",2020-05-27,23,3,10,33
"13451","0900-0959",2020-05-28,24,4,11,35
"13452","0900-0959",2020-05-29,23,5,12,35
"13453","0900-0959",2020-05-30,27,6,10,37
"13454","0900-0959",2020-05-31,24,7,11,35
"13455","1000-1059",2020-05-01,18,5,14,32
"13456","1000-1059",2020-05-02,15,6,16,31
"13457","1000-1059",2020-05-03,14,7,15,29
"13458","1000-1059",2020-05-04,12,1,16,28
"13459","1000-1059",2020-05-05,12,2,17,29
"13460","1000-1059",2020-05-06,11,3,16,27
"13461","1000-1059",2020-05-07,18,4,19,37
"13462","1000-1059",2020-05-08,17,5,21,38
"13463","1000-1059",2020-05-09,16,6,17,33
"13464","1000-1059",2020-05-10,18,7,19,37
"13465","1000-1059",2020-05-11,17,1,20,37
"13466","1000-1059",2020-05-12,17,2,19,36
"13467","1000-1059",2020-05-13,16,3,19,35
"13468","1000-1059",2020-05-14,18,4,20,38
"13469","1000-1059",2020-05-15,19,5,20,39
"13470","1000-1059",2020-05-16,17,6,16,33
"13471","1000-1059",2020-05-17,19,7,20,39
"13472","1000-1059",2020-05-18,19,1,19,38
"13473","1000-1059",2020-05-19,18,2,18,36
"13474","1000-1059",2020-05-20,17,3,19,36
"13475","1000-1059",2020-05-21,20,4,21,41
"13476","1000-1059",2020-05-22,19,5,19,38
"13477","1000-1059",2020-05-23,17,6,16,33
"13478","1000-1059",2020-05-24,20,7,21,41
"13479","1000-1059",2020-05-25,19,1,20,39
"13480","1000-1059",2020-05-26,19,2,20,39
"13481","1000-1059",2020-05-27,18,3,19,37
"13482","1000-1059",2020-05-28,20,4,20,40
"13483","1000-1059",2020-05-29,19,5,20,39
"13484","1000-1059",2020-05-30,17,6,17,34
"13485","1000-1059",2020-05-31,21,7,21,42
"13486","1100-1159",2020-05-01,28,5,22,50
"13487","1100-1159",2020-05-02,14,6,20,34
"13488","1100-1159",2020-05-03,17,7,15,32
"13489","1100-1159",2020-05-04,17,1,14,31
"13490","1100-1159",2020-05-05,18,2,14,32
"13491","1100-1159",2020-05-06,17,3,13,30
"13492","1100-1159",2020-05-07,14,4,17,31
"13493","1100-1159",2020-05-08,17,5,18,35
"13494","1100-1159",2020-05-09,14,6,17,31
"13495","1100-1159",2020-05-10,16,7,17,33
"13496","1100-1159",2020-05-11,16,1,18,34
"13497","1100-1159",2020-05-12,16,2,17,33
"13498","1100-1159",2020-05-13,16,3,17,33
"13499","1100-1159",2020-05-14,16,4,18,34
"13500","1100-1159",2020-05-15,17,5,18,35
"13501","1100-1159",2020-05-16,13,6,17,30
"13502","1100-1159",2020-05-17,16,7,19,35
"13503","1100-1159",2020-05-18,17,1,19,36
"13504","1100-1159",2020-05-19,16,2,17,33
"13505","1100-1159",2020-05-20,15,3,18,33
"13506","1100-1159",2020-05-21,16,4,18,34
"13507","1100-1159",2020-05-22,18,5,20,38
"13508","1100-1159",2020-05-23,13,6,19,32
"13509","1100-1159",2020-05-24,16,7,18,34
"13510","1100-1159",2020-05-25,15,1,18,33
"13511","1100-1159",2020-05-26,16,2,17,33
"13512","1100-1159",2020-05-27,15,3,17,32
"13513","1100-1159",2020-05-28,16,4,18,34
"13514","1100-1159",2020-05-29,16,5,18,34
"13515","1100-1159",2020-05-30,13,6,18,31
"13516","1100-1159",2020-05-31,16,7,19,35
"13517","1200-1259",2020-05-01,24,5,23,47
"13518","1200-1259",2020-05-02,16,6,19,35
"13519","1200-1259",2020-05-03,19,7,19,38
"13520","1200-1259",2020-05-04,19,1,15,34
"13521","1200-1259",2020-05-05,18,2,17,35
"13522","1200-1259",2020-05-06,17,3,12,29
"13523","1200-1259",2020-05-07,17,4,16,33
"13524","1200-1259",2020-05-08,18,5,15,33
"13525","1200-1259",2020-05-09,17,6,14,31
"13526","1200-1259",2020-05-10,17,7,17,34
"13527","1200-1259",2020-05-11,19,1,14,33
"13528","1200-1259",2020-05-12,17,2,15,32
"13529","1200-1259",2020-05-13,18,3,13,31
"13530","1200-1259",2020-05-14,17,4,16,33
"13531","1200-1259",2020-05-15,18,5,15,33
"13532","1200-1259",2020-05-16,16,6,14,30
"13533","1200-1259",2020-05-17,17,7,16,33
"13534","1200-1259",2020-05-18,18,1,15,33
"13535","1200-1259",2020-05-19,17,2,15,32
"13536","1200-1259",2020-05-20,17,3,13,30
"13537","1200-1259",2020-05-21,17,4,16,33
"13538","1200-1259",2020-05-22,19,5,16,35
"13539","1200-1259",2020-05-23,16,6,14,30
"13540","1200-1259",2020-05-24,17,7,16,33
"13541","1200-1259",2020-05-25,19,1,14,33
"13542","1200-1259",2020-05-26,17,2,15,32
"13543","1200-1259",2020-05-27,17,3,13,30
"13544","1200-1259",2020-05-28,17,4,16,33
"13545","1200-1259",2020-05-29,18,5,15,33
"13546","1200-1259",2020-05-30,17,6,16,33
"13547","1200-1259",2020-05-31,16,7,17,33
"13548","1300-1359",2020-05-01,17,5,29,46
"13549","1300-1359",2020-05-02,20,6,20,40
"13550","1300-1359",2020-05-03,14,7,20,34
"13551","1300-1359",2020-05-04,14,1,18,32
"13552","1300-1359",2020-05-05,13,2,17,30
"13553","1300-1359",2020-05-06,14,3,19,33
"13554","1300-1359",2020-05-07,20,4,17,37
"13555","1300-1359",2020-05-08,20,5,18,38
"13556","1300-1359",2020-05-09,20,6,18,38
"13557","1300-1359",2020-05-10,20,7,17,37
"13558","1300-1359",2020-05-11,19,1,18,37
"13559","1300-1359",2020-05-12,19,2,17,36
"13560","1300-1359",2020-05-13,19,3,18,37
"13561","1300-1359",2020-05-14,20,4,18,38
"13562","1300-1359",2020-05-15,20,5,18,38
"13563","1300-1359",2020-05-16,21,6,19,40
"13564","1300-1359",2020-05-17,21,7,19,40
"13565","1300-1359",2020-05-18,20,1,18,38
"13566","1300-1359",2020-05-19,19,2,18,37
"13567","1300-1359",2020-05-20,18,3,19,37
"13568","1300-1359",2020-05-21,21,4,19,40
"13569","1300-1359",2020-05-22,22,5,20,42
"13570","1300-1359",2020-05-23,21,6,19,40
"13571","1300-1359",2020-05-24,20,7,19,39
"13572","1300-1359",2020-05-25,19,1,19,38
"13573","1300-1359",2020-05-26,19,2,19,38
"13574","1300-1359",2020-05-27,19,3,19,38
"13575","1300-1359",2020-05-28,20,4,19,39
"13576","1300-1359",2020-05-29,22,5,19,41
"13577","1300-1359",2020-05-30,21,6,18,39
"13578","1300-1359",2020-05-31,22,7,19,41
"13579","1400-1459",2020-05-01,20,5,26,46
"13580","1400-1459",2020-05-02,16,6,18,34
"13581","1400-1459",2020-05-03,10,7,18,28
"13582","1400-1459",2020-05-04,12,1,19,31
"13583","1400-1459",2020-05-05,14,2,18,32
"13584","1400-1459",2020-05-06,11,3,17,28
"13585","1400-1459",2020-05-07,11,4,17,28
"13586","1400-1459",2020-05-08,11,5,20,31
"13587","1400-1459",2020-05-09,12,6,17,29
"13588","1400-1459",2020-05-10,11,7,18,29
"13589","1400-1459",2020-05-11,11,1,20,31
"13590","1400-1459",2020-05-12,11,2,18,29
"13591","1400-1459",2020-05-13,10,3,19,29
"13592","1400-1459",2020-05-14,11,4,19,30
"13593","1400-1459",2020-05-15,10,5,19,29
"13594","1400-1459",2020-05-16,12,6,16,28
"13595","1400-1459",2020-05-17,11,7,19,30
"13596","1400-1459",2020-05-18,10,1,19,29
"13597","1400-1459",2020-05-19,11,2,18,29
"13598","1400-1459",2020-05-20,11,3,18,29
"13599","1400-1459",2020-05-21,11,4,20,31
"13600","1400-1459",2020-05-22,13,5,19,32
"13601","1400-1459",2020-05-23,12,6,16,28
"13602","1400-1459",2020-05-24,11,7,20,31
"13603","1400-1459",2020-05-25,11,1,20,31
"13604","1400-1459",2020-05-26,11,2,18,29
"13605","1400-1459",2020-05-27,10,3,18,28
"13606","1400-1459",2020-05-28,12,4,20,32
"13607","1400-1459",2020-05-29,11,5,20,31
"13608","1400-1459",2020-05-30,12,6,17,29
"13609","1400-1459",2020-05-31,10,7,19,29
"13610","1500-1559",2020-05-01,21,5,15,36
"13611","1500-1559",2020-05-02,14,6,14,28
"13612","1500-1559",2020-05-03,15,7,12,27
"13613","1500-1559",2020-05-04,16,1,11,27
"13614","1500-1559",2020-05-05,16,2,10,26
"13615","1500-1559",2020-05-06,17,3,11,28
"13616","1500-1559",2020-05-07,14,4,13,27
"13617","1500-1559",2020-05-08,14,5,12,26
"13618","1500-1559",2020-05-09,14,6,15,29
"13619","1500-1559",2020-05-10,14,7,13,27
"13620","1500-1559",2020-05-11,14,1,13,27
"13621","1500-1559",2020-05-12,14,2,12,26
"13622","1500-1559",2020-05-13,14,3,14,28
"13623","1500-1559",2020-05-14,15,4,12,27
"13624","1500-1559",2020-05-15,15,5,12,27
"13625","1500-1559",2020-05-16,15,6,14,29
"13626","1500-1559",2020-05-17,16,7,12,28
"13627","1500-1559",2020-05-18,15,1,13,28
"13628","1500-1559",2020-05-19,15,2,12,27
"13629","1500-1559",2020-05-20,15,3,13,28
"13630","1500-1559",2020-05-21,16,4,13,29
"13631","1500-1559",2020-05-22,15,5,13,28
"13632","1500-1559",2020-05-23,15,6,15,30
"13633","1500-1559",2020-05-24,16,7,12,28
"13634","1500-1559",2020-05-25,16,1,13,29
"13635","1500-1559",2020-05-26,15,2,12,27
"13636","1500-1559",2020-05-27,16,3,14,30
"13637","1500-1559",2020-05-28,15,4,12,27
"13638","1500-1559",2020-05-29,16,5,12,28
"13639","1500-1559",2020-05-30,15,6,13,28
"13640","1500-1559",2020-05-31,17,7,12,29
"13641","1600-1659",2020-05-01,12,5,21,33
"13642","1600-1659",2020-05-02,15,6,12,27
"13643","1600-1659",2020-05-03,14,7,16,30
"13644","1600-1659",2020-05-04,12,1,18,30
"13645","1600-1659",2020-05-05,12,2,20,32
"13646","1600-1659",2020-05-06,13,3,20,33
"13647","1600-1659",2020-05-07,11,4,22,33
"13648","1600-1659",2020-05-08,13,5,22,35
"13649","1600-1659",2020-05-09,11,6,22,33
"13650","1600-1659",2020-05-10,12,7,23,35
"13651","1600-1659",2020-05-11,10,1,22,32
"13652","1600-1659",2020-05-12,11,2,22,33
"13653","1600-1659",2020-05-13,12,3,22,34
"13654","1600-1659",2020-05-14,11,4,22,33
"13655","1600-1659",2020-05-15,13,5,22,35
"13656","1600-1659",2020-05-16,11,6,22,33
"13657","1600-1659",2020-05-17,12,7,23,35
"13658","1600-1659",2020-05-18,11,1,22,33
"13659","1600-1659",2020-05-19,11,2,22,33
"13660","1600-1659",2020-05-20,12,3,22,34
"13661","1600-1659",2020-05-21,12,4,22,34
"13662","1600-1659",2020-05-22,14,5,25,39
"13663","1600-1659",2020-05-23,11,6,22,33
"13664","1600-1659",2020-05-24,13,7,22,35
"13665","1600-1659",2020-05-25,12,1,21,33
"13666","1600-1659",2020-05-26,13,2,22,35
"13667","1600-1659",2020-05-27,12,3,22,34
"13668","1600-1659",2020-05-28,11,4,23,34
"13669","1600-1659",2020-05-29,13,5,22,35
"13670","1600-1659",2020-05-30,11,6,22,33
"13671","1600-1659",2020-05-31,12,7,23,35
"13672","1700-1759",2020-05-01,21,5,15,36
"13673","1700-1759",2020-05-02,18,6,10,28
"13674","1700-1759",2020-05-03,17,7,13,30
"13675","1700-1759",2020-05-04,19,1,11,30
"13676","1700-1759",2020-05-05,19,2,12,31
"13677","1700-1759",2020-05-06,20,3,12,32
"13678","1700-1759",2020-05-07,23,4,12,35
"13679","1700-1759",2020-05-08,23,5,12,35
"13680","1700-1759",2020-05-09,22,6,13,35
"13681","1700-1759",2020-05-10,23,7,13,36
"13682","1700-1759",2020-05-11,23,1,12,35
"13683","1700-1759",2020-05-12,23,2,12,35
"13684","1700-1759",2020-05-13,23,3,13,36
"13685","1700-1759",2020-05-14,24,4,14,38
"13686","1700-1759",2020-05-15,22,5,13,35
"13687","1700-1759",2020-05-16,21,6,14,35
"13688","1700-1759",2020-05-17,25,7,14,39
"13689","1700-1759",2020-05-18,22,1,13,35
"13690","1700-1759",2020-05-19,22,2,13,35
"13691","1700-1759",2020-05-20,23,3,13,36
"13692","1700-1759",2020-05-21,24,4,14,38
"13693","1700-1759",2020-05-22,23,5,13,36
"13694","1700-1759",2020-05-23,22,6,14,36
"13695","1700-1759",2020-05-24,24,7,13,37
"13696","1700-1759",2020-05-25,24,1,13,37
"13697","1700-1759",2020-05-26,23,2,12,35
"13698","1700-1759",2020-05-27,23,3,14,37
"13699","1700-1759",2020-05-28,25,4,13,38
"13700","1700-1759",2020-05-29,23,5,14,37
"13701","1700-1759",2020-05-30,22,6,14,36
"13702","1700-1759",2020-05-31,24,7,14,38
"13703","1800-1859",2020-05-01,18,5,18,36
"13704","1800-1859",2020-05-02,13,6,23,36
"13705","1800-1859",2020-05-03,8,7,22,30
"13706","1800-1859",2020-05-04,9,1,17,26
"13707","1800-1859",2020-05-05,9,2,19,28
"13708","1800-1859",2020-05-06,10,3,20,30
"13709","1800-1859",2020-05-07,8,4,22,30
"13710","1800-1859",2020-05-08,8,5,24,32
"13711","1800-1859",2020-05-09,9,6,20,29
"13712","1800-1859",2020-05-10,8,7,23,31
"13713","1800-1859",2020-05-11,8,1,20,28
"13714","1800-1859",2020-05-12,8,2,22,30
"13715","1800-1859",2020-05-13,9,3,22,31
"13716","1800-1859",2020-05-14,10,4,23,33
"13717","1800-1859",2020-05-15,9,5,27,36
"13718","1800-1859",2020-05-16,9,6,21,30
"13719","1800-1859",2020-05-17,11,7,25,36
"13720","1800-1859",2020-05-18,10,1,24,34
"13721","1800-1859",2020-05-19,10,2,23,33
"13722","1800-1859",2020-05-20,10,3,23,33
"13723","1800-1859",2020-05-21,12,4,25,37
"13724","1800-1859",2020-05-22,14,5,28,42
"13725","1800-1859",2020-05-23,10,6,21,31
"13726","1800-1859",2020-05-24,10,7,26,36
"13727","1800-1859",2020-05-25,9,1,24,33
"13728","1800-1859",2020-05-26,9,2,24,33
"13729","1800-1859",2020-05-27,10,3,23,33
"13730","1800-1859",2020-05-28,10,4,24,34
"13731","1800-1859",2020-05-29,10,5,26,36
"13732","1800-1859",2020-05-30,10,6,21,31
"13733","1800-1859",2020-05-31,11,7,24,35
"13734","1900-1959",2020-05-01,23,5,26,49
"13735","1900-1959",2020-05-02,20,6,17,37
"13736","1900-1959",2020-05-03,18,7,14,32
"13737","1900-1959",2020-05-04,15,1,14,29
"13738","1900-1959",2020-05-05,13,2,15,28
"13739","1900-1959",2020-05-06,13,3,15,28
"13740","1900-1959",2020-05-07,15,4,13,28
"13741","1900-1959",2020-05-08,15,5,14,29
"13742","1900-1959",2020-05-09,14,6,14,28
"13743","1900-1959",2020-05-10,16,7,14,30
"13744","1900-1959",2020-05-11,16,1,14,30
"13745","1900-1959",2020-05-12,16,2,14,30
"13746","1900-1959",2020-05-13,16,3,14,30
"13747","1900-1959",2020-05-14,16,4,14,30
"13748","1900-1959",2020-05-15,18,5,13,31
"13749","1900-1959",2020-05-16,14,6,13,27
"13750","1900-1959",2020-05-17,15,7,14,29
"13751","1900-1959",2020-05-18,17,1,13,30
"13752","1900-1959",2020-05-19,15,2,13,28
"13753","1900-1959",2020-05-20,14,3,14,28
"13754","1900-1959",2020-05-21,15,4,13,28
"13755","1900-1959",2020-05-22,16,5,15,31
"13756","1900-1959",2020-05-23,14,6,14,28
"13757","1900-1959",2020-05-24,14,7,14,28
"13758","1900-1959",2020-05-25,15,1,16,31
"13759","1900-1959",2020-05-26,15,2,14,29
"13760","1900-1959",2020-05-27,14,3,14,28
"13761","1900-1959",2020-05-28,15,4,15,30
"13762","1900-1959",2020-05-29,15,5,15,30
"13763","1900-1959",2020-05-30,14,6,14,28
"13764","1900-1959",2020-05-31,15,7,15,30
"13765","2000-2059",2020-05-01,19,5,21,40
"13766","2000-2059",2020-05-02,13,6,18,31
"13767","2000-2059",2020-05-03,11,7,9,20
"13768","2000-2059",2020-05-04,13,1,13,26
"13769","2000-2059",2020-05-05,9,2,9,18
"13770","2000-2059",2020-05-06,12,3,11,23
"13771","2000-2059",2020-05-07,9,4,12,21
"13772","2000-2059",2020-05-08,13,5,13,26
"13773","2000-2059",2020-05-09,10,6,11,21
"13774","2000-2059",2020-05-10,10,7,12,22
"13775","2000-2059",2020-05-11,12,1,13,25
"13776","2000-2059",2020-05-12,9,2,12,21
"13777","2000-2059",2020-05-13,11,3,12,23
"13778","2000-2059",2020-05-14,9,4,13,22
"13779","2000-2059",2020-05-15,11,5,13,24
"13780","2000-2059",2020-05-16,10,6,11,21
"13781","2000-2059",2020-05-17,10,7,15,25
"13782","2000-2059",2020-05-18,10,1,14,24
"13783","2000-2059",2020-05-19,9,2,13,22
"13784","2000-2059",2020-05-20,12,3,13,25
"13785","2000-2059",2020-05-21,9,4,15,24
"13786","2000-2059",2020-05-22,14,5,16,30
"13787","2000-2059",2020-05-23,10,6,12,22
"13788","2000-2059",2020-05-24,11,7,14,25
"13789","2000-2059",2020-05-25,13,1,13,26
"13790","2000-2059",2020-05-26,9,2,13,22
"13791","2000-2059",2020-05-27,12,3,13,25
"13792","2000-2059",2020-05-28,9,4,13,22
"13793","2000-2059",2020-05-29,13,5,13,26
"13794","2000-2059",2020-05-30,10,6,13,23
"13795","2000-2059",2020-05-31,12,7,14,26
"13796","2100-2159",2020-05-01,7,5,23,30
"13797","2100-2159",2020-05-02,2,6,26,28
"13798","2100-2159",2020-05-03,4,7,20,24
"13799","2100-2159",2020-05-04,2,1,21,23
"13800","2100-2159",2020-05-05,3,2,22,25
"13801","2100-2159",2020-05-06,4,3,23,27
"13802","2100-2159",2020-05-07,2,4,21,23
"13803","2100-2159",2020-05-09,1,6,21,22
"13804","2100-2159",2020-05-10,2,7,22,24
"13805","2100-2159",2020-05-12,1,2,22,23
"13806","2100-2159",2020-05-14,2,4,23,25
"13807","2100-2159",2020-05-15,1,5,24,25
"13808","2100-2159",2020-05-16,1,6,22,23
"13809","2100-2159",2020-05-17,2,7,23,25
"13810","2100-2159",2020-05-18,1,1,23,24
"13811","2100-2159",2020-05-19,1,2,22,23
"13812","2100-2159",2020-05-21,2,4,24,26
"13813","2100-2159",2020-05-22,1,5,27,28
"13814","2100-2159",2020-05-23,1,6,21,22
"13815","2100-2159",2020-05-24,2,7,21,23
"13816","2100-2159",2020-05-25,1,1,24,25
"13817","2100-2159",2020-05-26,1,2,21,22
"13818","2100-2159",2020-05-28,2,4,22,24
"13819","2100-2159",2020-05-29,1,5,25,26
"13820","2100-2159",2020-05-30,1,6,22,23
"13821","2100-2159",2020-05-31,2,7,26,28
"13822","2200-2259",2020-05-01,6,5,17,23
"13823","2200-2259",2020-05-02,2,6,12,14
"13824","2200-2259",2020-05-03,4,7,10,14
"13825","2200-2259",2020-05-04,2,1,10,12
"13826","2200-2259",2020-05-05,2,2,7,9
"13827","2200-2259",2020-05-06,4,3,7,11
"13828","2200-2259",2020-05-07,2,4,8,10
"13829","2200-2259",2020-05-08,1,5,9,10
"13830","2200-2259",2020-05-09,1,6,8,9
"13831","2200-2259",2020-05-10,2,7,8,10
"13832","2200-2259",2020-05-11,1,1,9,10
"13833","2200-2259",2020-05-12,1,2,8,9
"13834","2200-2259",2020-05-13,1,3,7,8
"13835","2200-2259",2020-05-14,2,4,8,10
"13836","2200-2259",2020-05-15,1,5,7,8
"13837","2200-2259",2020-05-16,1,6,8,9
"13838","2200-2259",2020-05-17,2,7,8,10
"13839","2200-2259",2020-05-18,1,1,7,8
"13840","2200-2259",2020-05-19,1,2,8,9
"13841","2200-2259",2020-05-20,1,3,7,8
"13842","2200-2259",2020-05-21,2,4,8,10
"13843","2200-2259",2020-05-22,2,5,7,9
"13844","2200-2259",2020-05-23,1,6,8,9
"13845","2200-2259",2020-05-24,2,7,8,10
"13846","2200-2259",2020-05-25,1,1,7,8
"13847","2200-2259",2020-05-26,1,2,9,10
"13848","2200-2259",2020-05-27,1,3,7,8
"13849","2200-2259",2020-05-28,2,4,8,10
"13850","2200-2259",2020-05-29,2,5,7,9
"13851","2200-2259",2020-05-30,1,6,8,9
"13852","2200-2259",2020-05-31,2,7,8,10
"13853","2300-2359",2020-05-01,4,5,11,15
"13854","2300-2359",2020-05-02,3,6,3,6
"13855","2300-2359",2020-05-03,4,7,8,12
"13856","2300-2359",2020-05-04,3,1,7,10
"13857","2300-2359",2020-05-05,3,2,7,10
"13858","2300-2359",2020-05-06,2,3,7,9
"13859","2300-2359",2020-05-07,3,4,7,10
"13860","2300-2359",2020-05-08,3,5,5,8
"13861","2300-2359",2020-05-09,3,6,5,8
"13862","2300-2359",2020-05-10,3,7,7,10
"13863","2300-2359",2020-05-11,3,1,5,8
"13864","2300-2359",2020-05-12,3,2,5,8
"13865","2300-2359",2020-05-13,3,3,5,8
"13866","2300-2359",2020-05-14,4,4,7,11
"13867","2300-2359",2020-05-15,4,5,6,10
"13868","2300-2359",2020-05-16,3,6,5,8
"13869","2300-2359",2020-05-17,4,7,7,11
"13870","2300-2359",2020-05-18,4,1,6,10
"13871","2300-2359",2020-05-19,3,2,5,8
"13872","2300-2359",2020-05-20,3,3,5,8
"13873","2300-2359",2020-05-21,4,4,7,11
"13874","2300-2359",2020-05-22,4,5,8,12
"13875","2300-2359",2020-05-23,3,6,5,8
"13876","2300-2359",2020-05-24,4,7,7,11
"13877","2300-2359",2020-05-25,4,1,6,10
"13878","2300-2359",2020-05-26,3,2,5,8
"13879","2300-2359",2020-05-27,3,3,5,8
"13880","2300-2359",2020-05-28,4,4,7,11
"13881","2300-2359",2020-05-29,4,5,7,11
"13882","2300-2359",2020-05-30,3,6,5,8
"13883","2300-2359",2020-05-31,4,7,7,11
"13884","0001-0559",2020-05-03,NA,7,7,NA
"13885","2100-2159",2020-05-08,NA,5,21,NA
"13886","2100-2159",2020-05-11,NA,1,22,NA
"13887","2100-2159",2020-05-13,NA,3,23,NA
"13888","2100-2159",2020-05-20,NA,3,22,NA
"13889","2100-2159",2020-05-27,NA,3,22,NA
"13890","0001-0559",2020-06-01,4,1,4,8
"13891","0001-0559",2020-06-02,3,2,6,9
"13892","0001-0559",2020-06-03,3,3,6,9
"13893","0001-0559",2020-06-04,2,4,6,8
"13894","0001-0559",2020-06-05,4,5,7,11
"13895","0001-0559",2020-06-06,4,6,8,12
"13896","0001-0559",2020-06-07,4,7,8,12
"13897","0001-0559",2020-06-08,4,1,6,10
"13898","0001-0559",2020-06-09,4,2,7,11
"13899","0001-0559",2020-06-10,4,3,7,11
"13900","0001-0559",2020-06-11,4,4,7,11
"13901","0001-0559",2020-06-12,4,5,7,11
"13902","0001-0559",2020-06-13,4,6,9,13
"13903","0001-0559",2020-06-14,4,7,8,12
"13904","0001-0559",2020-06-15,4,1,6,10
"13905","0001-0559",2020-06-16,4,2,7,11
"13906","0001-0559",2020-06-17,4,3,7,11
"13907","0001-0559",2020-06-18,4,4,7,11
"13908","0001-0559",2020-06-19,4,5,7,11
"13909","0001-0559",2020-06-20,4,6,8,12
"13910","0001-0559",2020-06-21,4,7,8,12
"13911","0001-0559",2020-06-22,4,1,7,11
"13912","0001-0559",2020-06-23,4,2,8,12
"13913","0001-0559",2020-06-24,4,3,8,12
"13914","0001-0559",2020-06-25,4,4,8,12
"13915","0001-0559",2020-06-26,4,5,8,12
"13916","0001-0559",2020-06-27,4,6,9,13
"13917","0001-0559",2020-06-28,4,7,8,12
"13918","0001-0559",2020-06-29,4,1,7,11
"13919","0001-0559",2020-06-30,4,2,8,12
"13920","0600-0659",2020-06-01,9,1,4,13
"13921","0600-0659",2020-06-02,7,2,3,10
"13922","0600-0659",2020-06-03,10,3,3,13
"13923","0600-0659",2020-06-04,9,4,3,12
"13924","0600-0659",2020-06-05,10,5,4,14
"13925","0600-0659",2020-06-06,10,6,4,14
"13926","0600-0659",2020-06-07,10,7,5,15
"13927","0600-0659",2020-06-08,11,1,4,15
"13928","0600-0659",2020-06-09,8,2,4,12
"13929","0600-0659",2020-06-10,10,3,4,14
"13930","0600-0659",2020-06-11,11,4,7,18
"13931","0600-0659",2020-06-12,12,5,6,18
"13932","0600-0659",2020-06-13,13,6,6,19
"13933","0600-0659",2020-06-14,13,7,7,20
"13934","0600-0659",2020-06-15,16,1,6,22
"13935","0600-0659",2020-06-16,13,2,6,19
"13936","0600-0659",2020-06-17,15,3,6,21
"13937","0600-0659",2020-06-18,14,4,7,21
"13938","0600-0659",2020-06-19,16,5,6,22
"13939","0600-0659",2020-06-20,16,6,6,22
"13940","0600-0659",2020-06-21,12,7,8,20
"13941","0600-0659",2020-06-22,16,1,7,23
"13942","0600-0659",2020-06-23,13,2,7,20
"13943","0600-0659",2020-06-24,15,3,7,22
"13944","0600-0659",2020-06-25,15,4,9,24
"13945","0600-0659",2020-06-26,16,5,7,23
"13946","0600-0659",2020-06-27,16,6,7,23
"13947","0600-0659",2020-06-28,15,7,9,24
"13948","0600-0659",2020-06-29,21,1,7,28
"13949","0600-0659",2020-06-30,15,2,7,22
"13950","0700-0759",2020-06-01,28,1,3,31
"13951","0700-0759",2020-06-02,27,2,3,30
"13952","0700-0759",2020-06-03,30,3,3,33
"13953","0700-0759",2020-06-04,34,4,7,41
"13954","0700-0759",2020-06-05,34,5,6,40
"13955","0700-0759",2020-06-06,33,6,6,39
"13956","0700-0759",2020-06-07,35,7,6,41
"13957","0700-0759",2020-06-08,37,1,6,43
"13958","0700-0759",2020-06-09,33,2,6,39
"13959","0700-0759",2020-06-10,35,3,6,41
"13960","0700-0759",2020-06-11,39,4,5,44
"13961","0700-0759",2020-06-12,39,5,6,45
"13962","0700-0759",2020-06-13,39,6,5,44
"13963","0700-0759",2020-06-14,36,7,5,41
"13964","0700-0759",2020-06-15,39,1,6,45
"13965","0700-0759",2020-06-16,36,2,6,42
"13966","0700-0759",2020-06-17,36,3,6,42
"13967","0700-0759",2020-06-18,40,4,6,46
"13968","0700-0759",2020-06-19,39,5,7,46
"13969","0700-0759",2020-06-20,39,6,6,45
"13970","0700-0759",2020-06-21,37,7,5,42
"13971","0700-0759",2020-06-22,39,1,6,45
"13972","0700-0759",2020-06-23,36,2,6,42
"13973","0700-0759",2020-06-24,36,3,6,42
"13974","0700-0759",2020-06-25,41,4,6,47
"13975","0700-0759",2020-06-26,41,5,7,48
"13976","0700-0759",2020-06-27,43,6,6,49
"13977","0700-0759",2020-06-28,34,7,6,40
"13978","0700-0759",2020-06-29,38,1,8,46
"13979","0700-0759",2020-06-30,34,2,6,40
"13980","0800-0859",2020-06-01,25,1,15,40
"13981","0800-0859",2020-06-02,20,2,17,37
"13982","0800-0859",2020-06-03,22,3,18,40
"13983","0800-0859",2020-06-04,20,4,17,37
"13984","0800-0859",2020-06-05,24,5,19,43
"13985","0800-0859",2020-06-06,21,6,17,38
"13986","0800-0859",2020-06-07,25,7,20,45
"13987","0800-0859",2020-06-08,27,1,21,48
"13988","0800-0859",2020-06-09,22,2,17,39
"13989","0800-0859",2020-06-10,24,3,19,43
"13990","0800-0859",2020-06-11,26,4,21,47
"13991","0800-0859",2020-06-12,28,5,22,50
"13992","0800-0859",2020-06-13,26,6,21,47
"13993","0800-0859",2020-06-14,29,7,20,49
"13994","0800-0859",2020-06-15,32,1,23,55
"13995","0800-0859",2020-06-16,27,2,20,47
"13996","0800-0859",2020-06-17,28,3,20,48
"13997","0800-0859",2020-06-18,29,4,23,52
"13998","0800-0859",2020-06-19,31,5,23,54
"13999","0800-0859",2020-06-20,30,6,22,52
"14000","0800-0859",2020-06-21,30,7,21,51
"14001","0800-0859",2020-06-22,32,1,23,55
"14002","0800-0859",2020-06-23,29,2,20,49
"14003","0800-0859",2020-06-24,30,3,20,50
"14004","0800-0859",2020-06-25,34,4,23,57
"14005","0800-0859",2020-06-26,36,5,23,59
"14006","0800-0859",2020-06-27,33,6,23,56
"14007","0800-0859",2020-06-28,40,7,21,61
"14008","0800-0859",2020-06-29,42,1,23,65
"14009","0800-0859",2020-06-30,37,2,21,58
"14010","0900-0959",2020-06-01,28,1,11,39
"14011","0900-0959",2020-06-02,25,2,8,33
"14012","0900-0959",2020-06-03,24,3,10,34
"14013","0900-0959",2020-06-04,25,4,11,36
"14014","0900-0959",2020-06-05,25,5,14,39
"14015","0900-0959",2020-06-06,25,6,13,38
"14016","0900-0959",2020-06-07,27,7,16,43
"14017","0900-0959",2020-06-08,28,1,19,47
"14018","0900-0959",2020-06-09,27,2,14,41
"14019","0900-0959",2020-06-10,28,3,15,43
"14020","0900-0959",2020-06-11,30,4,19,49
"14021","0900-0959",2020-06-12,28,5,21,49
"14022","0900-0959",2020-06-13,28,6,21,49
"14023","0900-0959",2020-06-14,28,7,20,48
"14024","0900-0959",2020-06-15,29,1,23,52
"14025","0900-0959",2020-06-16,28,2,19,47
"14026","0900-0959",2020-06-17,28,3,19,47
"14027","0900-0959",2020-06-18,30,4,21,51
"14028","0900-0959",2020-06-19,28,5,22,50
"14029","0900-0959",2020-06-20,28,6,23,51
"14030","0900-0959",2020-06-21,29,7,20,49
"14031","0900-0959",2020-06-22,29,1,22,51
"14032","0900-0959",2020-06-23,27,2,19,46
"14033","0900-0959",2020-06-24,27,3,19,46
"14034","0900-0959",2020-06-25,30,4,21,51
"14035","0900-0959",2020-06-26,28,5,23,51
"14036","0900-0959",2020-06-27,28,6,23,51
"14037","0900-0959",2020-06-28,25,7,23,48
"14038","0900-0959",2020-06-29,25,1,27,52
"14039","0900-0959",2020-06-30,23,2,24,47
"14040","1000-1059",2020-06-01,20,1,22,42
"14041","1000-1059",2020-06-02,23,2,16,39
"14042","1000-1059",2020-06-03,23,3,18,41
"14043","1000-1059",2020-06-04,25,4,19,44
"14044","1000-1059",2020-06-05,26,5,18,44
"14045","1000-1059",2020-06-06,23,6,18,41
"14046","1000-1059",2020-06-07,27,7,17,44
"14047","1000-1059",2020-06-08,28,1,18,46
"14048","1000-1059",2020-06-09,25,2,18,43
"14049","1000-1059",2020-06-10,25,3,19,44
"14050","1000-1059",2020-06-11,26,4,18,44
"14051","1000-1059",2020-06-12,29,5,17,46
"14052","1000-1059",2020-06-13,26,6,17,43
"14053","1000-1059",2020-06-14,27,7,16,43
"14054","1000-1059",2020-06-15,27,1,17,44
"14055","1000-1059",2020-06-16,25,2,17,42
"14056","1000-1059",2020-06-17,25,3,18,43
"14057","1000-1059",2020-06-18,27,4,18,45
"14058","1000-1059",2020-06-19,27,5,17,44
"14059","1000-1059",2020-06-20,25,6,17,42
"14060","1000-1059",2020-06-21,28,7,15,43
"14061","1000-1059",2020-06-22,29,1,16,45
"14062","1000-1059",2020-06-23,26,2,17,43
"14063","1000-1059",2020-06-24,26,3,18,44
"14064","1000-1059",2020-06-25,28,4,19,47
"14065","1000-1059",2020-06-26,28,5,19,47
"14066","1000-1059",2020-06-27,27,6,18,45
"14067","1000-1059",2020-06-28,34,7,22,56
"14068","1000-1059",2020-06-29,34,1,20,54
"14069","1000-1059",2020-06-30,33,2,21,54
"14070","1100-1159",2020-06-01,17,1,20,37
"14071","1100-1159",2020-06-02,15,2,19,34
"14072","1100-1159",2020-06-03,15,3,20,35
"14073","1100-1159",2020-06-04,18,4,24,42
"14074","1100-1159",2020-06-05,20,5,22,42
"14075","1100-1159",2020-06-06,18,6,23,41
"14076","1100-1159",2020-06-07,21,7,25,46
"14077","1100-1159",2020-06-08,20,1,25,45
"14078","1100-1159",2020-06-09,19,2,22,41
"14079","1100-1159",2020-06-10,21,3,23,44
"14080","1100-1159",2020-06-11,19,4,27,46
"14081","1100-1159",2020-06-12,20,5,27,47
"14082","1100-1159",2020-06-13,20,6,26,46
"14083","1100-1159",2020-06-14,21,7,27,48
"14084","1100-1159",2020-06-15,23,1,27,50
"14085","1100-1159",2020-06-16,22,2,23,45
"14086","1100-1159",2020-06-17,23,3,24,47
"14087","1100-1159",2020-06-18,23,4,26,49
"14088","1100-1159",2020-06-19,23,5,27,50
"14089","1100-1159",2020-06-20,23,6,26,49
"14090","1100-1159",2020-06-21,22,7,26,48
"14091","1100-1159",2020-06-22,23,1,28,51
"14092","1100-1159",2020-06-23,21,2,22,43
"14093","1100-1159",2020-06-24,22,3,23,45
"14094","1100-1159",2020-06-25,24,4,28,52
"14095","1100-1159",2020-06-26,25,5,28,53
"14096","1100-1159",2020-06-27,24,6,27,51
"14097","1100-1159",2020-06-28,25,7,28,53
"14098","1100-1159",2020-06-29,25,1,28,53
"14099","1100-1159",2020-06-30,24,2,24,48
"14100","1200-1259",2020-06-01,16,1,17,33
"14101","1200-1259",2020-06-02,20,2,17,37
"14102","1200-1259",2020-06-03,20,3,17,37
"14103","1200-1259",2020-06-04,23,4,18,41
"14104","1200-1259",2020-06-05,22,5,19,41
"14105","1200-1259",2020-06-06,23,6,17,40
"14106","1200-1259",2020-06-07,22,7,20,42
"14107","1200-1259",2020-06-08,21,1,19,40
"14108","1200-1259",2020-06-09,21,2,19,40
"14109","1200-1259",2020-06-10,21,3,20,41
"14110","1200-1259",2020-06-11,23,4,18,41
"14111","1200-1259",2020-06-12,21,5,18,39
"14112","1200-1259",2020-06-13,22,6,18,40
"14113","1200-1259",2020-06-14,24,7,19,43
"14114","1200-1259",2020-06-15,21,1,20,41
"14115","1200-1259",2020-06-16,21,2,19,40
"14116","1200-1259",2020-06-17,21,3,20,41
"14117","1200-1259",2020-06-18,22,4,20,42
"14118","1200-1259",2020-06-19,21,5,20,41
"14119","1200-1259",2020-06-20,22,6,20,42
"14120","1200-1259",2020-06-21,22,7,20,42
"14121","1200-1259",2020-06-22,21,1,22,43
"14122","1200-1259",2020-06-23,21,2,20,41
"14123","1200-1259",2020-06-24,21,3,21,42
"14124","1200-1259",2020-06-25,22,4,21,43
"14125","1200-1259",2020-06-26,21,5,21,42
"14126","1200-1259",2020-06-27,20,6,22,42
"14127","1200-1259",2020-06-28,22,7,21,43
"14128","1200-1259",2020-06-29,20,1,24,44
"14129","1200-1259",2020-06-30,20,2,23,43
"14130","1300-1359",2020-06-01,19,1,17,36
"14131","1300-1359",2020-06-02,18,2,17,35
"14132","1300-1359",2020-06-03,20,3,17,37
"14133","1300-1359",2020-06-04,18,4,18,36
"14134","1300-1359",2020-06-05,21,5,18,39
"14135","1300-1359",2020-06-06,19,6,19,38
"14136","1300-1359",2020-06-07,23,7,20,43
"14137","1300-1359",2020-06-08,23,1,20,43
"14138","1300-1359",2020-06-09,22,2,20,42
"14139","1300-1359",2020-06-10,24,3,20,44
"14140","1300-1359",2020-06-11,25,4,20,45
"14141","1300-1359",2020-06-12,27,5,20,47
"14142","1300-1359",2020-06-13,27,6,21,48
"14143","1300-1359",2020-06-14,26,7,21,47
"14144","1300-1359",2020-06-15,27,1,21,48
"14145","1300-1359",2020-06-16,25,2,21,46
"14146","1300-1359",2020-06-17,27,3,21,48
"14147","1300-1359",2020-06-18,27,4,23,50
"14148","1300-1359",2020-06-19,28,5,21,49
"14149","1300-1359",2020-06-20,28,6,22,50
"14150","1300-1359",2020-06-21,28,7,23,51
"14151","1300-1359",2020-06-22,29,1,21,50
"14152","1300-1359",2020-06-23,26,2,21,47
"14153","1300-1359",2020-06-24,27,3,21,48
"14154","1300-1359",2020-06-25,28,4,24,52
"14155","1300-1359",2020-06-26,29,5,22,51
"14156","1300-1359",2020-06-27,30,6,22,52
"14157","1300-1359",2020-06-28,28,7,21,49
"14158","1300-1359",2020-06-29,28,1,20,48
"14159","1300-1359",2020-06-30,26,2,17,43
"14160","1400-1459",2020-06-01,12,1,20,32
"14161","1400-1459",2020-06-02,13,2,19,32
"14162","1400-1459",2020-06-03,14,3,21,35
"14163","1400-1459",2020-06-04,13,4,25,38
"14164","1400-1459",2020-06-05,13,5,25,38
"14165","1400-1459",2020-06-06,13,6,25,38
"14166","1400-1459",2020-06-07,14,7,24,38
"14167","1400-1459",2020-06-08,15,1,24,39
"14168","1400-1459",2020-06-09,15,2,22,37
"14169","1400-1459",2020-06-10,17,3,24,41
"14170","1400-1459",2020-06-11,13,4,26,39
"14171","1400-1459",2020-06-12,13,5,24,37
"14172","1400-1459",2020-06-13,13,6,26,39
"14173","1400-1459",2020-06-14,13,7,26,39
"14174","1400-1459",2020-06-15,13,1,26,39
"14175","1400-1459",2020-06-16,13,2,23,36
"14176","1400-1459",2020-06-17,15,3,25,40
"14177","1400-1459",2020-06-18,14,4,24,38
"14178","1400-1459",2020-06-19,13,5,25,38
"14179","1400-1459",2020-06-20,14,6,26,40
"14180","1400-1459",2020-06-21,14,7,24,38
"14181","1400-1459",2020-06-22,13,1,24,37
"14182","1400-1459",2020-06-23,13,2,24,37
"14183","1400-1459",2020-06-24,15,3,26,41
"14184","1400-1459",2020-06-25,15,4,24,39
"14185","1400-1459",2020-06-26,14,5,25,39
"14186","1400-1459",2020-06-27,17,6,27,44
"14187","1400-1459",2020-06-28,20,7,26,46
"14188","1400-1459",2020-06-29,17,1,27,44
"14189","1400-1459",2020-06-30,15,2,26,41
"14190","1500-1559",2020-06-01,16,1,11,27
"14191","1500-1559",2020-06-02,16,2,12,28
"14192","1500-1559",2020-06-03,16,3,11,27
"14193","1500-1559",2020-06-04,21,4,12,33
"14194","1500-1559",2020-06-05,21,5,14,35
"14195","1500-1559",2020-06-06,20,6,13,33
"14196","1500-1559",2020-06-07,21,7,16,37
"14197","1500-1559",2020-06-08,23,1,19,42
"14198","1500-1559",2020-06-09,21,2,17,38
"14199","1500-1559",2020-06-10,21,3,17,38
"14200","1500-1559",2020-06-11,25,4,18,43
"14201","1500-1559",2020-06-12,23,5,21,44
"14202","1500-1559",2020-06-13,24,6,20,44
"14203","1500-1559",2020-06-14,27,7,20,47
"14204","1500-1559",2020-06-15,26,1,22,48
"14205","1500-1559",2020-06-16,24,2,20,44
"14206","1500-1559",2020-06-17,24,3,19,43
"14207","1500-1559",2020-06-18,26,4,22,48
"14208","1500-1559",2020-06-19,26,5,22,48
"14209","1500-1559",2020-06-20,26,6,21,47
"14210","1500-1559",2020-06-21,26,7,23,49
"14211","1500-1559",2020-06-22,26,1,24,50
"14212","1500-1559",2020-06-23,24,2,20,44
"14213","1500-1559",2020-06-24,24,3,19,43
"14214","1500-1559",2020-06-25,26,4,23,49
"14215","1500-1559",2020-06-26,27,5,23,50
"14216","1500-1559",2020-06-27,27,6,23,50
"14217","1500-1559",2020-06-28,28,7,26,54
"14218","1500-1559",2020-06-29,29,1,28,57
"14219","1500-1559",2020-06-30,24,2,22,46
"14220","1600-1659",2020-06-01,11,1,24,35
"14221","1600-1659",2020-06-02,10,2,23,33
"14222","1600-1659",2020-06-03,10,3,26,36
"14223","1600-1659",2020-06-04,13,4,23,36
"14224","1600-1659",2020-06-05,12,5,25,37
"14225","1600-1659",2020-06-06,12,6,24,36
"14226","1600-1659",2020-06-07,16,7,23,39
"14227","1600-1659",2020-06-08,17,1,23,40
"14228","1600-1659",2020-06-09,14,2,22,36
"14229","1600-1659",2020-06-10,14,3,25,39
"14230","1600-1659",2020-06-11,17,4,25,42
"14231","1600-1659",2020-06-12,17,5,25,42
"14232","1600-1659",2020-06-13,16,6,25,41
"14233","1600-1659",2020-06-14,17,7,25,42
"14234","1600-1659",2020-06-15,17,1,24,41
"14235","1600-1659",2020-06-16,14,2,24,38
"14236","1600-1659",2020-06-17,14,3,26,40
"14237","1600-1659",2020-06-18,16,4,27,43
"14238","1600-1659",2020-06-19,17,5,25,42
"14239","1600-1659",2020-06-20,16,6,25,41
"14240","1600-1659",2020-06-21,17,7,28,45
"14241","1600-1659",2020-06-22,18,1,25,43
"14242","1600-1659",2020-06-23,15,2,25,40
"14243","1600-1659",2020-06-24,15,3,27,42
"14244","1600-1659",2020-06-25,18,4,29,47
"14245","1600-1659",2020-06-26,19,5,28,47
"14246","1600-1659",2020-06-27,18,6,29,47
"14247","1600-1659",2020-06-28,15,7,34,49
"14248","1600-1659",2020-06-29,16,1,30,46
"14249","1600-1659",2020-06-30,12,2,28,40
"14250","1700-1759",2020-06-01,24,1,15,39
"14251","1700-1759",2020-06-02,24,2,18,42
"14252","1700-1759",2020-06-03,24,3,17,41
"14253","1700-1759",2020-06-04,21,4,19,40
"14254","1700-1759",2020-06-05,24,5,20,44
"14255","1700-1759",2020-06-06,22,6,17,39
"14256","1700-1759",2020-06-07,25,7,24,49
"14257","1700-1759",2020-06-08,26,1,27,53
"14258","1700-1759",2020-06-09,24,2,24,48
"14259","1700-1759",2020-06-10,25,3,23,48
"14260","1700-1759",2020-06-11,24,4,26,50
"14261","1700-1759",2020-06-12,25,5,26,51
"14262","1700-1759",2020-06-13,24,6,23,47
"14263","1700-1759",2020-06-14,26,7,29,55
"14264","1700-1759",2020-06-15,27,1,28,55
"14265","1700-1759",2020-06-16,25,2,25,50
"14266","1700-1759",2020-06-17,25,3,25,50
"14267","1700-1759",2020-06-18,25,4,25,50
"14268","1700-1759",2020-06-19,26,5,28,54
"14269","1700-1759",2020-06-20,25,6,25,50
"14270","1700-1759",2020-06-21,26,7,27,53
"14271","1700-1759",2020-06-22,27,1,29,56
"14272","1700-1759",2020-06-23,26,2,26,52
"14273","1700-1759",2020-06-24,26,3,26,52
"14274","1700-1759",2020-06-25,26,4,29,55
"14275","1700-1759",2020-06-26,27,5,31,58
"14276","1700-1759",2020-06-27,26,6,27,53
"14277","1700-1759",2020-06-28,33,7,22,55
"14278","1700-1759",2020-06-29,33,1,23,56
"14279","1700-1759",2020-06-30,30,2,20,50
"14280","1800-1859",2020-06-01,10,1,22,32
"14281","1800-1859",2020-06-02,16,2,18,34
"14282","1800-1859",2020-06-03,16,3,18,34
"14283","1800-1859",2020-06-04,21,4,20,41
"14284","1800-1859",2020-06-05,20,5,20,40
"14285","1800-1859",2020-06-06,19,6,19,38
"14286","1800-1859",2020-06-07,23,7,24,47
"14287","1800-1859",2020-06-08,22,1,22,44
"14288","1800-1859",2020-06-09,21,2,21,42
"14289","1800-1859",2020-06-10,21,3,23,44
"14290","1800-1859",2020-06-11,23,4,25,48
"14291","1800-1859",2020-06-12,23,5,26,49
"14292","1800-1859",2020-06-13,21,6,25,46
"14293","1800-1859",2020-06-14,23,7,27,50
"14294","1800-1859",2020-06-15,22,1,26,48
"14295","1800-1859",2020-06-16,22,2,25,47
"14296","1800-1859",2020-06-17,22,3,26,48
"14297","1800-1859",2020-06-18,21,4,26,47
"14298","1800-1859",2020-06-19,23,5,26,49
"14299","1800-1859",2020-06-20,20,6,26,46
"14300","1800-1859",2020-06-21,22,7,25,47
"14301","1800-1859",2020-06-22,23,1,26,49
"14302","1800-1859",2020-06-23,22,2,24,46
"14303","1800-1859",2020-06-24,22,3,24,46
"14304","1800-1859",2020-06-25,22,4,25,47
"14305","1800-1859",2020-06-26,23,5,26,49
"14306","1800-1859",2020-06-27,20,6,25,45
"14307","1800-1859",2020-06-28,21,7,25,46
"14308","1800-1859",2020-06-29,22,1,26,48
"14309","1800-1859",2020-06-30,19,2,24,43
"14310","1900-1959",2020-06-01,19,1,17,36
"14311","1900-1959",2020-06-02,14,2,18,32
"14312","1900-1959",2020-06-03,14,3,18,32
"14313","1900-1959",2020-06-04,16,4,16,32
"14314","1900-1959",2020-06-05,18,5,19,37
"14315","1900-1959",2020-06-06,14,6,15,29
"14316","1900-1959",2020-06-07,22,7,20,42
"14317","1900-1959",2020-06-08,22,1,21,43
"14318","1900-1959",2020-06-09,17,2,18,35
"14319","1900-1959",2020-06-10,18,3,19,37
"14320","1900-1959",2020-06-11,20,4,20,40
"14321","1900-1959",2020-06-12,21,5,20,41
"14322","1900-1959",2020-06-13,17,6,20,37
"14323","1900-1959",2020-06-14,23,7,23,46
"14324","1900-1959",2020-06-15,24,1,25,49
"14325","1900-1959",2020-06-16,20,2,23,43
"14326","1900-1959",2020-06-17,21,3,23,44
"14327","1900-1959",2020-06-18,22,4,23,45
"14328","1900-1959",2020-06-19,24,5,24,48
"14329","1900-1959",2020-06-20,20,6,22,42
"14330","1900-1959",2020-06-21,22,7,24,46
"14331","1900-1959",2020-06-22,24,1,26,50
"14332","1900-1959",2020-06-23,20,2,24,44
"14333","1900-1959",2020-06-24,20,3,24,44
"14334","1900-1959",2020-06-25,22,4,25,47
"14335","1900-1959",2020-06-26,25,5,26,51
"14336","1900-1959",2020-06-27,21,6,24,45
"14337","1900-1959",2020-06-28,27,7,30,57
"14338","1900-1959",2020-06-29,28,1,30,58
"14339","1900-1959",2020-06-30,22,2,26,48
"14340","2000-2059",2020-06-01,12,1,15,27
"14341","2000-2059",2020-06-02,10,2,16,26
"14342","2000-2059",2020-06-03,9,3,15,24
"14343","2000-2059",2020-06-04,10,4,19,29
"14344","2000-2059",2020-06-05,11,5,18,29
"14345","2000-2059",2020-06-06,12,6,18,30
"14346","2000-2059",2020-06-07,11,7,21,32
"14347","2000-2059",2020-06-08,10,1,19,29
"14348","2000-2059",2020-06-09,9,2,18,27
"14349","2000-2059",2020-06-10,11,3,18,29
"14350","2000-2059",2020-06-11,13,4,19,32
"14351","2000-2059",2020-06-12,12,5,18,30
"14352","2000-2059",2020-06-13,16,6,18,34
"14353","2000-2059",2020-06-14,13,7,19,32
"14354","2000-2059",2020-06-15,11,1,17,28
"14355","2000-2059",2020-06-16,11,2,17,28
"14356","2000-2059",2020-06-17,11,3,18,29
"14357","2000-2059",2020-06-18,12,4,17,29
"14358","2000-2059",2020-06-19,12,5,18,30
"14359","2000-2059",2020-06-20,15,6,18,33
"14360","2000-2059",2020-06-21,14,7,18,32
"14361","2000-2059",2020-06-22,13,1,19,32
"14362","2000-2059",2020-06-23,13,2,18,31
"14363","2000-2059",2020-06-24,13,3,19,32
"14364","2000-2059",2020-06-25,14,4,18,32
"14365","2000-2059",2020-06-26,12,5,20,32
"14366","2000-2059",2020-06-27,15,6,21,36
"14367","2000-2059",2020-06-28,15,7,22,37
"14368","2000-2059",2020-06-29,14,1,23,37
"14369","2000-2059",2020-06-30,13,2,20,33
"14370","2100-2159",2020-06-02,4,2,22,26
"14371","2100-2159",2020-06-03,4,3,25,29
"14372","2100-2159",2020-06-04,6,4,28,34
"14373","2100-2159",2020-06-05,5,5,30,35
"14374","2100-2159",2020-06-06,7,6,29,36
"14375","2100-2159",2020-06-07,6,7,32,38
"14376","2100-2159",2020-06-08,4,1,33,37
"14377","2100-2159",2020-06-09,5,2,29,34
"14378","2100-2159",2020-06-10,5,3,32,37
"14379","2100-2159",2020-06-11,5,4,33,38
"14380","2100-2159",2020-06-12,5,5,34,39
"14381","2100-2159",2020-06-13,7,6,32,39
"14382","2100-2159",2020-06-14,5,7,33,38
"14383","2100-2159",2020-06-15,4,1,34,38
"14384","2100-2159",2020-06-16,5,2,31,36
"14385","2100-2159",2020-06-17,6,3,32,38
"14386","2100-2159",2020-06-18,5,4,33,38
"14387","2100-2159",2020-06-19,5,5,34,39
"14388","2100-2159",2020-06-20,7,6,33,40
"14389","2100-2159",2020-06-21,5,7,34,39
"14390","2100-2159",2020-06-22,4,1,34,38
"14391","2100-2159",2020-06-23,5,2,31,36
"14392","2100-2159",2020-06-24,6,3,31,37
"14393","2100-2159",2020-06-25,5,4,34,39
"14394","2100-2159",2020-06-26,5,5,34,39
"14395","2100-2159",2020-06-27,7,6,33,40
"14396","2100-2159",2020-06-28,5,7,39,44
"14397","2100-2159",2020-06-29,4,1,38,42
"14398","2100-2159",2020-06-30,5,2,35,40
"14399","2200-2259",2020-06-01,2,1,13,15
"14400","2200-2259",2020-06-02,3,2,14,17
"14401","2200-2259",2020-06-03,3,3,13,16
"14402","2200-2259",2020-06-04,6,4,14,20
"14403","2200-2259",2020-06-05,6,5,15,21
"14404","2200-2259",2020-06-06,6,6,13,19
"14405","2200-2259",2020-06-07,7,7,17,24
"14406","2200-2259",2020-06-08,6,1,16,22
"14407","2200-2259",2020-06-09,6,2,14,20
"14408","2200-2259",2020-06-10,6,3,15,21
"14409","2200-2259",2020-06-11,9,4,16,25
"14410","2200-2259",2020-06-12,8,5,15,23
"14411","2200-2259",2020-06-13,8,6,15,23
"14412","2200-2259",2020-06-14,9,7,18,27
"14413","2200-2259",2020-06-15,8,1,16,24
"14414","2200-2259",2020-06-16,8,2,15,23
"14415","2200-2259",2020-06-17,8,3,16,24
"14416","2200-2259",2020-06-18,11,4,16,27
"14417","2200-2259",2020-06-19,8,5,17,25
"14418","2200-2259",2020-06-20,8,6,16,24
"14419","2200-2259",2020-06-21,11,7,17,28
"14420","2200-2259",2020-06-22,8,1,17,25
"14421","2200-2259",2020-06-23,8,2,16,24
"14422","2200-2259",2020-06-24,8,3,17,25
"14423","2200-2259",2020-06-25,12,4,17,29
"14424","2200-2259",2020-06-26,8,5,17,25
"14425","2200-2259",2020-06-27,8,6,17,25
"14426","2200-2259",2020-06-28,12,7,16,28
"14427","2200-2259",2020-06-29,8,1,16,24
"14428","2200-2259",2020-06-30,8,2,13,21
"14429","2300-2359",2020-06-01,4,1,5,9
"14430","2300-2359",2020-06-02,3,2,5,8
"14431","2300-2359",2020-06-03,3,3,4,7
"14432","2300-2359",2020-06-04,5,4,7,12
"14433","2300-2359",2020-06-05,4,5,7,11
"14434","2300-2359",2020-06-06,4,6,7,11
"14435","2300-2359",2020-06-07,4,7,5,9
"14436","2300-2359",2020-06-08,4,1,6,10
"14437","2300-2359",2020-06-09,4,2,5,9
"14438","2300-2359",2020-06-10,4,3,5,9
"14439","2300-2359",2020-06-11,3,4,5,8
"14440","2300-2359",2020-06-12,4,5,6,10
"14441","2300-2359",2020-06-13,3,6,6,9
"14442","2300-2359",2020-06-14,3,7,4,7
"14443","2300-2359",2020-06-15,3,1,6,9
"14444","2300-2359",2020-06-16,3,2,5,8
"14445","2300-2359",2020-06-17,3,3,5,8
"14446","2300-2359",2020-06-18,3,4,7,10
"14447","2300-2359",2020-06-19,4,5,6,10
"14448","2300-2359",2020-06-20,3,6,7,10
"14449","2300-2359",2020-06-21,5,7,8,13
"14450","2300-2359",2020-06-22,5,1,7,12
"14451","2300-2359",2020-06-23,5,2,6,11
"14452","2300-2359",2020-06-24,5,3,6,11
"14453","2300-2359",2020-06-25,5,4,8,13
"14454","2300-2359",2020-06-26,6,5,6,12
"14455","2300-2359",2020-06-27,5,6,6,11
"14456","2300-2359",2020-06-28,5,7,9,14
"14457","2300-2359",2020-06-29,5,1,8,13
"14458","2300-2359",2020-06-30,5,2,4,9
"14459","2100-2159",2020-06-01,NA,1,21,NA
"14460","0001-0559",2020-07-01,4,3,9,13
"14461","0001-0559",2020-07-02,5,4,7,12
"14462","0001-0559",2020-07-03,5,5,7,12
"14463","0001-0559",2020-07-04,5,6,7,12
"14464","0001-0559",2020-07-05,5,7,8,13
"14465","0001-0559",2020-07-06,5,1,7,12
"14466","0001-0559",2020-07-07,6,2,9,15
"14467","0001-0559",2020-07-08,6,3,9,15
"14468","0001-0559",2020-07-09,6,4,9,15
"14469","0001-0559",2020-07-10,6,5,9,15
"14470","0001-0559",2020-07-11,6,6,10,16
"14471","0001-0559",2020-07-12,6,7,10,16
"14472","0001-0559",2020-07-13,6,1,9,15
"14473","0001-0559",2020-07-14,6,2,9,15
"14474","0001-0559",2020-07-15,6,3,9,15
"14475","0001-0559",2020-07-16,6,4,9,15
"14476","0001-0559",2020-07-17,6,5,9,15
"14477","0001-0559",2020-07-18,6,6,10,16
"14478","0001-0559",2020-07-19,6,7,10,16
"14479","0001-0559",2020-07-20,6,1,9,15
"14480","0001-0559",2020-07-21,6,2,9,15
"14481","0001-0559",2020-07-22,6,3,9,15
"14482","0001-0559",2020-07-23,6,4,9,15
"14483","0001-0559",2020-07-24,6,5,9,15
"14484","0001-0559",2020-07-25,6,6,10,16
"14485","0001-0559",2020-07-26,6,7,9,15
"14486","0001-0559",2020-07-27,6,1,10,16
"14487","0001-0559",2020-07-28,6,2,9,15
"14488","0001-0559",2020-07-29,6,3,9,15
"14489","0001-0559",2020-07-30,6,4,9,15
"14490","0001-0559",2020-07-31,6,5,9,15
"14491","0600-0659",2020-07-01,18,3,8,26
"14492","0600-0659",2020-07-02,24,4,12,36
"14493","0600-0659",2020-07-03,25,5,11,36
"14494","0600-0659",2020-07-04,23,6,11,34
"14495","0600-0659",2020-07-05,22,7,12,34
"14496","0600-0659",2020-07-06,25,1,11,36
"14497","0600-0659",2020-07-07,25,2,14,39
"14498","0600-0659",2020-07-08,26,3,14,40
"14499","0600-0659",2020-07-09,28,4,15,43
"14500","0600-0659",2020-07-10,30,5,14,44
"14501","0600-0659",2020-07-11,32,6,15,47
"14502","0600-0659",2020-07-12,27,7,16,43
"14503","0600-0659",2020-07-13,31,1,15,46
"14504","0600-0659",2020-07-14,26,2,15,41
"14505","0600-0659",2020-07-15,26,3,15,41
"14506","0600-0659",2020-07-16,29,4,16,45
"14507","0600-0659",2020-07-17,31,5,15,46
"14508","0600-0659",2020-07-18,32,6,15,47
"14509","0600-0659",2020-07-19,27,7,16,43
"14510","0600-0659",2020-07-20,31,1,15,46
"14511","0600-0659",2020-07-21,26,2,15,41
"14512","0600-0659",2020-07-22,26,3,15,41
"14513","0600-0659",2020-07-23,29,4,16,45
"14514","0600-0659",2020-07-24,31,5,15,46
"14515","0600-0659",2020-07-25,32,6,15,47
"14516","0600-0659",2020-07-26,27,7,16,43
"14517","0600-0659",2020-07-27,31,1,15,46
"14518","0600-0659",2020-07-28,26,2,15,41
"14519","0600-0659",2020-07-29,26,3,15,41
"14520","0600-0659",2020-07-30,29,4,14,43
"14521","0600-0659",2020-07-31,30,5,13,43
"14522","0700-0759",2020-07-01,38,3,9,47
"14523","0700-0759",2020-07-02,43,4,14,57
"14524","0700-0759",2020-07-03,40,5,14,54
"14525","0700-0759",2020-07-04,37,6,12,49
"14526","0700-0759",2020-07-05,40,7,13,53
"14527","0700-0759",2020-07-06,47,1,14,61
"14528","0700-0759",2020-07-07,46,2,10,56
"14529","0700-0759",2020-07-08,46,3,10,56
"14530","0700-0759",2020-07-09,49,4,12,61
"14531","0700-0759",2020-07-10,50,5,12,62
"14532","0700-0759",2020-07-11,52,6,12,64
"14533","0700-0759",2020-07-12,49,7,10,59
"14534","0700-0759",2020-07-13,50,1,12,62
"14535","0700-0759",2020-07-14,48,2,10,58
"14536","0700-0759",2020-07-15,48,3,10,58
"14537","0700-0759",2020-07-16,50,4,12,62
"14538","0700-0759",2020-07-17,49,5,12,61
"14539","0700-0759",2020-07-18,51,6,12,63
"14540","0700-0759",2020-07-19,48,7,10,58
"14541","0700-0759",2020-07-20,49,1,12,61
"14542","0700-0759",2020-07-21,47,2,10,57
"14543","0700-0759",2020-07-22,48,3,10,58
"14544","0700-0759",2020-07-23,50,4,12,62
"14545","0700-0759",2020-07-24,49,5,12,61
"14546","0700-0759",2020-07-25,51,6,12,63
"14547","0700-0759",2020-07-26,48,7,10,58
"14548","0700-0759",2020-07-27,49,1,12,61
"14549","0700-0759",2020-07-28,47,2,10,57
"14550","0700-0759",2020-07-29,47,3,10,57
"14551","0700-0759",2020-07-30,50,4,12,62
"14552","0700-0759",2020-07-31,49,5,12,61
"14553","0800-0859",2020-07-01,41,3,22,63
"14554","0800-0859",2020-07-02,49,4,23,72
"14555","0800-0859",2020-07-03,50,5,23,73
"14556","0800-0859",2020-07-04,44,6,20,64
"14557","0800-0859",2020-07-05,48,7,22,70
"14558","0800-0859",2020-07-06,48,1,27,75
"14559","0800-0859",2020-07-07,47,2,29,76
"14560","0800-0859",2020-07-08,46,3,29,75
"14561","0800-0859",2020-07-09,51,4,32,83
"14562","0800-0859",2020-07-10,51,5,35,86
"14563","0800-0859",2020-07-11,48,6,35,83
"14564","0800-0859",2020-07-12,49,7,33,82
"14565","0800-0859",2020-07-13,50,1,34,84
"14566","0800-0859",2020-07-14,46,2,30,76
"14567","0800-0859",2020-07-15,46,3,30,76
"14568","0800-0859",2020-07-16,51,4,33,84
"14569","0800-0859",2020-07-17,51,5,35,86
"14570","0800-0859",2020-07-18,48,6,35,83
"14571","0800-0859",2020-07-19,49,7,33,82
"14572","0800-0859",2020-07-20,50,1,34,84
"14573","0800-0859",2020-07-21,46,2,30,76
"14574","0800-0859",2020-07-22,46,3,30,76
"14575","0800-0859",2020-07-23,51,4,32,83
"14576","0800-0859",2020-07-24,51,5,34,85
"14577","0800-0859",2020-07-25,48,6,34,82
"14578","0800-0859",2020-07-26,49,7,32,81
"14579","0800-0859",2020-07-27,51,1,33,84
"14580","0800-0859",2020-07-28,46,2,29,75
"14581","0800-0859",2020-07-29,47,3,29,76
"14582","0800-0859",2020-07-30,51,4,32,83
"14583","0800-0859",2020-07-31,51,5,34,85
"14584","0900-0959",2020-07-01,26,3,26,52
"14585","0900-0959",2020-07-02,35,4,27,62
"14586","0900-0959",2020-07-03,33,5,29,62
"14587","0900-0959",2020-07-04,26,6,27,53
"14588","0900-0959",2020-07-05,31,7,28,59
"14589","0900-0959",2020-07-06,43,1,30,73
"14590","0900-0959",2020-07-07,45,2,30,75
"14591","0900-0959",2020-07-08,50,3,28,78
"14592","0900-0959",2020-07-09,51,4,29,80
"14593","0900-0959",2020-07-10,53,5,29,82
"14594","0900-0959",2020-07-11,49,6,28,77
"14595","0900-0959",2020-07-12,52,7,28,80
"14596","0900-0959",2020-07-13,52,1,30,82
"14597","0900-0959",2020-07-14,46,2,29,75
"14598","0900-0959",2020-07-15,50,3,28,78
"14599","0900-0959",2020-07-16,52,4,29,81
"14600","0900-0959",2020-07-17,53,5,29,82
"14601","0900-0959",2020-07-18,49,6,28,77
"14602","0900-0959",2020-07-19,52,7,28,80
"14603","0900-0959",2020-07-20,52,1,30,82
"14604","0900-0959",2020-07-21,46,2,29,75
"14605","0900-0959",2020-07-22,50,3,28,78
"14606","0900-0959",2020-07-23,50,4,29,79
"14607","0900-0959",2020-07-24,51,5,29,80
"14608","0900-0959",2020-07-25,47,6,28,75
"14609","0900-0959",2020-07-26,50,7,28,78
"14610","0900-0959",2020-07-27,50,1,31,81
"14611","0900-0959",2020-07-28,44,2,29,73
"14612","0900-0959",2020-07-29,48,3,28,76
"14613","0900-0959",2020-07-30,48,4,29,77
"14614","0900-0959",2020-07-31,47,5,29,76
"14615","1000-1059",2020-07-01,35,3,23,58
"14616","1000-1059",2020-07-02,37,4,31,68
"14617","1000-1059",2020-07-03,35,5,27,62
"14618","1000-1059",2020-07-04,33,6,24,57
"14619","1000-1059",2020-07-05,37,7,30,67
"14620","1000-1059",2020-07-06,38,1,33,71
"14621","1000-1059",2020-07-07,37,2,34,71
"14622","1000-1059",2020-07-08,37,3,36,73
"14623","1000-1059",2020-07-09,40,4,38,78
"14624","1000-1059",2020-07-10,40,5,37,77
"14625","1000-1059",2020-07-11,39,6,37,76
"14626","1000-1059",2020-07-12,41,7,38,79
"14627","1000-1059",2020-07-13,41,1,37,78
"14628","1000-1059",2020-07-14,38,2,34,72
"14629","1000-1059",2020-07-15,38,3,35,73
"14630","1000-1059",2020-07-16,40,4,38,78
"14631","1000-1059",2020-07-17,39,5,37,76
"14632","1000-1059",2020-07-18,39,6,37,76
"14633","1000-1059",2020-07-19,40,7,38,78
"14634","1000-1059",2020-07-20,40,1,37,77
"14635","1000-1059",2020-07-21,38,2,34,72
"14636","1000-1059",2020-07-22,38,3,35,73
"14637","1000-1059",2020-07-23,41,4,38,79
"14638","1000-1059",2020-07-24,40,5,37,77
"14639","1000-1059",2020-07-25,39,6,37,76
"14640","1000-1059",2020-07-26,41,7,38,79
"14641","1000-1059",2020-07-27,41,1,36,77
"14642","1000-1059",2020-07-28,38,2,34,72
"14643","1000-1059",2020-07-29,38,3,35,73
"14644","1000-1059",2020-07-30,40,4,38,78
"14645","1000-1059",2020-07-31,40,5,37,77
"14646","1100-1159",2020-07-01,32,3,31,63
"14647","1100-1159",2020-07-02,32,4,36,68
"14648","1100-1159",2020-07-03,35,5,36,71
"14649","1100-1159",2020-07-04,32,6,32,64
"14650","1100-1159",2020-07-05,36,7,32,68
"14651","1100-1159",2020-07-06,41,1,38,79
"14652","1100-1159",2020-07-07,41,2,33,74
"14653","1100-1159",2020-07-08,44,3,35,79
"14654","1100-1159",2020-07-09,44,4,36,80
"14655","1100-1159",2020-07-10,46,5,37,83
"14656","1100-1159",2020-07-11,42,6,33,75
"14657","1100-1159",2020-07-12,45,7,36,81
"14658","1100-1159",2020-07-13,46,1,36,82
"14659","1100-1159",2020-07-14,41,2,34,75
"14660","1100-1159",2020-07-15,43,3,36,79
"14661","1100-1159",2020-07-16,44,4,36,80
"14662","1100-1159",2020-07-17,46,5,37,83
"14663","1100-1159",2020-07-18,41,6,34,75
"14664","1100-1159",2020-07-19,47,7,36,83
"14665","1100-1159",2020-07-20,48,1,36,84
"14666","1100-1159",2020-07-21,41,2,34,75
"14667","1100-1159",2020-07-22,43,3,36,79
"14668","1100-1159",2020-07-23,44,4,36,80
"14669","1100-1159",2020-07-24,46,5,37,83
"14670","1100-1159",2020-07-25,40,6,33,73
"14671","1100-1159",2020-07-26,44,7,36,80
"14672","1100-1159",2020-07-27,44,1,38,82
"14673","1100-1159",2020-07-28,40,2,34,74
"14674","1100-1159",2020-07-29,42,3,35,77
"14675","1100-1159",2020-07-30,41,4,36,77
"14676","1100-1159",2020-07-31,43,5,36,79
"14677","1200-1259",2020-07-01,25,3,26,51
"14678","1200-1259",2020-07-02,28,4,31,59
"14679","1200-1259",2020-07-03,30,5,31,61
"14680","1200-1259",2020-07-04,29,6,29,58
"14681","1200-1259",2020-07-05,30,7,32,62
"14682","1200-1259",2020-07-06,30,1,40,70
"14683","1200-1259",2020-07-07,28,2,40,68
"14684","1200-1259",2020-07-08,30,3,45,75
"14685","1200-1259",2020-07-09,34,4,45,79
"14686","1200-1259",2020-07-10,34,5,45,79
"14687","1200-1259",2020-07-11,33,6,44,77
"14688","1200-1259",2020-07-12,34,7,44,78
"14689","1200-1259",2020-07-13,36,1,45,81
"14690","1200-1259",2020-07-14,30,2,41,71
"14691","1200-1259",2020-07-15,33,3,45,78
"14692","1200-1259",2020-07-16,35,4,45,80
"14693","1200-1259",2020-07-17,36,5,44,80
"14694","1200-1259",2020-07-18,35,6,43,78
"14695","1200-1259",2020-07-19,34,7,44,78
"14696","1200-1259",2020-07-20,36,1,45,81
"14697","1200-1259",2020-07-21,30,2,40,70
"14698","1200-1259",2020-07-22,33,3,44,77
"14699","1200-1259",2020-07-23,36,4,44,80
"14700","1200-1259",2020-07-24,36,5,44,80
"14701","1200-1259",2020-07-25,35,6,41,76
"14702","1200-1259",2020-07-26,35,7,42,77
"14703","1200-1259",2020-07-27,37,1,42,79
"14704","1200-1259",2020-07-28,31,2,39,70
"14705","1200-1259",2020-07-29,32,3,44,76
"14706","1200-1259",2020-07-30,33,4,42,75
"14707","1200-1259",2020-07-31,34,5,43,77
"14708","1300-1359",2020-07-01,29,3,23,52
"14709","1300-1359",2020-07-02,38,4,28,66
"14710","1300-1359",2020-07-03,36,5,26,62
"14711","1300-1359",2020-07-04,30,6,25,55
"14712","1300-1359",2020-07-05,37,7,30,67
"14713","1300-1359",2020-07-06,45,1,29,74
"14714","1300-1359",2020-07-07,46,2,28,74
"14715","1300-1359",2020-07-08,47,3,29,76
"14716","1300-1359",2020-07-09,49,4,36,85
"14717","1300-1359",2020-07-10,48,5,35,83
"14718","1300-1359",2020-07-11,47,6,36,83
"14719","1300-1359",2020-07-12,49,7,37,86
"14720","1300-1359",2020-07-13,46,1,37,83
"14721","1300-1359",2020-07-14,45,2,29,74
"14722","1300-1359",2020-07-15,46,3,31,77
"14723","1300-1359",2020-07-16,48,4,37,85
"14724","1300-1359",2020-07-17,47,5,36,83
"14725","1300-1359",2020-07-18,47,6,37,84
"14726","1300-1359",2020-07-19,51,7,38,89
"14727","1300-1359",2020-07-20,48,1,38,86
"14728","1300-1359",2020-07-21,47,2,30,77
"14729","1300-1359",2020-07-22,48,3,32,80
"14730","1300-1359",2020-07-23,48,4,38,86
"14731","1300-1359",2020-07-24,48,5,36,84
"14732","1300-1359",2020-07-25,47,6,37,84
"14733","1300-1359",2020-07-26,48,7,37,85
"14734","1300-1359",2020-07-27,45,1,36,81
"14735","1300-1359",2020-07-28,45,2,29,74
"14736","1300-1359",2020-07-29,47,3,30,77
"14737","1300-1359",2020-07-30,48,4,35,83
"14738","1300-1359",2020-07-31,46,5,33,79
"14739","1400-1459",2020-07-01,21,3,30,51
"14740","1400-1459",2020-07-02,23,4,30,53
"14741","1400-1459",2020-07-03,22,5,31,53
"14742","1400-1459",2020-07-04,22,6,30,52
"14743","1400-1459",2020-07-05,25,7,31,56
"14744","1400-1459",2020-07-06,26,1,33,59
"14745","1400-1459",2020-07-07,33,2,31,64
"14746","1400-1459",2020-07-08,33,3,34,67
"14747","1400-1459",2020-07-09,36,4,30,66
"14748","1400-1459",2020-07-10,35,5,32,67
"14749","1400-1459",2020-07-11,34,6,34,68
"14750","1400-1459",2020-07-12,35,7,32,67
"14751","1400-1459",2020-07-13,37,1,32,69
"14752","1400-1459",2020-07-14,32,2,31,63
"14753","1400-1459",2020-07-15,32,3,34,66
"14754","1400-1459",2020-07-16,37,4,31,68
"14755","1400-1459",2020-07-17,36,5,32,68
"14756","1400-1459",2020-07-18,33,6,34,67
"14757","1400-1459",2020-07-19,35,7,32,67
"14758","1400-1459",2020-07-20,37,1,32,69
"14759","1400-1459",2020-07-21,32,2,31,63
"14760","1400-1459",2020-07-22,32,3,34,66
"14761","1400-1459",2020-07-23,37,4,30,67
"14762","1400-1459",2020-07-24,36,5,31,67
"14763","1400-1459",2020-07-25,33,6,33,66
"14764","1400-1459",2020-07-26,35,7,31,66
"14765","1400-1459",2020-07-27,37,1,31,68
"14766","1400-1459",2020-07-28,32,2,30,62
"14767","1400-1459",2020-07-29,32,3,33,65
"14768","1400-1459",2020-07-30,32,4,29,61
"14769","1400-1459",2020-07-31,32,5,29,61
"14770","1500-1559",2020-07-01,33,3,22,55
"14771","1500-1559",2020-07-02,38,4,29,67
"14772","1500-1559",2020-07-03,39,5,29,68
"14773","1500-1559",2020-07-04,34,6,24,58
"14774","1500-1559",2020-07-05,37,7,28,65
"14775","1500-1559",2020-07-06,40,1,35,75
"14776","1500-1559",2020-07-07,34,2,37,71
"14777","1500-1559",2020-07-08,37,3,38,75
"14778","1500-1559",2020-07-09,38,4,43,81
"14779","1500-1559",2020-07-10,39,5,43,82
"14780","1500-1559",2020-07-11,38,6,40,78
"14781","1500-1559",2020-07-12,41,7,40,81
"14782","1500-1559",2020-07-13,39,1,41,80
"14783","1500-1559",2020-07-14,35,2,37,72
"14784","1500-1559",2020-07-15,38,3,37,75
"14785","1500-1559",2020-07-16,39,4,42,81
"14786","1500-1559",2020-07-17,39,5,42,81
"14787","1500-1559",2020-07-18,38,6,38,76
"14788","1500-1559",2020-07-19,41,7,39,80
"14789","1500-1559",2020-07-20,39,1,40,79
"14790","1500-1559",2020-07-21,35,2,35,70
"14791","1500-1559",2020-07-22,38,3,36,74
"14792","1500-1559",2020-07-23,36,4,40,76
"14793","1500-1559",2020-07-24,37,5,41,78
"14794","1500-1559",2020-07-25,35,6,37,72
"14795","1500-1559",2020-07-26,38,7,38,76
"14796","1500-1559",2020-07-27,37,1,40,77
"14797","1500-1559",2020-07-28,33,2,35,68
"14798","1500-1559",2020-07-29,36,3,36,72
"14799","1500-1559",2020-07-30,36,4,40,76
"14800","1500-1559",2020-07-31,37,5,41,78
"14801","1600-1659",2020-07-01,13,3,34,47
"14802","1600-1659",2020-07-02,13,4,40,53
"14803","1600-1659",2020-07-03,13,5,39,52
"14804","1600-1659",2020-07-04,12,6,33,45
"14805","1600-1659",2020-07-05,15,7,39,54
"14806","1600-1659",2020-07-06,16,1,41,57
"14807","1600-1659",2020-07-07,15,2,44,59
"14808","1600-1659",2020-07-08,15,3,44,59
"14809","1600-1659",2020-07-09,18,4,44,62
"14810","1600-1659",2020-07-10,20,5,42,62
"14811","1600-1659",2020-07-11,18,6,40,58
"14812","1600-1659",2020-07-12,18,7,44,62
"14813","1600-1659",2020-07-13,19,1,43,62
"14814","1600-1659",2020-07-14,15,2,41,56
"14815","1600-1659",2020-07-15,15,3,41,56
"14816","1600-1659",2020-07-16,18,4,43,61
"14817","1600-1659",2020-07-17,20,5,42,62
"14818","1600-1659",2020-07-18,17,6,40,57
"14819","1600-1659",2020-07-19,18,7,44,62
"14820","1600-1659",2020-07-20,19,1,43,62
"14821","1600-1659",2020-07-21,15,2,43,58
"14822","1600-1659",2020-07-22,15,3,43,58
"14823","1600-1659",2020-07-23,18,4,44,62
"14824","1600-1659",2020-07-24,19,5,42,61
"14825","1600-1659",2020-07-25,17,6,41,58
"14826","1600-1659",2020-07-26,18,7,44,62
"14827","1600-1659",2020-07-27,18,1,42,60
"14828","1600-1659",2020-07-28,15,2,42,57
"14829","1600-1659",2020-07-29,15,3,42,57
"14830","1600-1659",2020-07-30,18,4,44,62
"14831","1600-1659",2020-07-31,19,5,42,61
"14832","1700-1759",2020-07-01,33,3,19,52
"14833","1700-1759",2020-07-02,34,4,18,52
"14834","1700-1759",2020-07-03,36,5,19,55
"14835","1700-1759",2020-07-04,22,6,19,41
"14836","1700-1759",2020-07-05,36,7,19,55
"14837","1700-1759",2020-07-06,44,1,20,64
"14838","1700-1759",2020-07-07,47,2,23,70
"14839","1700-1759",2020-07-08,45,3,24,69
"14840","1700-1759",2020-07-09,47,4,25,72
"14841","1700-1759",2020-07-10,47,5,28,75
"14842","1700-1759",2020-07-11,42,6,27,69
"14843","1700-1759",2020-07-12,47,7,27,74
"14844","1700-1759",2020-07-13,47,1,27,74
"14845","1700-1759",2020-07-14,46,2,24,70
"14846","1700-1759",2020-07-15,45,3,25,70
"14847","1700-1759",2020-07-16,47,4,26,73
"14848","1700-1759",2020-07-17,47,5,28,75
"14849","1700-1759",2020-07-18,42,6,26,68
"14850","1700-1759",2020-07-19,47,7,27,74
"14851","1700-1759",2020-07-20,47,1,27,74
"14852","1700-1759",2020-07-21,46,2,23,69
"14853","1700-1759",2020-07-22,45,3,24,69
"14854","1700-1759",2020-07-23,46,4,24,70
"14855","1700-1759",2020-07-24,46,5,26,72
"14856","1700-1759",2020-07-25,41,6,24,65
"14857","1700-1759",2020-07-26,46,7,25,71
"14858","1700-1759",2020-07-27,46,1,25,71
"14859","1700-1759",2020-07-28,45,2,23,68
"14860","1700-1759",2020-07-29,44,3,24,68
"14861","1700-1759",2020-07-30,44,4,22,66
"14862","1700-1759",2020-07-31,44,5,24,68
"14863","1800-1859",2020-07-01,25,3,30,55
"14864","1800-1859",2020-07-02,25,4,33,58
"14865","1800-1859",2020-07-03,27,5,33,60
"14866","1800-1859",2020-07-04,23,6,26,49
"14867","1800-1859",2020-07-05,27,7,31,58
"14868","1800-1859",2020-07-06,27,1,39,66
"14869","1800-1859",2020-07-07,30,2,37,67
"14870","1800-1859",2020-07-08,30,3,37,67
"14871","1800-1859",2020-07-09,32,4,39,71
"14872","1800-1859",2020-07-10,34,5,41,75
"14873","1800-1859",2020-07-11,31,6,37,68
"14874","1800-1859",2020-07-12,34,7,40,74
"14875","1800-1859",2020-07-13,33,1,41,74
"14876","1800-1859",2020-07-14,31,2,37,68
"14877","1800-1859",2020-07-15,30,3,38,68
"14878","1800-1859",2020-07-16,33,4,40,73
"14879","1800-1859",2020-07-17,34,5,41,75
"14880","1800-1859",2020-07-18,31,6,37,68
"14881","1800-1859",2020-07-19,34,7,41,75
"14882","1800-1859",2020-07-20,33,1,42,75
"14883","1800-1859",2020-07-21,31,2,38,69
"14884","1800-1859",2020-07-22,30,3,39,69
"14885","1800-1859",2020-07-23,32,4,40,72
"14886","1800-1859",2020-07-24,33,5,41,74
"14887","1800-1859",2020-07-25,29,6,36,65
"14888","1800-1859",2020-07-26,32,7,40,72
"14889","1800-1859",2020-07-27,33,1,41,74
"14890","1800-1859",2020-07-28,30,2,37,67
"14891","1800-1859",2020-07-29,29,3,38,67
"14892","1800-1859",2020-07-30,31,4,39,70
"14893","1800-1859",2020-07-31,33,5,40,73
"14894","1900-1959",2020-07-01,23,3,31,54
"14895","1900-1959",2020-07-02,26,4,30,56
"14896","1900-1959",2020-07-03,28,5,34,62
"14897","1900-1959",2020-07-04,17,6,27,44
"14898","1900-1959",2020-07-05,27,7,34,61
"14899","1900-1959",2020-07-06,27,1,35,62
"14900","1900-1959",2020-07-07,20,2,40,60
"14901","1900-1959",2020-07-08,20,3,39,59
"14902","1900-1959",2020-07-09,24,4,42,66
"14903","1900-1959",2020-07-10,24,5,42,66
"14904","1900-1959",2020-07-11,17,6,39,56
"14905","1900-1959",2020-07-12,23,7,41,64
"14906","1900-1959",2020-07-13,24,1,43,67
"14907","1900-1959",2020-07-14,19,2,41,60
"14908","1900-1959",2020-07-15,19,3,40,59
"14909","1900-1959",2020-07-16,23,4,42,65
"14910","1900-1959",2020-07-17,24,5,43,67
"14911","1900-1959",2020-07-18,17,6,39,56
"14912","1900-1959",2020-07-19,24,7,42,66
"14913","1900-1959",2020-07-20,25,1,44,69
"14914","1900-1959",2020-07-21,20,2,42,62
"14915","1900-1959",2020-07-22,20,3,41,61
"14916","1900-1959",2020-07-23,24,4,43,67
"14917","1900-1959",2020-07-24,25,5,44,69
"14918","1900-1959",2020-07-25,17,6,40,57
"14919","1900-1959",2020-07-26,23,7,41,64
"14920","1900-1959",2020-07-27,24,1,44,68
"14921","1900-1959",2020-07-28,19,2,41,60
"14922","1900-1959",2020-07-29,19,3,40,59
"14923","1900-1959",2020-07-30,22,4,42,64
"14924","1900-1959",2020-07-31,24,5,42,66
"14925","2000-2059",2020-07-01,16,3,25,41
"14926","2000-2059",2020-07-02,21,4,32,53
"14927","2000-2059",2020-07-03,18,5,32,50
"14928","2000-2059",2020-07-04,16,6,26,42
"14929","2000-2059",2020-07-05,19,7,34,53
"14930","2000-2059",2020-07-06,20,1,32,52
"14931","2000-2059",2020-07-07,23,2,35,58
"14932","2000-2059",2020-07-08,23,3,36,59
"14933","2000-2059",2020-07-09,26,4,40,66
"14934","2000-2059",2020-07-10,29,5,40,69
"14935","2000-2059",2020-07-11,29,6,38,67
"14936","2000-2059",2020-07-12,29,7,42,71
"14937","2000-2059",2020-07-13,29,1,40,69
"14938","2000-2059",2020-07-14,27,2,36,63
"14939","2000-2059",2020-07-15,27,3,36,63
"14940","2000-2059",2020-07-16,30,4,41,71
"14941","2000-2059",2020-07-17,29,5,41,70
"14942","2000-2059",2020-07-18,29,6,38,67
"14943","2000-2059",2020-07-19,29,7,43,72
"14944","2000-2059",2020-07-20,29,1,41,70
"14945","2000-2059",2020-07-21,27,2,37,64
"14946","2000-2059",2020-07-22,27,3,37,64
"14947","2000-2059",2020-07-23,29,4,43,72
"14948","2000-2059",2020-07-24,28,5,43,71
"14949","2000-2059",2020-07-25,28,6,39,67
"14950","2000-2059",2020-07-26,28,7,42,70
"14951","2000-2059",2020-07-27,29,1,41,70
"14952","2000-2059",2020-07-28,26,2,37,63
"14953","2000-2059",2020-07-29,26,3,37,63
"14954","2000-2059",2020-07-30,29,4,38,67
"14955","2000-2059",2020-07-31,27,5,40,67
"14956","2100-2159",2020-07-01,8,3,41,49
"14957","2100-2159",2020-07-02,6,4,40,46
"14958","2100-2159",2020-07-03,7,5,40,47
"14959","2100-2159",2020-07-04,8,6,28,36
"14960","2100-2159",2020-07-05,9,7,41,50
"14961","2100-2159",2020-07-06,8,1,43,51
"14962","2100-2159",2020-07-07,8,2,34,42
"14963","2100-2159",2020-07-08,9,3,35,44
"14964","2100-2159",2020-07-09,8,4,39,47
"14965","2100-2159",2020-07-10,9,5,42,51
"14966","2100-2159",2020-07-11,10,6,33,43
"14967","2100-2159",2020-07-12,10,7,41,51
"14968","2100-2159",2020-07-13,9,1,41,50
"14969","2100-2159",2020-07-14,8,2,35,43
"14970","2100-2159",2020-07-15,10,3,36,46
"14971","2100-2159",2020-07-16,8,4,40,48
"14972","2100-2159",2020-07-17,9,5,41,50
"14973","2100-2159",2020-07-18,10,6,33,43
"14974","2100-2159",2020-07-19,11,7,41,52
"14975","2100-2159",2020-07-20,10,1,41,51
"14976","2100-2159",2020-07-21,8,2,35,43
"14977","2100-2159",2020-07-22,10,3,36,46
"14978","2100-2159",2020-07-23,9,4,38,47
"14979","2100-2159",2020-07-24,10,5,39,49
"14980","2100-2159",2020-07-25,10,6,31,41
"14981","2100-2159",2020-07-26,9,7,39,48
"14982","2100-2159",2020-07-27,9,1,39,48
"14983","2100-2159",2020-07-28,8,2,33,41
"14984","2100-2159",2020-07-29,10,3,34,44
"14985","2100-2159",2020-07-30,8,4,38,46
"14986","2100-2159",2020-07-31,9,5,38,47
"14987","2200-2259",2020-07-01,11,3,17,28
"14988","2200-2259",2020-07-02,13,4,21,34
"14989","2200-2259",2020-07-03,11,5,21,32
"14990","2200-2259",2020-07-04,10,6,20,30
"14991","2200-2259",2020-07-05,12,7,21,33
"14992","2200-2259",2020-07-06,10,1,24,34
"14993","2200-2259",2020-07-07,11,2,27,38
"14994","2200-2259",2020-07-08,12,3,28,40
"14995","2200-2259",2020-07-09,14,4,31,45
"14996","2200-2259",2020-07-10,12,5,32,44
"14997","2200-2259",2020-07-11,11,6,31,42
"14998","2200-2259",2020-07-12,14,7,32,46
"14999","2200-2259",2020-07-13,12,1,32,44
"15000","2200-2259",2020-07-14,11,2,28,39
"15001","2200-2259",2020-07-15,11,3,29,40
"15002","2200-2259",2020-07-16,14,4,32,46
"15003","2200-2259",2020-07-17,12,5,32,44
"15004","2200-2259",2020-07-18,11,6,31,42
"15005","2200-2259",2020-07-19,14,7,33,47
"15006","2200-2259",2020-07-20,12,1,33,45
"15007","2200-2259",2020-07-21,11,2,28,39
"15008","2200-2259",2020-07-22,11,3,29,40
"15009","2200-2259",2020-07-23,14,4,32,46
"15010","2200-2259",2020-07-24,12,5,32,44
"15011","2200-2259",2020-07-25,11,6,30,41
"15012","2200-2259",2020-07-26,14,7,31,45
"15013","2200-2259",2020-07-27,12,1,31,43
"15014","2200-2259",2020-07-28,11,2,27,38
"15015","2200-2259",2020-07-29,11,3,28,39
"15016","2200-2259",2020-07-30,12,4,27,39
"15017","2200-2259",2020-07-31,10,5,27,37
"15018","2300-2359",2020-07-01,4,3,9,13
"15019","2300-2359",2020-07-02,6,4,14,20
"15020","2300-2359",2020-07-03,6,5,14,20
"15021","2300-2359",2020-07-04,6,6,9,15
"15022","2300-2359",2020-07-05,6,7,14,20
"15023","2300-2359",2020-07-06,7,1,16,23
"15024","2300-2359",2020-07-07,5,2,12,17
"15025","2300-2359",2020-07-08,6,3,12,18
"15026","2300-2359",2020-07-09,6,4,16,22
"15027","2300-2359",2020-07-10,6,5,18,24
"15028","2300-2359",2020-07-11,5,6,14,19
"15029","2300-2359",2020-07-12,6,7,18,24
"15030","2300-2359",2020-07-13,6,1,18,24
"15031","2300-2359",2020-07-14,5,2,14,19
"15032","2300-2359",2020-07-15,6,3,14,20
"15033","2300-2359",2020-07-16,6,4,18,24
"15034","2300-2359",2020-07-17,6,5,18,24
"15035","2300-2359",2020-07-18,5,6,14,19
"15036","2300-2359",2020-07-19,6,7,18,24
"15037","2300-2359",2020-07-20,6,1,18,24
"15038","2300-2359",2020-07-21,5,2,14,19
"15039","2300-2359",2020-07-22,6,3,14,20
"15040","2300-2359",2020-07-23,6,4,18,24
"15041","2300-2359",2020-07-24,6,5,18,24
"15042","2300-2359",2020-07-25,5,6,13,18
"15043","2300-2359",2020-07-26,6,7,18,24
"15044","2300-2359",2020-07-27,6,1,18,24
"15045","2300-2359",2020-07-28,5,2,14,19
"15046","2300-2359",2020-07-29,6,3,14,20
"15047","2300-2359",2020-07-30,6,4,18,24
"15048","2300-2359",2020-07-31,6,5,18,24
"15049","0001-0559",2020-08-01,7,6,10,17
"15050","0001-0559",2020-08-02,6,7,11,17
"15051","0001-0559",2020-08-03,7,1,12,19
"15052","0001-0559",2020-08-04,7,2,11,18
"15053","0001-0559",2020-08-05,5,3,7,12
"15054","0001-0559",2020-08-06,5,4,11,16
"15055","0001-0559",2020-08-07,7,5,13,20
"15056","0001-0559",2020-08-08,7,6,12,19
"15057","0001-0559",2020-08-09,6,7,12,18
"15058","0001-0559",2020-08-10,7,1,12,19
"15059","0001-0559",2020-08-11,8,2,12,20
"15060","0001-0559",2020-08-12,6,3,9,15
"15061","0001-0559",2020-08-13,6,4,14,20
"15062","0001-0559",2020-08-14,8,5,16,24
"15063","0001-0559",2020-08-15,8,6,13,21
"15064","0001-0559",2020-08-16,8,7,14,22
"15065","0001-0559",2020-08-17,8,1,14,22
"15066","0001-0559",2020-08-18,8,2,11,19
"15067","0001-0559",2020-08-19,6,3,8,14
"15068","0001-0559",2020-08-20,6,4,12,18
"15069","0001-0559",2020-08-21,8,5,14,22
"15070","0001-0559",2020-08-22,8,6,13,21
"15071","0001-0559",2020-08-23,8,7,13,21
"15072","0001-0559",2020-08-24,8,1,13,21
"15073","0001-0559",2020-08-25,8,2,11,19
"15074","0001-0559",2020-08-26,6,3,8,14
"15075","0001-0559",2020-08-27,6,4,13,19
"15076","0001-0559",2020-08-28,8,5,14,22
"15077","0001-0559",2020-08-29,8,6,13,21
"15078","0001-0559",2020-08-30,8,7,13,21
"15079","0001-0559",2020-08-31,8,1,13,21
"15080","0600-0659",2020-08-01,32,6,14,46
"15081","0600-0659",2020-08-02,28,7,15,43
"15082","0600-0659",2020-08-03,36,1,13,49
"15083","0600-0659",2020-08-04,31,2,13,44
"15084","0600-0659",2020-08-05,31,3,12,43
"15085","0600-0659",2020-08-06,36,4,13,49
"15086","0600-0659",2020-08-07,36,5,12,48
"15087","0600-0659",2020-08-08,35,6,12,47
"15088","0600-0659",2020-08-09,31,7,13,44
"15089","0600-0659",2020-08-10,35,1,12,47
"15090","0600-0659",2020-08-11,36,2,11,47
"15091","0600-0659",2020-08-12,37,3,10,47
"15092","0600-0659",2020-08-13,41,4,12,53
"15093","0600-0659",2020-08-14,41,5,11,52
"15094","0600-0659",2020-08-15,39,6,10,49
"15095","0600-0659",2020-08-16,34,7,11,45
"15096","0600-0659",2020-08-17,41,1,10,51
"15097","0600-0659",2020-08-18,35,2,10,45
"15098","0600-0659",2020-08-19,35,3,10,45
"15099","0600-0659",2020-08-20,40,4,10,50
"15100","0600-0659",2020-08-21,40,5,10,50
"15101","0600-0659",2020-08-22,37,6,10,47
"15102","0600-0659",2020-08-23,33,7,10,43
"15103","0600-0659",2020-08-24,40,1,10,50
"15104","0600-0659",2020-08-25,35,2,10,45
"15105","0600-0659",2020-08-26,35,3,10,45
"15106","0600-0659",2020-08-27,40,4,10,50
"15107","0600-0659",2020-08-28,40,5,10,50
"15108","0600-0659",2020-08-29,37,6,10,47
"15109","0600-0659",2020-08-30,33,7,10,43
"15110","0600-0659",2020-08-31,40,1,11,51
"15111","0700-0759",2020-08-01,56,6,11,67
"15112","0700-0759",2020-08-02,53,7,9,62
"15113","0700-0759",2020-08-03,55,1,11,66
"15114","0700-0759",2020-08-04,54,2,8,62
"15115","0700-0759",2020-08-05,53,3,7,60
"15116","0700-0759",2020-08-06,57,4,10,67
"15117","0700-0759",2020-08-07,56,5,9,65
"15118","0700-0759",2020-08-08,56,6,9,65
"15119","0700-0759",2020-08-09,55,7,7,62
"15120","0700-0759",2020-08-10,55,1,9,64
"15121","0700-0759",2020-08-11,50,2,13,63
"15122","0700-0759",2020-08-12,52,3,14,66
"15123","0700-0759",2020-08-13,55,4,16,71
"15124","0700-0759",2020-08-14,54,5,15,69
"15125","0700-0759",2020-08-15,53,6,14,67
"15126","0700-0759",2020-08-16,53,7,13,66
"15127","0700-0759",2020-08-17,53,1,15,68
"15128","0700-0759",2020-08-18,51,2,13,64
"15129","0700-0759",2020-08-19,51,3,13,64
"15130","0700-0759",2020-08-20,56,4,16,72
"15131","0700-0759",2020-08-21,54,5,15,69
"15132","0700-0759",2020-08-22,53,6,14,67
"15133","0700-0759",2020-08-23,53,7,13,66
"15134","0700-0759",2020-08-24,54,1,15,69
"15135","0700-0759",2020-08-25,52,2,13,65
"15136","0700-0759",2020-08-26,51,3,13,64
"15137","0700-0759",2020-08-27,56,4,16,72
"15138","0700-0759",2020-08-28,54,5,15,69
"15139","0700-0759",2020-08-29,53,6,14,67
"15140","0700-0759",2020-08-30,53,7,13,66
"15141","0700-0759",2020-08-31,54,1,15,69
"15142","0800-0859",2020-08-01,52,6,34,86
"15143","0800-0859",2020-08-02,50,7,34,84
"15144","0800-0859",2020-08-03,53,1,35,88
"15145","0800-0859",2020-08-04,49,2,33,82
"15146","0800-0859",2020-08-05,51,3,34,85
"15147","0800-0859",2020-08-06,53,4,38,91
"15148","0800-0859",2020-08-07,55,5,39,94
"15149","0800-0859",2020-08-08,53,6,35,88
"15150","0800-0859",2020-08-09,54,7,37,91
"15151","0800-0859",2020-08-10,55,1,38,93
"15152","0800-0859",2020-08-11,54,2,28,82
"15153","0800-0859",2020-08-12,55,3,31,86
"15154","0800-0859",2020-08-13,56,4,34,90
"15155","0800-0859",2020-08-14,57,5,35,92
"15156","0800-0859",2020-08-15,54,6,31,85
"15157","0800-0859",2020-08-16,56,7,33,89
"15158","0800-0859",2020-08-17,57,1,35,92
"15159","0800-0859",2020-08-18,57,2,30,87
"15160","0800-0859",2020-08-19,56,3,31,87
"15161","0800-0859",2020-08-20,57,4,33,90
"15162","0800-0859",2020-08-21,56,5,33,89
"15163","0800-0859",2020-08-22,56,6,31,87
"15164","0800-0859",2020-08-23,58,7,32,90
"15165","0800-0859",2020-08-24,56,1,33,89
"15166","0800-0859",2020-08-25,56,2,30,86
"15167","0800-0859",2020-08-26,56,3,31,87
"15168","0800-0859",2020-08-27,57,4,33,90
"15169","0800-0859",2020-08-28,56,5,33,89
"15170","0800-0859",2020-08-29,56,6,31,87
"15171","0800-0859",2020-08-30,58,7,32,90
"15172","0800-0859",2020-08-31,56,1,33,89
"15173","0900-0959",2020-08-01,48,6,32,80
"15174","0900-0959",2020-08-02,51,7,29,80
"15175","0900-0959",2020-08-03,51,1,33,84
"15176","0900-0959",2020-08-04,49,2,33,82
"15177","0900-0959",2020-08-05,52,3,31,83
"15178","0900-0959",2020-08-06,54,4,33,87
"15179","0900-0959",2020-08-07,53,5,32,85
"15180","0900-0959",2020-08-08,50,6,34,84
"15181","0900-0959",2020-08-09,52,7,31,83
"15182","0900-0959",2020-08-10,53,1,31,84
"15183","0900-0959",2020-08-11,50,2,33,83
"15184","0900-0959",2020-08-12,50,3,33,83
"15185","0900-0959",2020-08-13,52,4,34,86
"15186","0900-0959",2020-08-14,52,5,33,85
"15187","0900-0959",2020-08-15,49,6,36,85
"15188","0900-0959",2020-08-16,51,7,30,81
"15189","0900-0959",2020-08-17,51,1,32,83
"15190","0900-0959",2020-08-18,44,2,34,78
"15191","0900-0959",2020-08-19,45,3,33,78
"15192","0900-0959",2020-08-20,49,4,35,84
"15193","0900-0959",2020-08-21,49,5,33,82
"15194","0900-0959",2020-08-22,46,6,37,83
"15195","0900-0959",2020-08-23,48,7,32,80
"15196","0900-0959",2020-08-24,49,1,33,82
"15197","0900-0959",2020-08-25,44,2,35,79
"15198","0900-0959",2020-08-26,45,3,33,78
"15199","0900-0959",2020-08-27,49,4,35,84
"15200","0900-0959",2020-08-28,49,5,33,82
"15201","0900-0959",2020-08-29,46,6,37,83
"15202","0900-0959",2020-08-30,48,7,32,80
"15203","0900-0959",2020-08-31,49,1,33,82
"15204","1000-1059",2020-08-01,40,6,39,79
"15205","1000-1059",2020-08-02,42,7,40,82
"15206","1000-1059",2020-08-03,44,1,40,84
"15207","1000-1059",2020-08-04,41,2,38,79
"15208","1000-1059",2020-08-05,39,3,38,77
"15209","1000-1059",2020-08-06,42,4,39,81
"15210","1000-1059",2020-08-07,41,5,39,80
"15211","1000-1059",2020-08-08,39,6,39,78
"15212","1000-1059",2020-08-09,41,7,39,80
"15213","1000-1059",2020-08-10,40,1,40,80
"15214","1000-1059",2020-08-11,34,2,35,69
"15215","1000-1059",2020-08-12,34,3,33,67
"15216","1000-1059",2020-08-13,37,4,35,72
"15217","1000-1059",2020-08-14,36,5,36,72
"15218","1000-1059",2020-08-15,34,6,36,70
"15219","1000-1059",2020-08-16,36,7,34,70
"15220","1000-1059",2020-08-17,36,1,36,72
"15221","1000-1059",2020-08-18,36,2,33,69
"15222","1000-1059",2020-08-19,36,3,33,69
"15223","1000-1059",2020-08-20,40,4,36,76
"15224","1000-1059",2020-08-21,38,5,33,71
"15225","1000-1059",2020-08-22,35,6,34,69
"15226","1000-1059",2020-08-23,38,7,33,71
"15227","1000-1059",2020-08-24,38,1,34,72
"15228","1000-1059",2020-08-25,36,2,33,69
"15229","1000-1059",2020-08-26,36,3,33,69
"15230","1000-1059",2020-08-27,40,4,36,76
"15231","1000-1059",2020-08-28,38,5,33,71
"15232","1000-1059",2020-08-29,35,6,34,69
"15233","1000-1059",2020-08-30,38,7,33,71
"15234","1000-1059",2020-08-31,38,1,34,72
"15235","1100-1159",2020-08-01,44,6,30,74
"15236","1100-1159",2020-08-02,45,7,32,77
"15237","1100-1159",2020-08-03,47,1,33,80
"15238","1100-1159",2020-08-04,43,2,30,73
"15239","1100-1159",2020-08-05,41,3,31,72
"15240","1100-1159",2020-08-06,43,4,33,76
"15241","1100-1159",2020-08-07,44,5,32,76
"15242","1100-1159",2020-08-08,41,6,31,72
"15243","1100-1159",2020-08-09,43,7,32,75
"15244","1100-1159",2020-08-10,44,1,32,76
"15245","1100-1159",2020-08-11,40,2,37,77
"15246","1100-1159",2020-08-12,40,3,38,78
"15247","1100-1159",2020-08-13,42,4,40,82
"15248","1100-1159",2020-08-14,43,5,39,82
"15249","1100-1159",2020-08-15,41,6,36,77
"15250","1100-1159",2020-08-16,43,7,38,81
"15251","1100-1159",2020-08-17,42,1,39,81
"15252","1100-1159",2020-08-18,38,2,37,75
"15253","1100-1159",2020-08-19,38,3,37,75
"15254","1100-1159",2020-08-20,41,4,40,81
"15255","1100-1159",2020-08-21,41,5,38,79
"15256","1100-1159",2020-08-22,39,6,35,74
"15257","1100-1159",2020-08-23,43,7,38,81
"15258","1100-1159",2020-08-24,41,1,38,79
"15259","1100-1159",2020-08-25,38,2,37,75
"15260","1100-1159",2020-08-26,38,3,37,75
"15261","1100-1159",2020-08-27,41,4,40,81
"15262","1100-1159",2020-08-28,41,5,38,79
"15263","1100-1159",2020-08-29,39,6,35,74
"15264","1100-1159",2020-08-30,43,7,38,81
"15265","1100-1159",2020-08-31,41,1,38,79
"15266","1200-1259",2020-08-01,31,6,46,77
"15267","1200-1259",2020-08-02,31,7,45,76
"15268","1200-1259",2020-08-03,33,1,46,79
"15269","1200-1259",2020-08-04,30,2,45,75
"15270","1200-1259",2020-08-05,32,3,46,78
"15271","1200-1259",2020-08-06,33,4,48,81
"15272","1200-1259",2020-08-07,35,5,47,82
"15273","1200-1259",2020-08-08,34,6,45,79
"15274","1200-1259",2020-08-09,34,7,45,79
"15275","1200-1259",2020-08-10,35,1,46,81
"15276","1200-1259",2020-08-11,29,2,43,72
"15277","1200-1259",2020-08-12,30,3,44,74
"15278","1200-1259",2020-08-13,30,4,44,74
"15279","1200-1259",2020-08-14,32,5,44,76
"15280","1200-1259",2020-08-15,30,6,41,71
"15281","1200-1259",2020-08-16,32,7,43,75
"15282","1200-1259",2020-08-17,32,1,42,74
"15283","1200-1259",2020-08-18,30,2,42,72
"15284","1200-1259",2020-08-19,30,3,43,73
"15285","1200-1259",2020-08-20,29,4,44,73
"15286","1200-1259",2020-08-21,30,5,45,75
"15287","1200-1259",2020-08-22,29,6,39,68
"15288","1200-1259",2020-08-23,31,7,44,75
"15289","1200-1259",2020-08-24,30,1,44,74
"15290","1200-1259",2020-08-25,30,2,42,72
"15291","1200-1259",2020-08-26,30,3,43,73
"15292","1200-1259",2020-08-27,29,4,44,73
"15293","1200-1259",2020-08-28,30,5,45,75
"15294","1200-1259",2020-08-29,29,6,39,68
"15295","1200-1259",2020-08-30,31,7,44,75
"15296","1200-1259",2020-08-31,30,1,44,74
"15297","1300-1359",2020-08-01,49,6,39,88
"15298","1300-1359",2020-08-02,50,7,41,91
"15299","1300-1359",2020-08-03,44,1,42,86
"15300","1300-1359",2020-08-04,43,2,36,79
"15301","1300-1359",2020-08-05,42,3,36,78
"15302","1300-1359",2020-08-06,47,4,41,88
"15303","1300-1359",2020-08-07,45,5,40,85
"15304","1300-1359",2020-08-08,45,6,41,86
"15305","1300-1359",2020-08-09,48,7,42,90
"15306","1300-1359",2020-08-10,43,1,39,82
"15307","1300-1359",2020-08-11,41,2,38,79
"15308","1300-1359",2020-08-12,40,3,38,78
"15309","1300-1359",2020-08-13,45,4,41,86
"15310","1300-1359",2020-08-14,43,5,39,82
"15311","1300-1359",2020-08-15,42,6,39,81
"15312","1300-1359",2020-08-16,45,7,43,88
"15313","1300-1359",2020-08-17,40,1,39,79
"15314","1300-1359",2020-08-18,39,2,39,78
"15315","1300-1359",2020-08-19,37,3,38,75
"15316","1300-1359",2020-08-20,42,4,40,82
"15317","1300-1359",2020-08-21,44,5,40,84
"15318","1300-1359",2020-08-22,40,6,40,80
"15319","1300-1359",2020-08-23,43,7,42,85
"15320","1300-1359",2020-08-24,42,1,40,82
"15321","1300-1359",2020-08-25,38,2,38,76
"15322","1300-1359",2020-08-26,37,3,38,75
"15323","1300-1359",2020-08-27,42,4,40,82
"15324","1300-1359",2020-08-28,43,5,40,83
"15325","1300-1359",2020-08-29,40,6,40,80
"15326","1300-1359",2020-08-30,43,7,42,85
"15327","1300-1359",2020-08-31,41,1,40,81
"15328","1400-1459",2020-08-01,37,6,39,76
"15329","1400-1459",2020-08-02,40,7,36,76
"15330","1400-1459",2020-08-03,46,1,38,84
"15331","1400-1459",2020-08-04,39,2,36,75
"15332","1400-1459",2020-08-05,40,3,39,79
"15333","1400-1459",2020-08-06,42,4,39,81
"15334","1400-1459",2020-08-07,43,5,39,82
"15335","1400-1459",2020-08-08,42,6,42,84
"15336","1400-1459",2020-08-09,41,7,40,81
"15337","1400-1459",2020-08-10,42,1,39,81
"15338","1400-1459",2020-08-11,35,2,32,67
"15339","1400-1459",2020-08-12,36,3,35,71
"15340","1400-1459",2020-08-13,38,4,34,72
"15341","1400-1459",2020-08-14,38,5,34,72
"15342","1400-1459",2020-08-15,41,6,36,77
"15343","1400-1459",2020-08-16,40,7,37,77
"15344","1400-1459",2020-08-17,39,1,34,73
"15345","1400-1459",2020-08-18,36,2,31,67
"15346","1400-1459",2020-08-19,35,3,31,66
"15347","1400-1459",2020-08-20,39,4,34,73
"15348","1400-1459",2020-08-21,38,5,34,72
"15349","1400-1459",2020-08-22,40,6,36,76
"15350","1400-1459",2020-08-23,41,7,37,78
"15351","1400-1459",2020-08-24,39,1,34,73
"15352","1400-1459",2020-08-25,35,2,31,66
"15353","1400-1459",2020-08-26,35,3,31,66
"15354","1400-1459",2020-08-27,39,4,34,73
"15355","1400-1459",2020-08-28,38,5,34,72
"15356","1400-1459",2020-08-29,40,6,36,76
"15357","1400-1459",2020-08-30,41,7,37,78
"15358","1400-1459",2020-08-31,39,1,34,73
"15359","1500-1559",2020-08-01,40,6,31,71
"15360","1500-1559",2020-08-02,43,7,33,76
"15361","1500-1559",2020-08-03,41,1,33,74
"15362","1500-1559",2020-08-04,37,2,30,67
"15363","1500-1559",2020-08-05,37,3,31,68
"15364","1500-1559",2020-08-06,41,4,35,76
"15365","1500-1559",2020-08-07,40,5,37,77
"15366","1500-1559",2020-08-08,38,6,33,71
"15367","1500-1559",2020-08-09,42,7,35,77
"15368","1500-1559",2020-08-10,42,1,36,78
"15369","1500-1559",2020-08-11,33,2,29,62
"15370","1500-1559",2020-08-12,35,3,28,63
"15371","1500-1559",2020-08-13,37,4,32,69
"15372","1500-1559",2020-08-14,36,5,34,70
"15373","1500-1559",2020-08-15,36,6,29,65
"15374","1500-1559",2020-08-16,39,7,31,70
"15375","1500-1559",2020-08-17,37,1,31,68
"15376","1500-1559",2020-08-18,33,2,29,62
"15377","1500-1559",2020-08-19,34,3,28,62
"15378","1500-1559",2020-08-20,38,4,31,69
"15379","1500-1559",2020-08-21,37,5,34,71
"15380","1500-1559",2020-08-22,36,6,28,64
"15381","1500-1559",2020-08-23,38,7,31,69
"15382","1500-1559",2020-08-24,38,1,32,70
"15383","1500-1559",2020-08-25,33,2,28,61
"15384","1500-1559",2020-08-26,34,3,28,62
"15385","1500-1559",2020-08-27,38,4,31,69
"15386","1500-1559",2020-08-28,38,5,33,71
"15387","1500-1559",2020-08-29,36,6,28,64
"15388","1500-1559",2020-08-30,38,7,31,69
"15389","1500-1559",2020-08-31,38,1,31,69
"15390","1600-1659",2020-08-01,14,6,52,66
"15391","1600-1659",2020-08-02,20,7,55,75
"15392","1600-1659",2020-08-03,23,1,55,78
"15393","1600-1659",2020-08-04,19,2,52,71
"15394","1600-1659",2020-08-05,18,3,50,68
"15395","1600-1659",2020-08-06,23,4,53,76
"15396","1600-1659",2020-08-07,24,5,51,75
"15397","1600-1659",2020-08-08,18,6,51,69
"15398","1600-1659",2020-08-09,23,7,54,77
"15399","1600-1659",2020-08-10,25,1,53,78
"15400","1600-1659",2020-08-11,28,2,47,75
"15401","1600-1659",2020-08-12,26,3,47,73
"15402","1600-1659",2020-08-13,30,4,50,80
"15403","1600-1659",2020-08-14,31,5,47,78
"15404","1600-1659",2020-08-15,23,6,50,73
"15405","1600-1659",2020-08-16,30,7,54,84
"15406","1600-1659",2020-08-17,30,1,49,79
"15407","1600-1659",2020-08-18,26,2,46,72
"15408","1600-1659",2020-08-19,25,3,45,70
"15409","1600-1659",2020-08-20,28,4,49,77
"15410","1600-1659",2020-08-21,30,5,48,78
"15411","1600-1659",2020-08-22,22,6,50,72
"15412","1600-1659",2020-08-23,29,7,51,80
"15413","1600-1659",2020-08-24,30,1,50,80
"15414","1600-1659",2020-08-25,25,2,45,70
"15415","1600-1659",2020-08-26,25,3,45,70
"15416","1600-1659",2020-08-27,28,4,49,77
"15417","1600-1659",2020-08-28,29,5,49,78
"15418","1600-1659",2020-08-29,22,6,50,72
"15419","1600-1659",2020-08-30,29,7,51,80
"15420","1600-1659",2020-08-31,29,1,50,79
"15421","1700-1759",2020-08-01,47,6,29,76
"15422","1700-1759",2020-08-02,52,7,30,82
"15423","1700-1759",2020-08-03,55,1,31,86
"15424","1700-1759",2020-08-04,51,2,29,80
"15425","1700-1759",2020-08-05,50,3,30,80
"15426","1700-1759",2020-08-06,54,4,31,85
"15427","1700-1759",2020-08-07,54,5,34,88
"15428","1700-1759",2020-08-08,46,6,29,75
"15429","1700-1759",2020-08-09,53,7,32,85
"15430","1700-1759",2020-08-10,53,1,35,88
"15431","1700-1759",2020-08-11,42,2,34,76
"15432","1700-1759",2020-08-12,43,3,35,78
"15433","1700-1759",2020-08-13,46,4,36,82
"15434","1700-1759",2020-08-14,45,5,39,84
"15435","1700-1759",2020-08-15,42,6,33,75
"15436","1700-1759",2020-08-16,49,7,38,87
"15437","1700-1759",2020-08-17,46,1,39,85
"15438","1700-1759",2020-08-18,42,2,33,75
"15439","1700-1759",2020-08-19,43,3,34,77
"15440","1700-1759",2020-08-20,45,4,36,81
"15441","1700-1759",2020-08-21,45,5,38,83
"15442","1700-1759",2020-08-22,41,6,33,74
"15443","1700-1759",2020-08-23,46,7,38,84
"15444","1700-1759",2020-08-24,46,1,38,84
"15445","1700-1759",2020-08-25,42,2,33,75
"15446","1700-1759",2020-08-26,43,3,34,77
"15447","1700-1759",2020-08-27,45,4,36,81
"15448","1700-1759",2020-08-28,46,5,37,83
"15449","1700-1759",2020-08-29,41,6,33,74
"15450","1700-1759",2020-08-30,46,7,38,84
"15451","1700-1759",2020-08-31,45,1,37,82
"15452","1800-1859",2020-08-01,26,6,37,63
"15453","1800-1859",2020-08-02,29,7,40,69
"15454","1800-1859",2020-08-03,32,1,45,77
"15455","1800-1859",2020-08-04,26,2,40,66
"15456","1800-1859",2020-08-05,27,3,39,66
"15457","1800-1859",2020-08-06,30,4,42,72
"15458","1800-1859",2020-08-07,33,5,42,75
"15459","1800-1859",2020-08-08,28,6,37,65
"15460","1800-1859",2020-08-09,31,7,41,72
"15461","1800-1859",2020-08-10,33,1,42,75
"15462","1800-1859",2020-08-11,31,2,35,66
"15463","1800-1859",2020-08-12,33,3,35,68
"15464","1800-1859",2020-08-13,36,4,39,75
"15465","1800-1859",2020-08-14,39,5,38,77
"15466","1800-1859",2020-08-15,32,6,37,69
"15467","1800-1859",2020-08-16,38,7,41,79
"15468","1800-1859",2020-08-17,39,1,39,78
"15469","1800-1859",2020-08-18,31,2,34,65
"15470","1800-1859",2020-08-19,33,3,34,67
"15471","1800-1859",2020-08-20,36,4,40,76
"15472","1800-1859",2020-08-21,37,5,38,75
"15473","1800-1859",2020-08-22,32,6,34,66
"15474","1800-1859",2020-08-23,38,7,41,79
"15475","1800-1859",2020-08-24,37,1,39,76
"15476","1800-1859",2020-08-25,31,2,33,64
"15477","1800-1859",2020-08-26,33,3,34,67
"15478","1800-1859",2020-08-27,36,4,40,76
"15479","1800-1859",2020-08-28,37,5,39,76
"15480","1800-1859",2020-08-29,32,6,34,66
"15481","1800-1859",2020-08-30,38,7,41,79
"15482","1800-1859",2020-08-31,38,1,39,77
"15483","1900-1959",2020-08-01,19,6,39,58
"15484","1900-1959",2020-08-02,26,7,43,69
"15485","1900-1959",2020-08-03,28,1,44,72
"15486","1900-1959",2020-08-04,22,2,41,63
"15487","1900-1959",2020-08-05,24,3,37,61
"15488","1900-1959",2020-08-06,29,4,41,70
"15489","1900-1959",2020-08-07,30,5,42,72
"15490","1900-1959",2020-08-08,21,6,37,58
"15491","1900-1959",2020-08-09,29,7,40,69
"15492","1900-1959",2020-08-10,29,1,42,71
"15493","1900-1959",2020-08-11,18,2,38,56
"15494","1900-1959",2020-08-12,18,3,37,55
"15495","1900-1959",2020-08-13,23,4,40,63
"15496","1900-1959",2020-08-14,23,5,41,64
"15497","1900-1959",2020-08-15,18,6,32,50
"15498","1900-1959",2020-08-16,22,7,38,60
"15499","1900-1959",2020-08-17,22,1,40,62
"15500","1900-1959",2020-08-18,19,2,36,55
"15501","1900-1959",2020-08-19,19,3,36,55
"15502","1900-1959",2020-08-20,22,4,39,61
"15503","1900-1959",2020-08-21,22,5,40,62
"15504","1900-1959",2020-08-22,18,6,30,48
"15505","1900-1959",2020-08-23,22,7,37,59
"15506","1900-1959",2020-08-24,22,1,40,62
"15507","1900-1959",2020-08-25,19,2,36,55
"15508","1900-1959",2020-08-26,19,3,36,55
"15509","1900-1959",2020-08-27,22,4,39,61
"15510","1900-1959",2020-08-28,22,5,40,62
"15511","1900-1959",2020-08-29,18,6,30,48
"15512","1900-1959",2020-08-30,22,7,37,59
"15513","1900-1959",2020-08-31,22,1,39,61
"15514","2000-2059",2020-08-01,29,6,37,66
"15515","2000-2059",2020-08-02,33,7,41,74
"15516","2000-2059",2020-08-03,31,1,45,76
"15517","2000-2059",2020-08-04,27,2,38,65
"15518","2000-2059",2020-08-05,25,3,42,67
"15519","2000-2059",2020-08-06,29,4,43,72
"15520","2000-2059",2020-08-07,29,5,47,76
"15521","2000-2059",2020-08-08,26,6,40,66
"15522","2000-2059",2020-08-09,29,7,44,73
"15523","2000-2059",2020-08-10,27,1,45,72
"15524","2000-2059",2020-08-11,27,2,39,66
"15525","2000-2059",2020-08-12,27,3,43,70
"15526","2000-2059",2020-08-13,33,4,42,75
"15527","2000-2059",2020-08-14,33,5,45,78
"15528","2000-2059",2020-08-15,31,6,43,74
"15529","2000-2059",2020-08-16,34,7,44,78
"15530","2000-2059",2020-08-17,31,1,45,76
"15531","2000-2059",2020-08-18,24,2,40,64
"15532","2000-2059",2020-08-19,24,3,42,66
"15533","2000-2059",2020-08-20,30,4,42,72
"15534","2000-2059",2020-08-21,32,5,44,76
"15535","2000-2059",2020-08-22,28,6,42,70
"15536","2000-2059",2020-08-23,31,7,44,75
"15537","2000-2059",2020-08-24,30,1,44,74
"15538","2000-2059",2020-08-25,24,2,40,64
"15539","2000-2059",2020-08-26,24,3,42,66
"15540","2000-2059",2020-08-27,31,4,42,73
"15541","2000-2059",2020-08-28,32,5,44,76
"15542","2000-2059",2020-08-29,28,6,42,70
"15543","2000-2059",2020-08-30,31,7,44,75
"15544","2000-2059",2020-08-31,30,1,44,74
"15545","2100-2159",2020-08-01,9,6,30,39
"15546","2100-2159",2020-08-02,9,7,37,46
"15547","2100-2159",2020-08-03,8,1,41,49
"15548","2100-2159",2020-08-04,8,2,35,43
"15549","2100-2159",2020-08-05,10,3,36,46
"15550","2100-2159",2020-08-06,9,4,41,50
"15551","2100-2159",2020-08-07,9,5,40,49
"15552","2100-2159",2020-08-08,10,6,31,41
"15553","2100-2159",2020-08-09,9,7,41,50
"15554","2100-2159",2020-08-10,9,1,39,48
"15555","2100-2159",2020-08-11,15,2,27,42
"15556","2100-2159",2020-08-12,17,3,28,45
"15557","2100-2159",2020-08-13,17,4,34,51
"15558","2100-2159",2020-08-14,16,5,33,49
"15559","2100-2159",2020-08-15,15,6,33,48
"15560","2100-2159",2020-08-16,16,7,34,50
"15561","2100-2159",2020-08-17,16,1,33,49
"15562","2100-2159",2020-08-18,15,2,27,42
"15563","2100-2159",2020-08-19,15,3,28,43
"15564","2100-2159",2020-08-20,17,4,32,49
"15565","2100-2159",2020-08-21,16,5,34,50
"15566","2100-2159",2020-08-22,15,6,31,46
"15567","2100-2159",2020-08-23,17,7,32,49
"15568","2100-2159",2020-08-24,16,1,34,50
"15569","2100-2159",2020-08-25,15,2,27,42
"15570","2100-2159",2020-08-26,15,3,28,43
"15571","2100-2159",2020-08-27,17,4,32,49
"15572","2100-2159",2020-08-28,16,5,34,50
"15573","2100-2159",2020-08-29,15,6,31,46
"15574","2100-2159",2020-08-30,17,7,32,49
"15575","2100-2159",2020-08-31,16,1,35,51
"15576","2200-2259",2020-08-01,7,6,30,37
"15577","2200-2259",2020-08-02,12,7,36,48
"15578","2200-2259",2020-08-03,11,1,34,45
"15579","2200-2259",2020-08-04,8,2,30,38
"15580","2200-2259",2020-08-05,6,3,31,37
"15581","2200-2259",2020-08-06,11,4,34,45
"15582","2200-2259",2020-08-07,10,5,35,45
"15583","2200-2259",2020-08-08,8,6,31,39
"15584","2200-2259",2020-08-09,11,7,34,45
"15585","2200-2259",2020-08-10,10,1,33,43
"15586","2200-2259",2020-08-11,6,2,33,39
"15587","2200-2259",2020-08-12,6,3,33,39
"15588","2200-2259",2020-08-13,11,4,40,51
"15589","2200-2259",2020-08-14,11,5,40,51
"15590","2200-2259",2020-08-15,9,6,35,44
"15591","2200-2259",2020-08-16,12,7,42,54
"15592","2200-2259",2020-08-17,11,1,39,50
"15593","2200-2259",2020-08-18,7,2,32,39
"15594","2200-2259",2020-08-19,7,3,31,38
"15595","2200-2259",2020-08-20,10,4,37,47
"15596","2200-2259",2020-08-21,11,5,38,49
"15597","2200-2259",2020-08-22,9,6,33,42
"15598","2200-2259",2020-08-23,10,7,39,49
"15599","2200-2259",2020-08-24,11,1,37,48
"15600","2200-2259",2020-08-25,7,2,32,39
"15601","2200-2259",2020-08-26,7,3,31,38
"15602","2200-2259",2020-08-27,10,4,37,47
"15603","2200-2259",2020-08-28,11,5,38,49
"15604","2200-2259",2020-08-29,9,6,33,42
"15605","2200-2259",2020-08-30,10,7,39,49
"15606","2200-2259",2020-08-31,11,1,36,47
"15607","2300-2359",2020-08-01,7,6,15,22
"15608","2300-2359",2020-08-02,9,7,22,31
"15609","2300-2359",2020-08-03,7,1,21,28
"15610","2300-2359",2020-08-04,6,2,12,18
"15611","2300-2359",2020-08-05,7,3,13,20
"15612","2300-2359",2020-08-06,8,4,21,29
"15613","2300-2359",2020-08-07,7,5,21,28
"15614","2300-2359",2020-08-08,6,6,14,20
"15615","2300-2359",2020-08-09,8,7,21,29
"15616","2300-2359",2020-08-10,7,1,21,28
"15617","2300-2359",2020-08-11,5,2,18,23
"15618","2300-2359",2020-08-12,6,3,20,26
"15619","2300-2359",2020-08-13,8,4,26,34
"15620","2300-2359",2020-08-14,7,5,26,33
"15621","2300-2359",2020-08-15,5,6,18,23
"15622","2300-2359",2020-08-16,7,7,27,34
"15623","2300-2359",2020-08-17,6,1,26,32
"15624","2300-2359",2020-08-18,5,2,19,24
"15625","2300-2359",2020-08-19,6,3,20,26
"15626","2300-2359",2020-08-20,6,4,25,31
"15627","2300-2359",2020-08-21,6,5,25,31
"15628","2300-2359",2020-08-22,5,6,19,24
"15629","2300-2359",2020-08-23,6,7,26,32
"15630","2300-2359",2020-08-24,6,1,25,31
"15631","2300-2359",2020-08-25,5,2,19,24
"15632","2300-2359",2020-08-26,6,3,20,26
"15633","2300-2359",2020-08-27,6,4,25,31
"15634","2300-2359",2020-08-28,6,5,25,31
"15635","2300-2359",2020-08-29,5,6,19,24
"15636","2300-2359",2020-08-30,6,7,26,32
"15637","2300-2359",2020-08-31,6,1,25,31
"15638","0001-0559",2020-09-01,8,2,11,19
"15639","0001-0559",2020-09-02,5,3,7,12
"15640","0001-0559",2020-09-03,6,4,11,17
"15641","0001-0559",2020-09-04,8,5,13,21
"15642","0001-0559",2020-09-05,6,6,10,16
"15643","0001-0559",2020-09-06,2,7,6,8
"15644","0001-0559",2020-09-07,5,1,10,15
"15645","0001-0559",2020-09-08,7,2,6,13
"15646","0001-0559",2020-09-09,6,3,6,12
"15647","0001-0559",2020-09-10,5,4,10,15
"15648","0001-0559",2020-09-11,7,5,12,19
"15649","0001-0559",2020-09-12,7,6,11,18
"15650","0001-0559",2020-09-13,6,7,11,17
"15651","0001-0559",2020-09-14,7,1,12,19
"15652","0001-0559",2020-09-15,7,2,8,15
"15653","0001-0559",2020-09-16,5,3,6,11
"15654","0001-0559",2020-09-17,5,4,10,15
"15655","0001-0559",2020-09-18,7,5,12,19
"15656","0001-0559",2020-09-19,7,6,11,18
"15657","0001-0559",2020-09-20,6,7,11,17
"15658","0001-0559",2020-09-21,7,1,12,19
"15659","0001-0559",2020-09-22,7,2,8,15
"15660","0001-0559",2020-09-23,5,3,6,11
"15661","0001-0559",2020-09-24,5,4,10,15
"15662","0001-0559",2020-09-25,7,5,12,19
"15663","0001-0559",2020-09-26,7,6,11,18
"15664","0001-0559",2020-09-27,6,7,11,17
"15665","0001-0559",2020-09-28,7,1,12,19
"15666","0001-0559",2020-09-29,7,2,8,15
"15667","0001-0559",2020-09-30,5,3,6,11
"15668","0600-0659",2020-09-01,37,2,9,46
"15669","0600-0659",2020-09-02,34,3,6,40
"15670","0600-0659",2020-09-03,40,4,7,47
"15671","0600-0659",2020-09-04,41,5,7,48
"15672","0600-0659",2020-09-05,36,6,5,41
"15673","0600-0659",2020-09-06,26,7,6,32
"15674","0600-0659",2020-09-07,31,1,6,37
"15675","0600-0659",2020-09-08,31,2,5,36
"15676","0600-0659",2020-09-09,27,3,6,33
"15677","0600-0659",2020-09-10,26,4,7,33
"15678","0600-0659",2020-09-11,26,5,7,33
"15679","0600-0659",2020-09-12,27,6,5,32
"15680","0600-0659",2020-09-13,26,7,7,33
"15681","0600-0659",2020-09-14,26,1,7,33
"15682","0600-0659",2020-09-15,27,2,6,33
"15683","0600-0659",2020-09-16,26,3,6,32
"15684","0600-0659",2020-09-17,26,4,7,33
"15685","0600-0659",2020-09-18,26,5,7,33
"15686","0600-0659",2020-09-19,27,6,6,33
"15687","0600-0659",2020-09-20,26,7,8,34
"15688","0600-0659",2020-09-21,26,1,8,34
"15689","0600-0659",2020-09-22,27,2,6,33
"15690","0600-0659",2020-09-23,26,3,6,32
"15691","0600-0659",2020-09-24,26,4,8,34
"15692","0600-0659",2020-09-25,26,5,8,34
"15693","0600-0659",2020-09-26,27,6,6,33
"15694","0600-0659",2020-09-27,26,7,8,34
"15695","0600-0659",2020-09-28,26,1,8,34
"15696","0600-0659",2020-09-29,27,2,6,33
"15697","0600-0659",2020-09-30,26,3,6,32
"15698","0700-0759",2020-09-01,52,2,14,66
"15699","0700-0759",2020-09-02,47,3,16,63
"15700","0700-0759",2020-09-03,53,4,19,72
"15701","0700-0759",2020-09-04,50,5,19,69
"15702","0700-0759",2020-09-05,48,6,18,66
"15703","0700-0759",2020-09-06,47,7,12,59
"15704","0700-0759",2020-09-07,47,1,14,61
"15705","0700-0759",2020-09-08,42,2,15,57
"15706","0700-0759",2020-09-09,43,3,15,58
"15707","0700-0759",2020-09-10,52,4,14,66
"15708","0700-0759",2020-09-11,50,5,14,64
"15709","0700-0759",2020-09-12,47,6,14,61
"15710","0700-0759",2020-09-13,52,7,14,66
"15711","0700-0759",2020-09-14,50,1,14,64
"15712","0700-0759",2020-09-15,44,2,14,58
"15713","0700-0759",2020-09-16,42,3,14,56
"15714","0700-0759",2020-09-17,52,4,14,66
"15715","0700-0759",2020-09-18,50,5,14,64
"15716","0700-0759",2020-09-19,47,6,14,61
"15717","0700-0759",2020-09-20,52,7,14,66
"15718","0700-0759",2020-09-21,50,1,14,64
"15719","0700-0759",2020-09-22,44,2,14,58
"15720","0700-0759",2020-09-23,42,3,14,56
"15721","0700-0759",2020-09-24,52,4,14,66
"15722","0700-0759",2020-09-25,50,5,14,64
"15723","0700-0759",2020-09-26,47,6,14,61
"15724","0700-0759",2020-09-27,51,7,14,65
"15725","0700-0759",2020-09-28,51,1,14,65
"15726","0700-0759",2020-09-29,44,2,14,58
"15727","0700-0759",2020-09-30,41,3,14,55
"15728","0800-0859",2020-09-01,56,2,33,89
"15729","0800-0859",2020-09-02,55,3,29,84
"15730","0800-0859",2020-09-03,58,4,34,92
"15731","0800-0859",2020-09-04,61,5,34,95
"15732","0800-0859",2020-09-05,55,6,29,84
"15733","0800-0859",2020-09-06,47,7,26,73
"15734","0800-0859",2020-09-07,50,1,30,80
"15735","0800-0859",2020-09-08,48,2,27,75
"15736","0800-0859",2020-09-09,47,3,24,71
"15737","0800-0859",2020-09-10,48,4,29,77
"15738","0800-0859",2020-09-11,50,5,29,79
"15739","0800-0859",2020-09-12,46,6,29,75
"15740","0800-0859",2020-09-13,50,7,29,79
"15741","0800-0859",2020-09-14,49,1,29,78
"15742","0800-0859",2020-09-15,47,2,27,74
"15743","0800-0859",2020-09-16,47,3,24,71
"15744","0800-0859",2020-09-17,49,4,29,78
"15745","0800-0859",2020-09-18,50,5,29,79
"15746","0800-0859",2020-09-19,47,6,29,76
"15747","0800-0859",2020-09-20,50,7,29,79
"15748","0800-0859",2020-09-21,49,1,29,78
"15749","0800-0859",2020-09-22,47,2,27,74
"15750","0800-0859",2020-09-23,47,3,24,71
"15751","0800-0859",2020-09-24,49,4,29,78
"15752","0800-0859",2020-09-25,50,5,29,79
"15753","0800-0859",2020-09-26,46,6,29,75
"15754","0800-0859",2020-09-27,50,7,29,79
"15755","0800-0859",2020-09-28,49,1,29,78
"15756","0800-0859",2020-09-29,47,2,27,74
"15757","0800-0859",2020-09-30,47,3,24,71
"15758","0900-0959",2020-09-01,46,2,34,80
"15759","0900-0959",2020-09-02,42,3,30,72
"15760","0900-0959",2020-09-03,46,4,33,79
"15761","0900-0959",2020-09-04,46,5,32,78
"15762","0900-0959",2020-09-05,42,6,31,73
"15763","0900-0959",2020-09-06,42,7,27,69
"15764","0900-0959",2020-09-07,47,1,26,73
"15765","0900-0959",2020-09-08,37,2,26,63
"15766","0900-0959",2020-09-09,36,3,26,62
"15767","0900-0959",2020-09-10,43,4,27,70
"15768","0900-0959",2020-09-11,43,5,25,68
"15769","0900-0959",2020-09-12,40,6,24,64
"15770","0900-0959",2020-09-13,43,7,27,70
"15771","0900-0959",2020-09-14,43,1,25,68
"15772","0900-0959",2020-09-15,37,2,24,61
"15773","0900-0959",2020-09-16,38,3,23,61
"15774","0900-0959",2020-09-17,43,4,27,70
"15775","0900-0959",2020-09-18,43,5,25,68
"15776","0900-0959",2020-09-19,40,6,25,65
"15777","0900-0959",2020-09-20,43,7,27,70
"15778","0900-0959",2020-09-21,43,1,25,68
"15779","0900-0959",2020-09-22,37,2,24,61
"15780","0900-0959",2020-09-23,38,3,23,61
"15781","0900-0959",2020-09-24,44,4,27,71
"15782","0900-0959",2020-09-25,43,5,25,68
"15783","0900-0959",2020-09-26,40,6,24,64
"15784","0900-0959",2020-09-27,43,7,27,70
"15785","0900-0959",2020-09-28,43,1,25,68
"15786","0900-0959",2020-09-29,37,2,24,61
"15787","0900-0959",2020-09-30,37,3,23,60
"15788","1000-1059",2020-09-01,38,2,35,73
"15789","1000-1059",2020-09-02,36,3,29,65
"15790","1000-1059",2020-09-03,40,4,31,71
"15791","1000-1059",2020-09-04,40,5,31,71
"15792","1000-1059",2020-09-05,34,6,27,61
"15793","1000-1059",2020-09-06,37,7,28,65
"15794","1000-1059",2020-09-07,37,1,30,67
"15795","1000-1059",2020-09-08,33,2,30,63
"15796","1000-1059",2020-09-09,29,3,26,55
"15797","1000-1059",2020-09-10,35,4,31,66
"15798","1000-1059",2020-09-11,35,5,31,66
"15799","1000-1059",2020-09-12,30,6,30,60
"15800","1000-1059",2020-09-13,35,7,32,67
"15801","1000-1059",2020-09-14,35,1,30,65
"15802","1000-1059",2020-09-15,30,2,26,56
"15803","1000-1059",2020-09-16,30,3,26,56
"15804","1000-1059",2020-09-17,36,4,32,68
"15805","1000-1059",2020-09-18,35,5,31,66
"15806","1000-1059",2020-09-19,30,6,30,60
"15807","1000-1059",2020-09-20,35,7,32,67
"15808","1000-1059",2020-09-21,35,1,30,65
"15809","1000-1059",2020-09-22,30,2,26,56
"15810","1000-1059",2020-09-23,30,3,26,56
"15811","1000-1059",2020-09-24,36,4,32,68
"15812","1000-1059",2020-09-25,35,5,31,66
"15813","1000-1059",2020-09-26,30,6,30,60
"15814","1000-1059",2020-09-27,35,7,31,66
"15815","1000-1059",2020-09-28,35,1,31,66
"15816","1000-1059",2020-09-29,30,2,26,56
"15817","1000-1059",2020-09-30,30,3,25,55
"15818","1100-1159",2020-09-01,37,2,37,74
"15819","1100-1159",2020-09-02,36,3,37,73
"15820","1100-1159",2020-09-03,40,4,39,79
"15821","1100-1159",2020-09-04,40,5,39,79
"15822","1100-1159",2020-09-05,36,6,38,74
"15823","1100-1159",2020-09-06,34,7,31,65
"15824","1100-1159",2020-09-07,39,1,36,75
"15825","1100-1159",2020-09-08,32,2,30,62
"15826","1100-1159",2020-09-09,34,3,29,63
"15827","1100-1159",2020-09-10,41,4,31,72
"15828","1100-1159",2020-09-11,43,5,31,74
"15829","1100-1159",2020-09-12,41,6,30,71
"15830","1100-1159",2020-09-13,43,7,30,73
"15831","1100-1159",2020-09-14,42,1,31,73
"15832","1100-1159",2020-09-15,36,2,31,67
"15833","1100-1159",2020-09-16,35,3,31,66
"15834","1100-1159",2020-09-17,42,4,31,73
"15835","1100-1159",2020-09-18,43,5,31,74
"15836","1100-1159",2020-09-19,41,6,30,71
"15837","1100-1159",2020-09-20,43,7,30,73
"15838","1100-1159",2020-09-21,42,1,31,73
"15839","1100-1159",2020-09-22,36,2,31,67
"15840","1100-1159",2020-09-23,35,3,31,66
"15841","1100-1159",2020-09-24,42,4,31,73
"15842","1100-1159",2020-09-25,43,5,31,74
"15843","1100-1159",2020-09-26,41,6,30,71
"15844","1100-1159",2020-09-27,43,7,30,73
"15845","1100-1159",2020-09-28,42,1,31,73
"15846","1100-1159",2020-09-29,36,2,31,67
"15847","1100-1159",2020-09-30,35,3,30,65
"15848","1200-1259",2020-09-01,32,2,44,76
"15849","1200-1259",2020-09-02,32,3,44,76
"15850","1200-1259",2020-09-03,32,4,47,79
"15851","1200-1259",2020-09-04,34,5,49,83
"15852","1200-1259",2020-09-05,30,6,38,68
"15853","1200-1259",2020-09-06,30,7,38,68
"15854","1200-1259",2020-09-07,37,1,41,78
"15855","1200-1259",2020-09-08,33,2,36,69
"15856","1200-1259",2020-09-09,32,3,36,68
"15857","1200-1259",2020-09-10,33,4,44,77
"15858","1200-1259",2020-09-11,35,5,47,82
"15859","1200-1259",2020-09-12,31,6,38,69
"15860","1200-1259",2020-09-13,34,7,46,80
"15861","1200-1259",2020-09-14,35,1,46,81
"15862","1200-1259",2020-09-15,31,2,39,70
"15863","1200-1259",2020-09-16,32,3,38,70
"15864","1200-1259",2020-09-17,34,4,46,80
"15865","1200-1259",2020-09-18,35,5,48,83
"15866","1200-1259",2020-09-19,31,6,38,69
"15867","1200-1259",2020-09-20,34,7,46,80
"15868","1200-1259",2020-09-21,35,1,46,81
"15869","1200-1259",2020-09-22,31,2,39,70
"15870","1200-1259",2020-09-23,32,3,38,70
"15871","1200-1259",2020-09-24,34,4,46,80
"15872","1200-1259",2020-09-25,35,5,47,82
"15873","1200-1259",2020-09-26,31,6,39,70
"15874","1200-1259",2020-09-27,34,7,46,80
"15875","1200-1259",2020-09-28,35,1,46,81
"15876","1200-1259",2020-09-29,31,2,39,70
"15877","1200-1259",2020-09-30,32,3,38,70
"15878","1300-1359",2020-09-01,42,2,37,79
"15879","1300-1359",2020-09-02,42,3,37,79
"15880","1300-1359",2020-09-03,46,4,39,85
"15881","1300-1359",2020-09-04,46,5,37,83
"15882","1300-1359",2020-09-05,40,6,37,77
"15883","1300-1359",2020-09-06,38,7,34,72
"15884","1300-1359",2020-09-07,42,1,39,81
"15885","1300-1359",2020-09-08,40,2,34,74
"15886","1300-1359",2020-09-09,39,3,32,71
"15887","1300-1359",2020-09-10,47,4,36,83
"15888","1300-1359",2020-09-11,47,5,36,83
"15889","1300-1359",2020-09-12,44,6,36,80
"15890","1300-1359",2020-09-13,48,7,37,85
"15891","1300-1359",2020-09-14,49,1,36,85
"15892","1300-1359",2020-09-15,39,2,31,70
"15893","1300-1359",2020-09-16,41,3,33,74
"15894","1300-1359",2020-09-17,47,4,37,84
"15895","1300-1359",2020-09-18,47,5,35,82
"15896","1300-1359",2020-09-19,45,6,36,81
"15897","1300-1359",2020-09-20,48,7,37,85
"15898","1300-1359",2020-09-21,48,1,36,84
"15899","1300-1359",2020-09-22,39,2,31,70
"15900","1300-1359",2020-09-23,41,3,33,74
"15901","1300-1359",2020-09-24,47,4,37,84
"15902","1300-1359",2020-09-25,47,5,36,83
"15903","1300-1359",2020-09-26,44,6,36,80
"15904","1300-1359",2020-09-27,48,7,37,85
"15905","1300-1359",2020-09-28,48,1,36,84
"15906","1300-1359",2020-09-29,39,2,31,70
"15907","1300-1359",2020-09-30,41,3,33,74
"15908","1400-1459",2020-09-01,31,2,35,66
"15909","1400-1459",2020-09-02,30,3,35,65
"15910","1400-1459",2020-09-03,34,4,37,71
"15911","1400-1459",2020-09-04,35,5,39,74
"15912","1400-1459",2020-09-05,35,6,38,73
"15913","1400-1459",2020-09-06,35,7,33,68
"15914","1400-1459",2020-09-07,40,1,38,78
"15915","1400-1459",2020-09-08,31,2,31,62
"15916","1400-1459",2020-09-09,29,3,34,63
"15917","1400-1459",2020-09-10,31,4,34,65
"15918","1400-1459",2020-09-11,31,5,36,67
"15919","1400-1459",2020-09-12,31,6,35,66
"15920","1400-1459",2020-09-13,32,7,36,68
"15921","1400-1459",2020-09-14,31,1,37,68
"15922","1400-1459",2020-09-15,26,2,35,61
"15923","1400-1459",2020-09-16,29,3,36,65
"15924","1400-1459",2020-09-17,31,4,35,66
"15925","1400-1459",2020-09-18,31,5,36,67
"15926","1400-1459",2020-09-19,31,6,36,67
"15927","1400-1459",2020-09-20,32,7,36,68
"15928","1400-1459",2020-09-21,32,1,37,69
"15929","1400-1459",2020-09-22,26,2,35,61
"15930","1400-1459",2020-09-23,29,3,36,65
"15931","1400-1459",2020-09-24,31,4,35,66
"15932","1400-1459",2020-09-25,31,5,36,67
"15933","1400-1459",2020-09-26,31,6,35,66
"15934","1400-1459",2020-09-27,32,7,36,68
"15935","1400-1459",2020-09-28,31,1,37,68
"15936","1400-1459",2020-09-29,26,2,35,61
"15937","1400-1459",2020-09-30,28,3,36,64
"15938","1500-1559",2020-09-01,36,2,28,64
"15939","1500-1559",2020-09-02,40,3,24,64
"15940","1500-1559",2020-09-03,45,4,30,75
"15941","1500-1559",2020-09-04,44,5,30,74
"15942","1500-1559",2020-09-05,37,6,23,60
"15943","1500-1559",2020-09-06,39,7,27,66
"15944","1500-1559",2020-09-07,43,1,28,71
"15945","1500-1559",2020-09-08,33,2,27,60
"15946","1500-1559",2020-09-09,35,3,27,62
"15947","1500-1559",2020-09-10,39,4,34,73
"15948","1500-1559",2020-09-11,39,5,34,73
"15949","1500-1559",2020-09-12,39,6,33,72
"15950","1500-1559",2020-09-13,40,7,35,75
"15951","1500-1559",2020-09-14,41,1,35,76
"15952","1500-1559",2020-09-15,33,2,27,60
"15953","1500-1559",2020-09-16,34,3,27,61
"15954","1500-1559",2020-09-17,39,4,34,73
"15955","1500-1559",2020-09-18,39,5,34,73
"15956","1500-1559",2020-09-19,39,6,33,72
"15957","1500-1559",2020-09-20,40,7,35,75
"15958","1500-1559",2020-09-21,40,1,34,74
"15959","1500-1559",2020-09-22,33,2,27,60
"15960","1500-1559",2020-09-23,34,3,27,61
"15961","1500-1559",2020-09-24,39,4,34,73
"15962","1500-1559",2020-09-25,39,5,34,73
"15963","1500-1559",2020-09-26,39,6,33,72
"15964","1500-1559",2020-09-27,40,7,35,75
"15965","1500-1559",2020-09-28,41,1,34,75
"15966","1500-1559",2020-09-29,33,2,27,60
"15967","1500-1559",2020-09-30,34,3,27,61
"15968","1600-1659",2020-09-01,26,2,47,73
"15969","1600-1659",2020-09-02,26,3,52,78
"15970","1600-1659",2020-09-03,28,4,56,84
"15971","1600-1659",2020-09-04,31,5,57,88
"15972","1600-1659",2020-09-05,23,6,55,78
"15973","1600-1659",2020-09-06,19,7,56,75
"15974","1600-1659",2020-09-07,24,1,62,86
"15975","1600-1659",2020-09-08,14,2,53,67
"15976","1600-1659",2020-09-09,16,3,48,64
"15977","1600-1659",2020-09-10,18,4,52,70
"15978","1600-1659",2020-09-11,19,5,52,71
"15979","1600-1659",2020-09-12,17,6,51,68
"15980","1600-1659",2020-09-13,19,7,54,73
"15981","1600-1659",2020-09-14,20,1,53,73
"15982","1600-1659",2020-09-15,15,2,45,60
"15983","1600-1659",2020-09-16,15,3,48,63
"15984","1600-1659",2020-09-17,18,4,52,70
"15985","1600-1659",2020-09-18,19,5,51,70
"15986","1600-1659",2020-09-19,17,6,51,68
"15987","1600-1659",2020-09-20,19,7,54,73
"15988","1600-1659",2020-09-21,19,1,53,72
"15989","1600-1659",2020-09-22,15,2,45,60
"15990","1600-1659",2020-09-23,15,3,48,63
"15991","1600-1659",2020-09-24,18,4,52,70
"15992","1600-1659",2020-09-25,19,5,52,71
"15993","1600-1659",2020-09-26,17,6,51,68
"15994","1600-1659",2020-09-27,19,7,54,73
"15995","1600-1659",2020-09-28,19,1,53,72
"15996","1600-1659",2020-09-29,15,2,45,60
"15997","1600-1659",2020-09-30,15,3,48,63
"15998","1700-1759",2020-09-01,40,2,34,74
"15999","1700-1759",2020-09-02,38,3,34,72
"16000","1700-1759",2020-09-03,42,4,37,79
"16001","1700-1759",2020-09-04,42,5,36,78
"16002","1700-1759",2020-09-05,36,6,32,68
"16003","1700-1759",2020-09-06,40,7,30,70
"16004","1700-1759",2020-09-07,43,1,31,74
"16005","1700-1759",2020-09-08,47,2,25,72
"16006","1700-1759",2020-09-09,45,3,26,71
"16007","1700-1759",2020-09-10,47,4,31,78
"16008","1700-1759",2020-09-11,48,5,29,77
"16009","1700-1759",2020-09-12,48,6,28,76
"16010","1700-1759",2020-09-13,49,7,30,79
"16011","1700-1759",2020-09-14,48,1,29,77
"16012","1700-1759",2020-09-15,46,2,27,73
"16013","1700-1759",2020-09-16,45,3,26,71
"16014","1700-1759",2020-09-17,48,4,30,78
"16015","1700-1759",2020-09-18,48,5,30,78
"16016","1700-1759",2020-09-19,48,6,28,76
"16017","1700-1759",2020-09-20,49,7,30,79
"16018","1700-1759",2020-09-21,48,1,29,77
"16019","1700-1759",2020-09-22,46,2,27,73
"16020","1700-1759",2020-09-23,45,3,26,71
"16021","1700-1759",2020-09-24,48,4,31,79
"16022","1700-1759",2020-09-25,48,5,29,77
"16023","1700-1759",2020-09-26,48,6,28,76
"16024","1700-1759",2020-09-27,49,7,30,79
"16025","1700-1759",2020-09-28,48,1,29,77
"16026","1700-1759",2020-09-29,46,2,27,73
"16027","1700-1759",2020-09-30,45,3,26,71
"16028","1800-1859",2020-09-01,32,2,33,65
"16029","1800-1859",2020-09-02,35,3,32,67
"16030","1800-1859",2020-09-03,39,4,36,75
"16031","1800-1859",2020-09-04,39,5,39,78
"16032","1800-1859",2020-09-05,30,6,32,62
"16033","1800-1859",2020-09-06,28,7,39,67
"16034","1800-1859",2020-09-07,33,1,47,80
"16035","1800-1859",2020-09-08,25,2,36,61
"16036","1800-1859",2020-09-09,27,3,39,66
"16037","1800-1859",2020-09-10,30,4,41,71
"16038","1800-1859",2020-09-11,31,5,43,74
"16039","1800-1859",2020-09-12,29,6,40,69
"16040","1800-1859",2020-09-13,31,7,41,72
"16041","1800-1859",2020-09-14,31,1,46,77
"16042","1800-1859",2020-09-15,25,2,38,63
"16043","1800-1859",2020-09-16,27,3,39,66
"16044","1800-1859",2020-09-17,30,4,41,71
"16045","1800-1859",2020-09-18,31,5,43,74
"16046","1800-1859",2020-09-19,30,6,40,70
"16047","1800-1859",2020-09-20,32,7,41,73
"16048","1800-1859",2020-09-21,32,1,44,76
"16049","1800-1859",2020-09-22,25,2,38,63
"16050","1800-1859",2020-09-23,27,3,39,66
"16051","1800-1859",2020-09-24,31,4,41,72
"16052","1800-1859",2020-09-25,32,5,43,75
"16053","1800-1859",2020-09-26,30,6,40,70
"16054","1800-1859",2020-09-27,32,7,41,73
"16055","1800-1859",2020-09-28,32,1,45,77
"16056","1800-1859",2020-09-29,25,2,38,63
"16057","1800-1859",2020-09-30,27,3,39,66
"16058","1900-1959",2020-09-01,18,2,37,55
"16059","1900-1959",2020-09-02,19,3,38,57
"16060","1900-1959",2020-09-03,22,4,44,66
"16061","1900-1959",2020-09-04,23,5,44,67
"16062","1900-1959",2020-09-05,15,6,30,45
"16063","1900-1959",2020-09-06,24,7,31,55
"16064","1900-1959",2020-09-07,26,1,33,59
"16065","1900-1959",2020-09-08,21,2,32,53
"16066","1900-1959",2020-09-09,22,3,31,53
"16067","1900-1959",2020-09-10,23,4,33,56
"16068","1900-1959",2020-09-11,23,5,35,58
"16069","1900-1959",2020-09-12,22,6,34,56
"16070","1900-1959",2020-09-13,23,7,36,59
"16071","1900-1959",2020-09-14,22,1,35,57
"16072","1900-1959",2020-09-15,21,2,29,50
"16073","1900-1959",2020-09-16,22,3,31,53
"16074","1900-1959",2020-09-17,23,4,34,57
"16075","1900-1959",2020-09-18,23,5,35,58
"16076","1900-1959",2020-09-19,22,6,34,56
"16077","1900-1959",2020-09-20,23,7,36,59
"16078","1900-1959",2020-09-21,22,1,35,57
"16079","1900-1959",2020-09-22,21,2,29,50
"16080","1900-1959",2020-09-23,22,3,31,53
"16081","1900-1959",2020-09-24,23,4,34,57
"16082","1900-1959",2020-09-25,23,5,35,58
"16083","1900-1959",2020-09-26,22,6,33,55
"16084","1900-1959",2020-09-27,23,7,36,59
"16085","1900-1959",2020-09-28,22,1,35,57
"16086","1900-1959",2020-09-29,21,2,29,50
"16087","1900-1959",2020-09-30,22,3,31,53
"16088","2000-2059",2020-09-01,23,2,38,61
"16089","2000-2059",2020-09-02,23,3,40,63
"16090","2000-2059",2020-09-03,29,4,39,68
"16091","2000-2059",2020-09-04,31,5,40,71
"16092","2000-2059",2020-09-05,27,6,38,65
"16093","2000-2059",2020-09-06,24,7,30,54
"16094","2000-2059",2020-09-07,25,1,36,61
"16095","2000-2059",2020-09-08,20,2,30,50
"16096","2000-2059",2020-09-09,18,3,33,51
"16097","2000-2059",2020-09-10,21,4,33,54
"16098","2000-2059",2020-09-11,23,5,35,58
"16099","2000-2059",2020-09-12,21,6,31,52
"16100","2000-2059",2020-09-13,21,7,33,54
"16101","2000-2059",2020-09-14,22,1,33,55
"16102","2000-2059",2020-09-15,18,2,28,46
"16103","2000-2059",2020-09-16,18,3,31,49
"16104","2000-2059",2020-09-17,21,4,33,54
"16105","2000-2059",2020-09-18,23,5,35,58
"16106","2000-2059",2020-09-19,21,6,31,52
"16107","2000-2059",2020-09-20,21,7,33,54
"16108","2000-2059",2020-09-21,22,1,33,55
"16109","2000-2059",2020-09-22,18,2,28,46
"16110","2000-2059",2020-09-23,18,3,31,49
"16111","2000-2059",2020-09-24,21,4,33,54
"16112","2000-2059",2020-09-25,23,5,35,58
"16113","2000-2059",2020-09-26,21,6,31,52
"16114","2000-2059",2020-09-27,21,7,33,54
"16115","2000-2059",2020-09-28,22,1,33,55
"16116","2000-2059",2020-09-29,18,2,28,46
"16117","2000-2059",2020-09-30,18,3,31,49
"16118","2100-2159",2020-09-01,16,2,26,42
"16119","2100-2159",2020-09-02,15,3,27,42
"16120","2100-2159",2020-09-03,19,4,31,50
"16121","2100-2159",2020-09-04,18,5,33,51
"16122","2100-2159",2020-09-05,13,6,26,39
"16123","2100-2159",2020-09-06,10,7,33,43
"16124","2100-2159",2020-09-07,10,1,37,47
"16125","2100-2159",2020-09-08,8,2,28,36
"16126","2100-2159",2020-09-09,9,3,28,37
"16127","2100-2159",2020-09-10,13,4,31,44
"16128","2100-2159",2020-09-11,11,5,31,42
"16129","2100-2159",2020-09-12,9,6,28,37
"16130","2100-2159",2020-09-13,13,7,31,44
"16131","2100-2159",2020-09-14,11,1,31,42
"16132","2100-2159",2020-09-15,9,2,28,37
"16133","2100-2159",2020-09-16,9,3,28,37
"16134","2100-2159",2020-09-17,13,4,31,44
"16135","2100-2159",2020-09-18,11,5,31,42
"16136","2100-2159",2020-09-19,9,6,29,38
"16137","2100-2159",2020-09-20,13,7,32,45
"16138","2100-2159",2020-09-21,11,1,33,44
"16139","2100-2159",2020-09-22,9,2,28,37
"16140","2100-2159",2020-09-23,9,3,28,37
"16141","2100-2159",2020-09-24,13,4,32,45
"16142","2100-2159",2020-09-25,11,5,32,43
"16143","2100-2159",2020-09-26,9,6,29,38
"16144","2100-2159",2020-09-27,13,7,32,45
"16145","2100-2159",2020-09-28,11,1,32,43
"16146","2100-2159",2020-09-29,9,2,28,37
"16147","2100-2159",2020-09-30,9,3,28,37
"16148","2200-2259",2020-09-01,7,2,30,37
"16149","2200-2259",2020-09-02,6,3,29,35
"16150","2200-2259",2020-09-03,8,4,36,44
"16151","2200-2259",2020-09-04,8,5,36,44
"16152","2200-2259",2020-09-05,5,6,27,32
"16153","2200-2259",2020-09-06,6,7,27,33
"16154","2200-2259",2020-09-07,9,1,30,39
"16155","2200-2259",2020-09-08,6,2,28,34
"16156","2200-2259",2020-09-09,6,3,27,33
"16157","2200-2259",2020-09-10,9,4,32,41
"16158","2200-2259",2020-09-11,9,5,32,41
"16159","2200-2259",2020-09-12,7,6,32,39
"16160","2200-2259",2020-09-13,9,7,34,43
"16161","2200-2259",2020-09-14,9,1,32,41
"16162","2200-2259",2020-09-15,6,2,27,33
"16163","2200-2259",2020-09-16,6,3,27,33
"16164","2200-2259",2020-09-17,9,4,32,41
"16165","2200-2259",2020-09-18,9,5,32,41
"16166","2200-2259",2020-09-19,8,6,32,40
"16167","2200-2259",2020-09-20,10,7,34,44
"16168","2200-2259",2020-09-21,10,1,32,42
"16169","2200-2259",2020-09-22,6,2,27,33
"16170","2200-2259",2020-09-23,6,3,27,33
"16171","2200-2259",2020-09-24,10,4,32,42
"16172","2200-2259",2020-09-25,10,5,32,42
"16173","2200-2259",2020-09-26,8,6,32,40
"16174","2200-2259",2020-09-27,10,7,34,44
"16175","2200-2259",2020-09-28,10,1,32,42
"16176","2200-2259",2020-09-29,6,2,27,33
"16177","2200-2259",2020-09-30,6,3,26,32
"16178","2300-2359",2020-09-01,5,2,20,25
"16179","2300-2359",2020-09-02,7,3,22,29
"16180","2300-2359",2020-09-03,7,4,28,35
"16181","2300-2359",2020-09-04,7,5,29,36
"16182","2300-2359",2020-09-05,5,6,19,24
"16183","2300-2359",2020-09-06,6,7,20,26
"16184","2300-2359",2020-09-07,7,1,21,28
"16185","2300-2359",2020-09-08,6,2,15,21
"16186","2300-2359",2020-09-09,6,3,13,19
"16187","2300-2359",2020-09-10,6,4,17,23
"16188","2300-2359",2020-09-11,6,5,17,23
"16189","2300-2359",2020-09-12,6,6,13,19
"16190","2300-2359",2020-09-13,6,7,17,23
"16191","2300-2359",2020-09-14,6,1,16,22
"16192","2300-2359",2020-09-15,6,2,13,19
"16193","2300-2359",2020-09-16,6,3,13,19
"16194","2300-2359",2020-09-17,6,4,17,23
"16195","2300-2359",2020-09-18,6,5,17,23
"16196","2300-2359",2020-09-19,6,6,13,19
"16197","2300-2359",2020-09-20,6,7,17,23
"16198","2300-2359",2020-09-21,6,1,16,22
"16199","2300-2359",2020-09-22,6,2,13,19
"16200","2300-2359",2020-09-23,6,3,13,19
"16201","2300-2359",2020-09-24,6,4,17,23
"16202","2300-2359",2020-09-25,6,5,17,23
"16203","2300-2359",2020-09-26,6,6,13,19
"16204","2300-2359",2020-09-27,6,7,17,23
"16205","2300-2359",2020-09-28,6,1,16,22
"16206","2300-2359",2020-09-29,6,2,13,19
"16207","2300-2359",2020-09-30,6,3,13,19
"16208","0001-0559",2020-10-01,5,4,14,19
"16209","0001-0559",2020-10-02,7,5,15,22
"16210","0001-0559",2020-10-03,7,6,12,19
"16211","0001-0559",2020-10-04,6,7,15,21
"16212","0001-0559",2020-10-05,7,1,15,22
"16213","0001-0559",2020-10-06,7,2,8,15
"16214","0001-0559",2020-10-07,3,3,7,10
"16215","0001-0559",2020-10-08,4,4,14,18
"16216","0001-0559",2020-10-09,6,5,14,20
"16217","0001-0559",2020-10-10,7,6,14,21
"16218","0001-0559",2020-10-11,5,7,15,20
"16219","0001-0559",2020-10-12,7,1,15,22
"16220","0001-0559",2020-10-13,6,2,9,15
"16221","0001-0559",2020-10-14,3,3,7,10
"16222","0001-0559",2020-10-15,4,4,14,18
"16223","0001-0559",2020-10-16,6,5,14,20
"16224","0001-0559",2020-10-17,7,6,14,21
"16225","0001-0559",2020-10-18,5,7,15,20
"16226","0001-0559",2020-10-19,7,1,15,22
"16227","0001-0559",2020-10-20,6,2,10,16
"16228","0001-0559",2020-10-21,3,3,7,10
"16229","0001-0559",2020-10-22,4,4,13,17
"16230","0001-0559",2020-10-23,6,5,14,20
"16231","0001-0559",2020-10-24,7,6,10,17
"16232","0001-0559",2020-10-25,4,7,10,14
"16233","0001-0559",2020-10-26,6,1,11,17
"16234","0001-0559",2020-10-27,5,2,10,15
"16235","0001-0559",2020-10-28,3,3,7,10
"16236","0001-0559",2020-10-29,4,4,10,14
"16237","0001-0559",2020-10-30,5,5,11,16
"16238","0001-0559",2020-10-31,5,6,12,17
"16239","0600-0659",2020-10-01,25,4,12,37
"16240","0600-0659",2020-10-02,29,5,11,40
"16241","0600-0659",2020-10-03,28,6,8,36
"16242","0600-0659",2020-10-04,30,7,9,39
"16243","0600-0659",2020-10-05,30,1,9,39
"16244","0600-0659",2020-10-06,28,2,9,37
"16245","0600-0659",2020-10-07,28,3,8,36
"16246","0600-0659",2020-10-08,30,4,8,38
"16247","0600-0659",2020-10-09,31,5,8,39
"16248","0600-0659",2020-10-10,31,6,8,39
"16249","0600-0659",2020-10-11,31,7,8,39
"16250","0600-0659",2020-10-12,31,1,8,39
"16251","0600-0659",2020-10-13,29,2,8,37
"16252","0600-0659",2020-10-14,27,3,8,35
"16253","0600-0659",2020-10-15,30,4,10,40
"16254","0600-0659",2020-10-16,31,5,10,41
"16255","0600-0659",2020-10-17,31,6,10,41
"16256","0600-0659",2020-10-18,31,7,9,40
"16257","0600-0659",2020-10-19,31,1,10,41
"16258","0600-0659",2020-10-20,28,2,9,37
"16259","0600-0659",2020-10-21,26,3,9,35
"16260","0600-0659",2020-10-22,29,4,9,38
"16261","0600-0659",2020-10-23,30,5,10,40
"16262","0600-0659",2020-10-24,30,6,10,40
"16263","0600-0659",2020-10-25,33,7,9,42
"16264","0600-0659",2020-10-26,33,1,10,43
"16265","0600-0659",2020-10-27,29,2,9,38
"16266","0600-0659",2020-10-28,27,3,9,36
"16267","0600-0659",2020-10-29,32,4,9,41
"16268","0600-0659",2020-10-30,33,5,10,43
"16269","0600-0659",2020-10-31,32,6,7,39
"16270","0700-0759",2020-10-01,52,4,17,69
"16271","0700-0759",2020-10-02,54,5,19,73
"16272","0700-0759",2020-10-03,49,6,17,66
"16273","0700-0759",2020-10-04,53,7,18,71
"16274","0700-0759",2020-10-05,55,1,18,73
"16275","0700-0759",2020-10-06,45,2,17,62
"16276","0700-0759",2020-10-07,47,3,19,66
"16277","0700-0759",2020-10-08,57,4,20,77
"16278","0700-0759",2020-10-09,58,5,21,79
"16279","0700-0759",2020-10-10,49,6,19,68
"16280","0700-0759",2020-10-11,53,7,20,73
"16281","0700-0759",2020-10-12,57,1,21,78
"16282","0700-0759",2020-10-13,48,2,20,68
"16283","0700-0759",2020-10-14,47,3,19,66
"16284","0700-0759",2020-10-15,55,4,21,76
"16285","0700-0759",2020-10-16,56,5,22,78
"16286","0700-0759",2020-10-17,47,6,20,67
"16287","0700-0759",2020-10-18,52,7,21,73
"16288","0700-0759",2020-10-19,56,1,22,78
"16289","0700-0759",2020-10-20,46,2,21,67
"16290","0700-0759",2020-10-21,45,3,20,65
"16291","0700-0759",2020-10-22,55,4,21,76
"16292","0700-0759",2020-10-23,56,5,22,78
"16293","0700-0759",2020-10-24,44,6,19,63
"16294","0700-0759",2020-10-25,48,7,20,68
"16295","0700-0759",2020-10-26,52,1,21,73
"16296","0700-0759",2020-10-27,46,2,20,66
"16297","0700-0759",2020-10-28,45,3,19,64
"16298","0700-0759",2020-10-29,51,4,20,71
"16299","0700-0759",2020-10-30,52,5,22,74
"16300","0700-0759",2020-10-31,43,6,15,58
"16301","0800-0859",2020-10-01,56,4,24,80
"16302","0800-0859",2020-10-02,58,5,28,86
"16303","0800-0859",2020-10-03,56,6,27,83
"16304","0800-0859",2020-10-04,56,7,29,85
"16305","0800-0859",2020-10-05,58,1,29,87
"16306","0800-0859",2020-10-06,54,2,26,80
"16307","0800-0859",2020-10-07,54,3,25,79
"16308","0800-0859",2020-10-08,59,4,31,90
"16309","0800-0859",2020-10-09,61,5,30,91
"16310","0800-0859",2020-10-10,60,6,26,86
"16311","0800-0859",2020-10-11,60,7,29,89
"16312","0800-0859",2020-10-12,61,1,29,90
"16313","0800-0859",2020-10-13,55,2,26,81
"16314","0800-0859",2020-10-14,55,3,24,79
"16315","0800-0859",2020-10-15,60,4,30,90
"16316","0800-0859",2020-10-16,61,5,29,90
"16317","0800-0859",2020-10-17,60,6,25,85
"16318","0800-0859",2020-10-18,60,7,29,89
"16319","0800-0859",2020-10-19,61,1,29,90
"16320","0800-0859",2020-10-20,55,2,26,81
"16321","0800-0859",2020-10-21,55,3,24,79
"16322","0800-0859",2020-10-22,60,4,30,90
"16323","0800-0859",2020-10-23,61,5,29,90
"16324","0800-0859",2020-10-24,56,6,25,81
"16325","0800-0859",2020-10-25,56,7,30,86
"16326","0800-0859",2020-10-26,57,1,30,87
"16327","0800-0859",2020-10-27,52,2,27,79
"16328","0800-0859",2020-10-28,53,3,25,78
"16329","0800-0859",2020-10-29,57,4,31,88
"16330","0800-0859",2020-10-30,58,5,30,88
"16331","0800-0859",2020-10-31,54,6,26,80
"16332","0900-0959",2020-10-01,39,4,29,68
"16333","0900-0959",2020-10-02,43,5,29,72
"16334","0900-0959",2020-10-03,40,6,29,69
"16335","0900-0959",2020-10-04,46,7,29,75
"16336","0900-0959",2020-10-05,46,1,28,74
"16337","0900-0959",2020-10-06,39,2,23,62
"16338","0900-0959",2020-10-07,40,3,26,66
"16339","0900-0959",2020-10-08,45,4,30,75
"16340","0900-0959",2020-10-09,47,5,30,77
"16341","0900-0959",2020-10-10,43,6,30,73
"16342","0900-0959",2020-10-11,48,7,30,78
"16343","0900-0959",2020-10-12,48,1,30,78
"16344","0900-0959",2020-10-13,37,2,26,63
"16345","0900-0959",2020-10-14,40,3,26,66
"16346","0900-0959",2020-10-15,47,4,30,77
"16347","0900-0959",2020-10-16,49,5,30,79
"16348","0900-0959",2020-10-17,45,6,30,75
"16349","0900-0959",2020-10-18,50,7,30,80
"16350","0900-0959",2020-10-19,48,1,30,78
"16351","0900-0959",2020-10-20,37,2,26,63
"16352","0900-0959",2020-10-21,41,3,26,67
"16353","0900-0959",2020-10-22,47,4,30,77
"16354","0900-0959",2020-10-23,49,5,30,79
"16355","0900-0959",2020-10-24,45,6,28,73
"16356","0900-0959",2020-10-25,49,7,27,76
"16357","0900-0959",2020-10-26,49,1,27,76
"16358","0900-0959",2020-10-27,39,2,25,64
"16359","0900-0959",2020-10-28,42,3,25,67
"16360","0900-0959",2020-10-29,47,4,27,74
"16361","0900-0959",2020-10-30,48,5,27,75
"16362","0900-0959",2020-10-31,45,6,26,71
"16363","1000-1059",2020-10-01,40,4,28,68
"16364","1000-1059",2020-10-02,42,5,29,71
"16365","1000-1059",2020-10-03,34,6,27,61
"16366","1000-1059",2020-10-04,40,7,30,70
"16367","1000-1059",2020-10-05,41,1,32,73
"16368","1000-1059",2020-10-06,31,2,28,59
"16369","1000-1059",2020-10-07,36,3,28,64
"16370","1000-1059",2020-10-08,46,4,31,77
"16371","1000-1059",2020-10-09,45,5,34,79
"16372","1000-1059",2020-10-10,36,6,33,69
"16373","1000-1059",2020-10-11,43,7,32,75
"16374","1000-1059",2020-10-12,45,1,35,80
"16375","1000-1059",2020-10-13,35,2,28,63
"16376","1000-1059",2020-10-14,36,3,29,65
"16377","1000-1059",2020-10-15,46,4,31,77
"16378","1000-1059",2020-10-16,47,5,33,80
"16379","1000-1059",2020-10-17,37,6,32,69
"16380","1000-1059",2020-10-18,43,7,31,74
"16381","1000-1059",2020-10-19,44,1,33,77
"16382","1000-1059",2020-10-20,35,2,27,62
"16383","1000-1059",2020-10-21,36,3,28,64
"16384","1000-1059",2020-10-22,45,4,31,76
"16385","1000-1059",2020-10-23,45,5,33,78
"16386","1000-1059",2020-10-24,35,6,31,66
"16387","1000-1059",2020-10-25,42,7,31,73
"16388","1000-1059",2020-10-26,42,1,33,75
"16389","1000-1059",2020-10-27,34,2,25,59
"16390","1000-1059",2020-10-28,35,3,27,62
"16391","1000-1059",2020-10-29,44,4,30,74
"16392","1000-1059",2020-10-30,43,5,33,76
"16393","1000-1059",2020-10-31,35,6,30,65
"16394","1100-1159",2020-10-01,41,4,32,73
"16395","1100-1159",2020-10-02,44,5,34,78
"16396","1100-1159",2020-10-03,43,6,33,76
"16397","1100-1159",2020-10-04,45,7,34,79
"16398","1100-1159",2020-10-05,44,1,35,79
"16399","1100-1159",2020-10-06,37,2,33,70
"16400","1100-1159",2020-10-07,37,3,33,70
"16401","1100-1159",2020-10-08,42,4,34,76
"16402","1100-1159",2020-10-09,44,5,35,79
"16403","1100-1159",2020-10-10,42,6,32,74
"16404","1100-1159",2020-10-11,45,7,35,80
"16405","1100-1159",2020-10-12,45,1,35,80
"16406","1100-1159",2020-10-13,35,2,32,67
"16407","1100-1159",2020-10-14,37,3,33,70
"16408","1100-1159",2020-10-15,41,4,36,77
"16409","1100-1159",2020-10-16,43,5,37,80
"16410","1100-1159",2020-10-17,41,6,34,75
"16411","1100-1159",2020-10-18,44,7,37,81
"16412","1100-1159",2020-10-19,43,1,37,80
"16413","1100-1159",2020-10-20,35,2,33,68
"16414","1100-1159",2020-10-21,37,3,34,71
"16415","1100-1159",2020-10-22,41,4,36,77
"16416","1100-1159",2020-10-23,43,5,37,80
"16417","1100-1159",2020-10-24,40,6,34,74
"16418","1100-1159",2020-10-25,42,7,37,79
"16419","1100-1159",2020-10-26,41,1,37,78
"16420","1100-1159",2020-10-27,35,2,34,69
"16421","1100-1159",2020-10-28,37,3,35,72
"16422","1100-1159",2020-10-29,40,4,37,77
"16423","1100-1159",2020-10-30,40,5,37,77
"16424","1100-1159",2020-10-31,36,6,35,71
"16425","1200-1259",2020-10-01,34,4,44,78
"16426","1200-1259",2020-10-02,33,5,46,79
"16427","1200-1259",2020-10-03,30,6,40,70
"16428","1200-1259",2020-10-04,34,7,47,81
"16429","1200-1259",2020-10-05,34,1,45,79
"16430","1200-1259",2020-10-06,28,2,37,65
"16431","1200-1259",2020-10-07,27,3,40,67
"16432","1200-1259",2020-10-08,31,4,45,76
"16433","1200-1259",2020-10-09,32,5,47,79
"16434","1200-1259",2020-10-10,33,6,41,74
"16435","1200-1259",2020-10-11,32,7,47,79
"16436","1200-1259",2020-10-12,33,1,46,79
"16437","1200-1259",2020-10-13,27,2,38,65
"16438","1200-1259",2020-10-14,27,3,40,67
"16439","1200-1259",2020-10-15,32,4,45,77
"16440","1200-1259",2020-10-16,32,5,47,79
"16441","1200-1259",2020-10-17,33,6,41,74
"16442","1200-1259",2020-10-18,32,7,47,79
"16443","1200-1259",2020-10-19,33,1,46,79
"16444","1200-1259",2020-10-20,27,2,38,65
"16445","1200-1259",2020-10-21,27,3,40,67
"16446","1200-1259",2020-10-22,31,4,45,76
"16447","1200-1259",2020-10-23,32,5,47,79
"16448","1200-1259",2020-10-24,34,6,38,72
"16449","1200-1259",2020-10-25,34,7,45,79
"16450","1200-1259",2020-10-26,35,1,44,79
"16451","1200-1259",2020-10-27,27,2,37,64
"16452","1200-1259",2020-10-28,27,3,39,66
"16453","1200-1259",2020-10-29,33,4,43,76
"16454","1200-1259",2020-10-30,34,5,44,78
"16455","1200-1259",2020-10-31,32,6,37,69
"16456","1300-1359",2020-10-01,45,4,37,82
"16457","1300-1359",2020-10-02,42,5,40,82
"16458","1300-1359",2020-10-03,41,6,35,76
"16459","1300-1359",2020-10-04,41,7,37,78
"16460","1300-1359",2020-10-05,39,1,41,80
"16461","1300-1359",2020-10-06,36,2,32,68
"16462","1300-1359",2020-10-07,35,3,35,70
"16463","1300-1359",2020-10-08,41,4,39,80
"16464","1300-1359",2020-10-09,37,5,41,78
"16465","1300-1359",2020-10-10,38,6,38,76
"16466","1300-1359",2020-10-11,40,7,38,78
"16467","1300-1359",2020-10-12,38,1,42,80
"16468","1300-1359",2020-10-13,35,2,34,69
"16469","1300-1359",2020-10-14,35,3,34,69
"16470","1300-1359",2020-10-15,45,4,40,85
"16471","1300-1359",2020-10-16,41,5,42,83
"16472","1300-1359",2020-10-17,42,6,38,80
"16473","1300-1359",2020-10-18,43,7,38,81
"16474","1300-1359",2020-10-19,42,1,41,83
"16475","1300-1359",2020-10-20,38,2,34,72
"16476","1300-1359",2020-10-21,38,3,34,72
"16477","1300-1359",2020-10-22,43,4,39,82
"16478","1300-1359",2020-10-23,40,5,41,81
"16479","1300-1359",2020-10-24,40,6,38,78
"16480","1300-1359",2020-10-25,41,7,38,79
"16481","1300-1359",2020-10-26,40,1,41,81
"16482","1300-1359",2020-10-27,36,2,32,68
"16483","1300-1359",2020-10-28,36,3,32,68
"16484","1300-1359",2020-10-29,42,4,39,81
"16485","1300-1359",2020-10-30,39,5,41,80
"16486","1300-1359",2020-10-31,39,6,36,75
"16487","1400-1459",2020-10-01,29,4,37,66
"16488","1400-1459",2020-10-02,33,5,39,72
"16489","1400-1459",2020-10-03,29,6,38,67
"16490","1400-1459",2020-10-04,32,7,37,69
"16491","1400-1459",2020-10-05,33,1,36,69
"16492","1400-1459",2020-10-06,26,2,34,60
"16493","1400-1459",2020-10-07,31,3,30,61
"16494","1400-1459",2020-10-08,37,4,34,71
"16495","1400-1459",2020-10-09,38,5,35,73
"16496","1400-1459",2020-10-10,37,6,35,72
"16497","1400-1459",2020-10-11,37,7,36,73
"16498","1400-1459",2020-10-12,39,1,35,74
"16499","1400-1459",2020-10-13,31,2,31,62
"16500","1400-1459",2020-10-14,32,3,31,63
"16501","1400-1459",2020-10-15,38,4,35,73
"16502","1400-1459",2020-10-16,39,5,35,74
"16503","1400-1459",2020-10-17,38,6,36,74
"16504","1400-1459",2020-10-18,38,7,36,74
"16505","1400-1459",2020-10-19,38,1,35,73
"16506","1400-1459",2020-10-20,32,2,30,62
"16507","1400-1459",2020-10-21,33,3,30,63
"16508","1400-1459",2020-10-22,39,4,33,72
"16509","1400-1459",2020-10-23,39,5,34,73
"16510","1400-1459",2020-10-24,37,6,35,72
"16511","1400-1459",2020-10-25,38,7,35,73
"16512","1400-1459",2020-10-26,38,1,34,72
"16513","1400-1459",2020-10-27,32,2,30,62
"16514","1400-1459",2020-10-28,33,3,30,63
"16515","1400-1459",2020-10-29,37,4,34,71
"16516","1400-1459",2020-10-30,38,5,34,72
"16517","1400-1459",2020-10-31,36,6,32,68
"16518","1500-1559",2020-10-01,37,4,36,73
"16519","1500-1559",2020-10-02,36,5,33,69
"16520","1500-1559",2020-10-03,37,6,32,69
"16521","1500-1559",2020-10-04,37,7,40,77
"16522","1500-1559",2020-10-05,36,1,39,75
"16523","1500-1559",2020-10-06,29,2,33,62
"16524","1500-1559",2020-10-07,30,3,35,65
"16525","1500-1559",2020-10-08,34,4,43,77
"16526","1500-1559",2020-10-09,34,5,38,72
"16527","1500-1559",2020-10-10,36,6,37,73
"16528","1500-1559",2020-10-11,36,7,42,78
"16529","1500-1559",2020-10-12,36,1,39,75
"16530","1500-1559",2020-10-13,29,2,34,63
"16531","1500-1559",2020-10-14,30,3,35,65
"16532","1500-1559",2020-10-15,34,4,43,77
"16533","1500-1559",2020-10-16,36,5,39,75
"16534","1500-1559",2020-10-17,36,6,36,72
"16535","1500-1559",2020-10-18,36,7,42,78
"16536","1500-1559",2020-10-19,36,1,39,75
"16537","1500-1559",2020-10-20,29,2,33,62
"16538","1500-1559",2020-10-21,30,3,34,64
"16539","1500-1559",2020-10-22,34,4,42,76
"16540","1500-1559",2020-10-23,34,5,37,71
"16541","1500-1559",2020-10-24,32,6,35,67
"16542","1500-1559",2020-10-25,32,7,41,73
"16543","1500-1559",2020-10-26,32,1,38,70
"16544","1500-1559",2020-10-27,29,2,33,62
"16545","1500-1559",2020-10-28,30,3,34,64
"16546","1500-1559",2020-10-29,31,4,42,73
"16547","1500-1559",2020-10-30,31,5,37,68
"16548","1500-1559",2020-10-31,27,6,36,63
"16549","1600-1659",2020-10-01,28,4,52,80
"16550","1600-1659",2020-10-02,29,5,53,82
"16551","1600-1659",2020-10-03,26,6,49,75
"16552","1600-1659",2020-10-04,30,7,46,76
"16553","1600-1659",2020-10-05,30,1,46,76
"16554","1600-1659",2020-10-06,23,2,37,60
"16555","1600-1659",2020-10-07,24,3,37,61
"16556","1600-1659",2020-10-08,30,4,49,79
"16557","1600-1659",2020-10-09,29,5,50,79
"16558","1600-1659",2020-10-10,25,6,47,72
"16559","1600-1659",2020-10-11,32,7,50,82
"16560","1600-1659",2020-10-12,30,1,52,82
"16561","1600-1659",2020-10-13,24,2,38,62
"16562","1600-1659",2020-10-14,24,3,38,62
"16563","1600-1659",2020-10-15,30,4,51,81
"16564","1600-1659",2020-10-16,29,5,54,83
"16565","1600-1659",2020-10-17,24,6,50,74
"16566","1600-1659",2020-10-18,32,7,51,83
"16567","1600-1659",2020-10-19,30,1,52,82
"16568","1600-1659",2020-10-20,23,2,40,63
"16569","1600-1659",2020-10-21,24,3,41,65
"16570","1600-1659",2020-10-22,30,4,51,81
"16571","1600-1659",2020-10-23,29,5,53,82
"16572","1600-1659",2020-10-24,21,6,45,66
"16573","1600-1659",2020-10-25,29,7,46,75
"16574","1600-1659",2020-10-26,26,1,48,74
"16575","1600-1659",2020-10-27,22,2,41,63
"16576","1600-1659",2020-10-28,22,3,41,63
"16577","1600-1659",2020-10-29,27,4,46,73
"16578","1600-1659",2020-10-30,26,5,49,75
"16579","1600-1659",2020-10-31,19,6,45,64
"16580","1700-1759",2020-10-01,43,4,34,77
"16581","1700-1759",2020-10-02,43,5,33,76
"16582","1700-1759",2020-10-03,42,6,31,73
"16583","1700-1759",2020-10-04,46,7,36,82
"16584","1700-1759",2020-10-05,46,1,34,80
"16585","1700-1759",2020-10-06,44,2,26,70
"16586","1700-1759",2020-10-07,45,3,28,73
"16587","1700-1759",2020-10-08,48,4,34,82
"16588","1700-1759",2020-10-09,49,5,33,82
"16589","1700-1759",2020-10-10,45,6,32,77
"16590","1700-1759",2020-10-11,48,7,36,84
"16591","1700-1759",2020-10-12,49,1,36,85
"16592","1700-1759",2020-10-13,45,2,27,72
"16593","1700-1759",2020-10-14,45,3,28,73
"16594","1700-1759",2020-10-15,48,4,34,82
"16595","1700-1759",2020-10-16,49,5,33,82
"16596","1700-1759",2020-10-17,45,6,31,76
"16597","1700-1759",2020-10-18,48,7,37,85
"16598","1700-1759",2020-10-19,49,1,35,84
"16599","1700-1759",2020-10-20,45,2,27,72
"16600","1700-1759",2020-10-21,46,3,28,74
"16601","1700-1759",2020-10-22,48,4,34,82
"16602","1700-1759",2020-10-23,49,5,33,82
"16603","1700-1759",2020-10-24,43,6,29,72
"16604","1700-1759",2020-10-25,47,7,34,81
"16605","1700-1759",2020-10-26,48,1,32,80
"16606","1700-1759",2020-10-27,46,2,26,72
"16607","1700-1759",2020-10-28,46,3,27,73
"16608","1700-1759",2020-10-29,47,4,30,77
"16609","1700-1759",2020-10-30,48,5,30,78
"16610","1700-1759",2020-10-31,42,6,26,68
"16611","1800-1859",2020-10-01,36,4,42,78
"16612","1800-1859",2020-10-02,36,5,43,79
"16613","1800-1859",2020-10-03,34,6,41,75
"16614","1800-1859",2020-10-04,35,7,44,79
"16615","1800-1859",2020-10-05,35,1,46,81
"16616","1800-1859",2020-10-06,29,2,42,71
"16617","1800-1859",2020-10-07,27,3,44,71
"16618","1800-1859",2020-10-08,32,4,48,80
"16619","1800-1859",2020-10-09,32,5,47,79
"16620","1800-1859",2020-10-10,29,6,44,73
"16621","1800-1859",2020-10-11,32,7,46,78
"16622","1800-1859",2020-10-12,32,1,48,80
"16623","1800-1859",2020-10-13,26,2,44,70
"16624","1800-1859",2020-10-14,27,3,44,71
"16625","1800-1859",2020-10-15,32,4,47,79
"16626","1800-1859",2020-10-16,32,5,47,79
"16627","1800-1859",2020-10-17,28,6,44,72
"16628","1800-1859",2020-10-18,32,7,46,78
"16629","1800-1859",2020-10-19,32,1,48,80
"16630","1800-1859",2020-10-20,24,2,43,67
"16631","1800-1859",2020-10-21,25,3,44,69
"16632","1800-1859",2020-10-22,32,4,47,79
"16633","1800-1859",2020-10-23,32,5,47,79
"16634","1800-1859",2020-10-24,24,6,43,67
"16635","1800-1859",2020-10-25,28,7,44,72
"16636","1800-1859",2020-10-26,28,1,47,75
"16637","1800-1859",2020-10-27,23,2,45,68
"16638","1800-1859",2020-10-28,24,3,45,69
"16639","1800-1859",2020-10-29,28,4,48,76
"16640","1800-1859",2020-10-30,28,5,46,74
"16641","1800-1859",2020-10-31,21,6,43,64
"16642","1900-1959",2020-10-01,30,4,36,66
"16643","1900-1959",2020-10-02,30,5,37,67
"16644","1900-1959",2020-10-03,30,6,36,66
"16645","1900-1959",2020-10-04,32,7,36,68
"16646","1900-1959",2020-10-05,31,1,36,67
"16647","1900-1959",2020-10-06,28,2,29,57
"16648","1900-1959",2020-10-07,32,3,31,63
"16649","1900-1959",2020-10-08,35,4,35,70
"16650","1900-1959",2020-10-09,35,5,36,71
"16651","1900-1959",2020-10-10,34,6,33,67
"16652","1900-1959",2020-10-11,35,7,35,70
"16653","1900-1959",2020-10-12,35,1,36,71
"16654","1900-1959",2020-10-13,32,2,29,61
"16655","1900-1959",2020-10-14,32,3,31,63
"16656","1900-1959",2020-10-15,35,4,35,70
"16657","1900-1959",2020-10-16,35,5,36,71
"16658","1900-1959",2020-10-17,34,6,32,66
"16659","1900-1959",2020-10-18,35,7,35,70
"16660","1900-1959",2020-10-19,35,1,36,71
"16661","1900-1959",2020-10-20,32,2,28,60
"16662","1900-1959",2020-10-21,32,3,31,63
"16663","1900-1959",2020-10-22,35,4,36,71
"16664","1900-1959",2020-10-23,35,5,36,71
"16665","1900-1959",2020-10-24,33,6,29,62
"16666","1900-1959",2020-10-25,36,7,34,70
"16667","1900-1959",2020-10-26,35,1,34,69
"16668","1900-1959",2020-10-27,32,2,28,60
"16669","1900-1959",2020-10-28,33,3,30,63
"16670","1900-1959",2020-10-29,35,4,33,68
"16671","1900-1959",2020-10-30,35,5,34,69
"16672","1900-1959",2020-10-31,29,6,29,58
"16673","2000-2059",2020-10-01,22,4,33,55
"16674","2000-2059",2020-10-02,23,5,34,57
"16675","2000-2059",2020-10-03,22,6,30,52
"16676","2000-2059",2020-10-04,21,7,37,58
"16677","2000-2059",2020-10-05,21,1,38,59
"16678","2000-2059",2020-10-06,17,2,34,51
"16679","2000-2059",2020-10-07,19,3,36,55
"16680","2000-2059",2020-10-08,26,4,38,64
"16681","2000-2059",2020-10-09,24,5,38,62
"16682","2000-2059",2020-10-10,19,6,36,55
"16683","2000-2059",2020-10-11,26,7,38,64
"16684","2000-2059",2020-10-12,24,1,38,62
"16685","2000-2059",2020-10-13,19,2,36,55
"16686","2000-2059",2020-10-14,20,3,36,56
"16687","2000-2059",2020-10-15,26,4,37,63
"16688","2000-2059",2020-10-16,24,5,37,61
"16689","2000-2059",2020-10-17,18,6,35,53
"16690","2000-2059",2020-10-18,26,7,37,63
"16691","2000-2059",2020-10-19,24,1,37,61
"16692","2000-2059",2020-10-20,19,2,36,55
"16693","2000-2059",2020-10-21,20,3,36,56
"16694","2000-2059",2020-10-22,27,4,37,64
"16695","2000-2059",2020-10-23,24,5,37,61
"16696","2000-2059",2020-10-24,18,6,34,52
"16697","2000-2059",2020-10-25,25,7,37,62
"16698","2000-2059",2020-10-26,23,1,37,60
"16699","2000-2059",2020-10-27,18,2,36,54
"16700","2000-2059",2020-10-28,20,3,36,56
"16701","2000-2059",2020-10-29,25,4,37,62
"16702","2000-2059",2020-10-30,24,5,37,61
"16703","2000-2059",2020-10-31,15,6,29,44
"16704","2100-2159",2020-10-01,15,4,38,53
"16705","2100-2159",2020-10-02,13,5,38,51
"16706","2100-2159",2020-10-03,7,6,37,44
"16707","2100-2159",2020-10-04,14,7,37,51
"16708","2100-2159",2020-10-05,12,1,37,49
"16709","2100-2159",2020-10-06,8,2,32,40
"16710","2100-2159",2020-10-07,9,3,38,47
"16711","2100-2159",2020-10-08,10,4,46,56
"16712","2100-2159",2020-10-09,10,5,47,57
"16713","2100-2159",2020-10-10,9,6,41,50
"16714","2100-2159",2020-10-11,11,7,47,58
"16715","2100-2159",2020-10-12,10,1,47,57
"16716","2100-2159",2020-10-13,8,2,36,44
"16717","2100-2159",2020-10-14,9,3,38,47
"16718","2100-2159",2020-10-15,11,4,48,59
"16719","2100-2159",2020-10-16,11,5,49,60
"16720","2100-2159",2020-10-17,10,6,42,52
"16721","2100-2159",2020-10-18,11,7,49,60
"16722","2100-2159",2020-10-19,11,1,49,60
"16723","2100-2159",2020-10-20,8,2,35,43
"16724","2100-2159",2020-10-21,8,3,37,45
"16725","2100-2159",2020-10-22,9,4,49,58
"16726","2100-2159",2020-10-23,11,5,49,60
"16727","2100-2159",2020-10-24,9,6,38,47
"16728","2100-2159",2020-10-25,10,7,45,55
"16729","2100-2159",2020-10-26,11,1,44,55
"16730","2100-2159",2020-10-27,9,2,34,43
"16731","2100-2159",2020-10-28,9,3,37,46
"16732","2100-2159",2020-10-29,9,4,45,54
"16733","2100-2159",2020-10-30,11,5,44,55
"16734","2100-2159",2020-10-31,8,6,31,39
"16735","2200-2259",2020-10-01,15,4,35,50
"16736","2200-2259",2020-10-02,15,5,36,51
"16737","2200-2259",2020-10-03,12,6,33,45
"16738","2200-2259",2020-10-04,14,7,38,52
"16739","2200-2259",2020-10-05,14,1,36,50
"16740","2200-2259",2020-10-06,9,2,31,40
"16741","2200-2259",2020-10-07,9,3,27,36
"16742","2200-2259",2020-10-08,14,4,33,47
"16743","2200-2259",2020-10-09,14,5,33,47
"16744","2200-2259",2020-10-10,13,6,30,43
"16745","2200-2259",2020-10-11,14,7,35,49
"16746","2200-2259",2020-10-12,14,1,33,47
"16747","2200-2259",2020-10-13,9,2,28,37
"16748","2200-2259",2020-10-14,9,3,28,37
"16749","2200-2259",2020-10-15,15,4,33,48
"16750","2200-2259",2020-10-16,15,5,33,48
"16751","2200-2259",2020-10-17,14,6,30,44
"16752","2200-2259",2020-10-18,15,7,35,50
"16753","2200-2259",2020-10-19,15,1,33,48
"16754","2200-2259",2020-10-20,10,2,28,38
"16755","2200-2259",2020-10-21,10,3,28,38
"16756","2200-2259",2020-10-22,15,4,33,48
"16757","2200-2259",2020-10-23,15,5,33,48
"16758","2200-2259",2020-10-24,10,6,28,38
"16759","2200-2259",2020-10-25,11,7,34,45
"16760","2200-2259",2020-10-26,11,1,31,42
"16761","2200-2259",2020-10-27,9,2,26,35
"16762","2200-2259",2020-10-28,8,3,27,35
"16763","2200-2259",2020-10-29,11,4,31,42
"16764","2200-2259",2020-10-30,11,5,31,42
"16765","2200-2259",2020-10-31,10,6,26,36
"16766","2300-2359",2020-10-01,7,4,19,26
"16767","2300-2359",2020-10-02,6,5,19,25
"16768","2300-2359",2020-10-03,4,6,16,20
"16769","2300-2359",2020-10-04,5,7,18,23
"16770","2300-2359",2020-10-05,5,1,17,22
"16771","2300-2359",2020-10-06,5,2,12,17
"16772","2300-2359",2020-10-07,8,3,14,22
"16773","2300-2359",2020-10-08,8,4,17,25
"16774","2300-2359",2020-10-09,8,5,17,25
"16775","2300-2359",2020-10-10,4,6,14,18
"16776","2300-2359",2020-10-11,8,7,17,25
"16777","2300-2359",2020-10-12,8,1,17,25
"16778","2300-2359",2020-10-13,8,2,14,22
"16779","2300-2359",2020-10-14,8,3,14,22
"16780","2300-2359",2020-10-15,9,4,18,27
"16781","2300-2359",2020-10-16,9,5,18,27
"16782","2300-2359",2020-10-17,5,6,15,20
"16783","2300-2359",2020-10-18,9,7,17,26
"16784","2300-2359",2020-10-19,9,1,17,26
"16785","2300-2359",2020-10-20,9,2,14,23
"16786","2300-2359",2020-10-21,9,3,14,23
"16787","2300-2359",2020-10-22,9,4,17,26
"16788","2300-2359",2020-10-23,9,5,17,26
"16789","2300-2359",2020-10-24,5,6,14,19
"16790","2300-2359",2020-10-25,9,7,17,26
"16791","2300-2359",2020-10-26,9,1,17,26
"16792","2300-2359",2020-10-27,9,2,14,23
"16793","2300-2359",2020-10-28,9,3,14,23
"16794","2300-2359",2020-10-29,9,4,17,26
"16795","2300-2359",2020-10-30,10,5,17,27
"16796","2300-2359",2020-10-31,5,6,12,17
"16797","0001-0559",2020-11-01,3,7,10,13
"16798","0001-0559",2020-11-02,6,1,13,19
"16799","0001-0559",2020-11-03,5,2,11,16
"16800","0001-0559",2020-11-04,4,3,9,13
"16801","0001-0559",2020-11-05,6,4,12,18
"16802","0001-0559",2020-11-06,8,5,14,22
"16803","0001-0559",2020-11-07,7,6,16,23
"16804","0001-0559",2020-11-08,7,7,18,25
"16805","0001-0559",2020-11-09,9,1,21,30
"16806","0001-0559",2020-11-10,8,2,13,21
"16807","0001-0559",2020-11-11,5,3,12,17
"16808","0001-0559",2020-11-12,6,4,17,23
"16809","0001-0559",2020-11-13,8,5,20,28
"16810","0001-0559",2020-11-14,8,6,21,29
"16811","0001-0559",2020-11-15,8,7,19,27
"16812","0001-0559",2020-11-16,9,1,20,29
"16813","0001-0559",2020-11-17,8,2,12,20
"16814","0001-0559",2020-11-18,5,3,16,21
"16815","0001-0559",2020-11-19,6,4,20,26
"16816","0001-0559",2020-11-20,9,5,26,35
"16817","0001-0559",2020-11-21,10,6,28,38
"16818","0001-0559",2020-11-22,10,7,25,35
"16819","0001-0559",2020-11-23,10,1,25,35
"16820","0001-0559",2020-11-24,10,2,23,33
"16821","0001-0559",2020-11-25,10,3,24,34
"16822","0001-0559",2020-11-26,8,4,15,23
"16823","0001-0559",2020-11-27,4,5,23,27
"16824","0001-0559",2020-11-28,11,6,27,38
"16825","0001-0559",2020-11-29,11,7,27,38
"16826","0001-0559",2020-11-30,11,1,25,36
"16827","0600-0659",2020-11-01,30,7,11,41
"16828","0600-0659",2020-11-02,29,1,10,39
"16829","0600-0659",2020-11-03,28,2,10,38
"16830","0600-0659",2020-11-04,24,3,11,35
"16831","0600-0659",2020-11-05,33,4,11,44
"16832","0600-0659",2020-11-06,34,5,13,47
"16833","0600-0659",2020-11-07,33,6,12,45
"16834","0600-0659",2020-11-08,37,7,15,52
"16835","0600-0659",2020-11-09,35,1,14,49
"16836","0600-0659",2020-11-10,30,2,14,44
"16837","0600-0659",2020-11-11,28,3,14,42
"16838","0600-0659",2020-11-12,34,4,15,49
"16839","0600-0659",2020-11-13,35,5,14,49
"16840","0600-0659",2020-11-14,33,6,15,48
"16841","0600-0659",2020-11-15,36,7,14,50
"16842","0600-0659",2020-11-16,35,1,13,48
"16843","0600-0659",2020-11-17,30,2,13,43
"16844","0600-0659",2020-11-18,31,3,15,46
"16845","0600-0659",2020-11-19,38,4,16,54
"16846","0600-0659",2020-11-20,43,5,18,61
"16847","0600-0659",2020-11-21,39,6,19,58
"16848","0600-0659",2020-11-22,43,7,17,60
"16849","0600-0659",2020-11-23,53,1,15,68
"16850","0600-0659",2020-11-24,53,2,15,68
"16851","0600-0659",2020-11-25,53,3,16,69
"16852","0600-0659",2020-11-26,37,4,10,47
"16853","0600-0659",2020-11-27,34,5,16,50
"16854","0600-0659",2020-11-28,41,6,21,62
"16855","0600-0659",2020-11-29,52,7,19,71
"16856","0600-0659",2020-11-30,53,1,16,69
"16857","0700-0759",2020-11-01,49,7,20,69
"16858","0700-0759",2020-11-02,54,1,19,73
"16859","0700-0759",2020-11-03,45,2,19,64
"16860","0700-0759",2020-11-04,42,3,18,60
"16861","0700-0759",2020-11-05,57,4,20,77
"16862","0700-0759",2020-11-06,61,5,21,82
"16863","0700-0759",2020-11-07,47,6,19,66
"16864","0700-0759",2020-11-08,56,7,19,75
"16865","0700-0759",2020-11-09,62,1,20,82
"16866","0700-0759",2020-11-10,45,2,20,65
"16867","0700-0759",2020-11-11,46,3,19,65
"16868","0700-0759",2020-11-12,60,4,19,79
"16869","0700-0759",2020-11-13,62,5,21,83
"16870","0700-0759",2020-11-14,50,6,19,69
"16871","0700-0759",2020-11-15,58,7,21,79
"16872","0700-0759",2020-11-16,61,1,21,82
"16873","0700-0759",2020-11-17,45,2,21,66
"16874","0700-0759",2020-11-18,43,3,22,65
"16875","0700-0759",2020-11-19,60,4,22,82
"16876","0700-0759",2020-11-20,64,5,28,92
"16877","0700-0759",2020-11-21,61,6,28,89
"16878","0700-0759",2020-11-22,65,7,28,93
"16879","0700-0759",2020-11-23,62,1,33,95
"16880","0700-0759",2020-11-24,62,2,33,95
"16881","0700-0759",2020-11-25,62,3,33,95
"16882","0700-0759",2020-11-26,50,4,22,72
"16883","0700-0759",2020-11-27,60,5,15,75
"16884","0700-0759",2020-11-28,62,6,29,91
"16885","0700-0759",2020-11-29,63,7,34,97
"16886","0700-0759",2020-11-30,63,1,33,96
"16887","0800-0859",2020-11-01,59,7,29,88
"16888","0800-0859",2020-11-02,60,1,31,91
"16889","0800-0859",2020-11-03,56,2,27,83
"16890","0800-0859",2020-11-04,59,3,26,85
"16891","0800-0859",2020-11-05,55,4,33,88
"16892","0800-0859",2020-11-06,59,5,31,90
"16893","0800-0859",2020-11-07,54,6,28,82
"16894","0800-0859",2020-11-08,58,7,32,90
"16895","0800-0859",2020-11-09,59,1,33,92
"16896","0800-0859",2020-11-10,57,2,25,82
"16897","0800-0859",2020-11-11,58,3,25,83
"16898","0800-0859",2020-11-12,56,4,32,88
"16899","0800-0859",2020-11-13,59,5,32,91
"16900","0800-0859",2020-11-14,57,6,29,86
"16901","0800-0859",2020-11-15,58,7,32,90
"16902","0800-0859",2020-11-16,58,1,32,90
"16903","0800-0859",2020-11-17,56,2,25,81
"16904","0800-0859",2020-11-18,54,3,22,76
"16905","0800-0859",2020-11-19,56,4,29,85
"16906","0800-0859",2020-11-20,58,5,32,90
"16907","0800-0859",2020-11-21,56,6,30,86
"16908","0800-0859",2020-11-22,55,7,29,84
"16909","0800-0859",2020-11-23,60,1,34,94
"16910","0800-0859",2020-11-24,58,2,35,93
"16911","0800-0859",2020-11-25,58,3,34,92
"16912","0800-0859",2020-11-26,50,4,26,76
"16913","0800-0859",2020-11-27,48,5,30,78
"16914","0800-0859",2020-11-28,58,6,29,87
"16915","0800-0859",2020-11-29,61,7,33,94
"16916","0800-0859",2020-11-30,59,1,35,94
"16917","0900-0959",2020-11-01,48,7,25,73
"16918","0900-0959",2020-11-02,47,1,25,72
"16919","0900-0959",2020-11-03,39,2,24,63
"16920","0900-0959",2020-11-04,39,3,21,60
"16921","0900-0959",2020-11-05,52,4,22,74
"16922","0900-0959",2020-11-06,49,5,26,75
"16923","0900-0959",2020-11-07,47,6,22,69
"16924","0900-0959",2020-11-08,50,7,24,74
"16925","0900-0959",2020-11-09,52,1,26,78
"16926","0900-0959",2020-11-10,41,2,23,64
"16927","0900-0959",2020-11-11,39,3,22,61
"16928","0900-0959",2020-11-12,53,4,24,77
"16929","0900-0959",2020-11-13,50,5,25,75
"16930","0900-0959",2020-11-14,46,6,24,70
"16931","0900-0959",2020-11-15,51,7,24,75
"16932","0900-0959",2020-11-16,51,1,25,76
"16933","0900-0959",2020-11-17,41,2,22,63
"16934","0900-0959",2020-11-18,38,3,24,62
"16935","0900-0959",2020-11-19,50,4,29,79
"16936","0900-0959",2020-11-20,52,5,30,82
"16937","0900-0959",2020-11-21,47,6,30,77
"16938","0900-0959",2020-11-22,52,7,33,85
"16939","0900-0959",2020-11-23,51,1,31,82
"16940","0900-0959",2020-11-24,52,2,29,81
"16941","0900-0959",2020-11-25,47,3,28,75
"16942","0900-0959",2020-11-26,39,4,32,71
"16943","0900-0959",2020-11-27,44,5,30,74
"16944","0900-0959",2020-11-28,46,6,34,80
"16945","0900-0959",2020-11-29,48,7,29,77
"16946","0900-0959",2020-11-30,50,1,29,79
"16947","1000-1059",2020-11-01,40,7,32,72
"16948","1000-1059",2020-11-02,42,1,34,76
"16949","1000-1059",2020-11-03,32,2,27,59
"16950","1000-1059",2020-11-04,34,3,27,61
"16951","1000-1059",2020-11-05,36,4,37,73
"16952","1000-1059",2020-11-06,37,5,38,75
"16953","1000-1059",2020-11-07,26,6,35,61
"16954","1000-1059",2020-11-08,38,7,38,76
"16955","1000-1059",2020-11-09,36,1,39,75
"16956","1000-1059",2020-11-10,34,2,30,64
"16957","1000-1059",2020-11-11,37,3,30,67
"16958","1000-1059",2020-11-12,38,4,39,77
"16959","1000-1059",2020-11-13,37,5,39,76
"16960","1000-1059",2020-11-14,29,6,35,64
"16961","1000-1059",2020-11-15,38,7,38,76
"16962","1000-1059",2020-11-16,36,1,39,75
"16963","1000-1059",2020-11-17,33,2,30,63
"16964","1000-1059",2020-11-18,39,3,29,68
"16965","1000-1059",2020-11-19,45,4,40,85
"16966","1000-1059",2020-11-20,43,5,40,83
"16967","1000-1059",2020-11-21,39,6,37,76
"16968","1000-1059",2020-11-22,47,7,40,87
"16969","1000-1059",2020-11-23,47,1,41,88
"16970","1000-1059",2020-11-24,48,2,41,89
"16971","1000-1059",2020-11-25,45,3,40,85
"16972","1000-1059",2020-11-26,35,4,30,65
"16973","1000-1059",2020-11-27,46,5,31,77
"16974","1000-1059",2020-11-28,45,6,39,84
"16975","1000-1059",2020-11-29,47,7,40,87
"16976","1000-1059",2020-11-30,47,1,42,89
"16977","1100-1159",2020-11-01,41,7,35,76
"16978","1100-1159",2020-11-02,41,1,34,75
"16979","1100-1159",2020-11-03,35,2,32,67
"16980","1100-1159",2020-11-04,37,3,34,71
"16981","1100-1159",2020-11-05,49,4,36,85
"16982","1100-1159",2020-11-06,49,5,33,82
"16983","1100-1159",2020-11-07,45,6,31,76
"16984","1100-1159",2020-11-08,50,7,30,80
"16985","1100-1159",2020-11-09,49,1,31,80
"16986","1100-1159",2020-11-10,34,2,30,64
"16987","1100-1159",2020-11-11,37,3,30,67
"16988","1100-1159",2020-11-12,49,4,33,82
"16989","1100-1159",2020-11-13,48,5,30,78
"16990","1100-1159",2020-11-14,46,6,29,75
"16991","1100-1159",2020-11-15,49,7,31,80
"16992","1100-1159",2020-11-16,48,1,31,79
"16993","1100-1159",2020-11-17,35,2,30,65
"16994","1100-1159",2020-11-18,35,3,28,63
"16995","1100-1159",2020-11-19,46,4,32,78
"16996","1100-1159",2020-11-20,47,5,32,79
"16997","1100-1159",2020-11-21,43,6,30,73
"16998","1100-1159",2020-11-22,44,7,32,76
"16999","1100-1159",2020-11-23,45,1,32,77
"17000","1100-1159",2020-11-24,44,2,33,77
"17001","1100-1159",2020-11-25,46,3,31,77
"17002","1100-1159",2020-11-26,38,4,28,66
"17003","1100-1159",2020-11-27,43,5,33,76
"17004","1100-1159",2020-11-28,41,6,32,73
"17005","1100-1159",2020-11-29,47,7,36,83
"17006","1100-1159",2020-11-30,49,1,34,83
"17007","1200-1259",2020-11-01,34,7,44,78
"17008","1200-1259",2020-11-02,37,1,48,85
"17009","1200-1259",2020-11-03,29,2,41,70
"17010","1200-1259",2020-11-04,28,3,41,69
"17011","1200-1259",2020-11-05,32,4,48,80
"17012","1200-1259",2020-11-06,29,5,49,78
"17013","1200-1259",2020-11-07,28,6,42,70
"17014","1200-1259",2020-11-08,30,7,55,85
"17015","1200-1259",2020-11-09,30,1,53,83
"17016","1200-1259",2020-11-10,27,2,49,76
"17017","1200-1259",2020-11-11,26,3,48,74
"17018","1200-1259",2020-11-12,30,4,54,84
"17019","1200-1259",2020-11-13,27,5,54,81
"17020","1200-1259",2020-11-14,25,6,48,73
"17021","1200-1259",2020-11-15,30,7,54,84
"17022","1200-1259",2020-11-16,30,1,53,83
"17023","1200-1259",2020-11-17,27,2,48,75
"17024","1200-1259",2020-11-18,27,3,48,75
"17025","1200-1259",2020-11-19,31,4,53,84
"17026","1200-1259",2020-11-20,31,5,58,89
"17027","1200-1259",2020-11-21,30,6,55,85
"17028","1200-1259",2020-11-22,33,7,57,90
"17029","1200-1259",2020-11-23,35,1,61,96
"17030","1200-1259",2020-11-24,34,2,59,93
"17031","1200-1259",2020-11-25,36,3,59,95
"17032","1200-1259",2020-11-26,25,4,43,68
"17033","1200-1259",2020-11-27,33,5,52,85
"17034","1200-1259",2020-11-28,32,6,57,89
"17035","1200-1259",2020-11-29,38,7,59,97
"17036","1200-1259",2020-11-30,38,1,61,99
"17037","1300-1359",2020-11-01,43,7,37,80
"17038","1300-1359",2020-11-02,41,1,38,79
"17039","1300-1359",2020-11-03,34,2,30,64
"17040","1300-1359",2020-11-04,33,3,29,62
"17041","1300-1359",2020-11-05,41,4,36,77
"17042","1300-1359",2020-11-06,39,5,39,78
"17043","1300-1359",2020-11-07,38,6,34,72
"17044","1300-1359",2020-11-08,44,7,36,80
"17045","1300-1359",2020-11-09,42,1,36,78
"17046","1300-1359",2020-11-10,35,2,27,62
"17047","1300-1359",2020-11-11,35,3,28,63
"17048","1300-1359",2020-11-12,45,4,35,80
"17049","1300-1359",2020-11-13,39,5,37,76
"17050","1300-1359",2020-11-14,40,6,32,72
"17051","1300-1359",2020-11-15,43,7,36,79
"17052","1300-1359",2020-11-16,42,1,36,78
"17053","1300-1359",2020-11-17,35,2,28,63
"17054","1300-1359",2020-11-18,32,3,26,58
"17055","1300-1359",2020-11-19,42,4,35,77
"17056","1300-1359",2020-11-20,46,5,41,87
"17057","1300-1359",2020-11-21,50,6,39,89
"17058","1300-1359",2020-11-22,47,7,42,89
"17059","1300-1359",2020-11-23,46,1,40,86
"17060","1300-1359",2020-11-24,47,2,43,90
"17061","1300-1359",2020-11-25,44,3,40,84
"17062","1300-1359",2020-11-26,28,4,32,60
"17063","1300-1359",2020-11-27,43,5,40,83
"17064","1300-1359",2020-11-28,51,6,40,91
"17065","1300-1359",2020-11-29,49,7,43,92
"17066","1300-1359",2020-11-30,46,1,42,88
"17067","1400-1459",2020-11-01,41,7,37,78
"17068","1400-1459",2020-11-02,40,1,37,77
"17069","1400-1459",2020-11-03,34,2,33,67
"17070","1400-1459",2020-11-04,32,3,33,65
"17071","1400-1459",2020-11-05,33,4,38,71
"17072","1400-1459",2020-11-06,35,5,38,73
"17073","1400-1459",2020-11-07,34,6,32,66
"17074","1400-1459",2020-11-08,37,7,40,77
"17075","1400-1459",2020-11-09,36,1,37,73
"17076","1400-1459",2020-11-10,31,2,31,62
"17077","1400-1459",2020-11-11,30,3,31,61
"17078","1400-1459",2020-11-12,34,4,38,72
"17079","1400-1459",2020-11-13,35,5,36,71
"17080","1400-1459",2020-11-14,33,6,31,64
"17081","1400-1459",2020-11-15,36,7,39,75
"17082","1400-1459",2020-11-16,35,1,37,72
"17083","1400-1459",2020-11-17,30,2,31,61
"17084","1400-1459",2020-11-18,32,3,33,65
"17085","1400-1459",2020-11-19,32,4,42,74
"17086","1400-1459",2020-11-20,38,5,37,75
"17087","1400-1459",2020-11-21,39,6,33,72
"17088","1400-1459",2020-11-22,38,7,37,75
"17089","1400-1459",2020-11-23,41,1,39,80
"17090","1400-1459",2020-11-24,41,2,38,79
"17091","1400-1459",2020-11-25,41,3,38,79
"17092","1400-1459",2020-11-26,27,4,30,57
"17093","1400-1459",2020-11-27,37,5,35,72
"17094","1400-1459",2020-11-28,40,6,34,74
"17095","1400-1459",2020-11-29,46,7,40,86
"17096","1400-1459",2020-11-30,45,1,39,84
"17097","1500-1559",2020-11-01,34,7,40,74
"17098","1500-1559",2020-11-02,34,1,35,69
"17099","1500-1559",2020-11-03,30,2,29,59
"17100","1500-1559",2020-11-04,29,3,29,58
"17101","1500-1559",2020-11-05,33,4,38,71
"17102","1500-1559",2020-11-06,33,5,34,67
"17103","1500-1559",2020-11-07,32,6,29,61
"17104","1500-1559",2020-11-08,39,7,45,84
"17105","1500-1559",2020-11-09,37,1,40,77
"17106","1500-1559",2020-11-10,26,2,33,59
"17107","1500-1559",2020-11-11,29,3,33,62
"17108","1500-1559",2020-11-12,37,4,43,80
"17109","1500-1559",2020-11-13,36,5,37,73
"17110","1500-1559",2020-11-14,36,6,34,70
"17111","1500-1559",2020-11-15,38,7,44,82
"17112","1500-1559",2020-11-16,38,1,39,77
"17113","1500-1559",2020-11-17,26,2,32,58
"17114","1500-1559",2020-11-18,30,3,32,62
"17115","1500-1559",2020-11-19,40,4,41,81
"17116","1500-1559",2020-11-20,41,5,37,78
"17117","1500-1559",2020-11-21,42,6,37,79
"17118","1500-1559",2020-11-22,42,7,42,84
"17119","1500-1559",2020-11-23,42,1,39,81
"17120","1500-1559",2020-11-24,41,2,40,81
"17121","1500-1559",2020-11-25,41,3,41,82
"17122","1500-1559",2020-11-26,22,4,26,48
"17123","1500-1559",2020-11-27,39,5,37,76
"17124","1500-1559",2020-11-28,43,6,37,80
"17125","1500-1559",2020-11-29,42,7,44,86
"17126","1500-1559",2020-11-30,40,1,43,83
"17127","1600-1659",2020-11-01,26,7,47,73
"17128","1600-1659",2020-11-02,24,1,48,72
"17129","1600-1659",2020-11-03,19,2,40,59
"17130","1600-1659",2020-11-04,27,3,37,64
"17131","1600-1659",2020-11-05,31,4,43,74
"17132","1600-1659",2020-11-06,26,5,45,71
"17133","1600-1659",2020-11-07,25,6,42,67
"17134","1600-1659",2020-11-08,37,7,39,76
"17135","1600-1659",2020-11-09,33,1,43,76
"17136","1600-1659",2020-11-10,28,2,34,62
"17137","1600-1659",2020-11-11,29,3,36,65
"17138","1600-1659",2020-11-12,34,4,40,74
"17139","1600-1659",2020-11-13,29,5,42,71
"17140","1600-1659",2020-11-14,28,6,41,69
"17141","1600-1659",2020-11-15,34,7,38,72
"17142","1600-1659",2020-11-16,31,1,43,74
"17143","1600-1659",2020-11-17,28,2,34,62
"17144","1600-1659",2020-11-18,29,3,36,65
"17145","1600-1659",2020-11-19,33,4,39,72
"17146","1600-1659",2020-11-20,32,5,45,77
"17147","1600-1659",2020-11-21,33,6,42,75
"17148","1600-1659",2020-11-22,35,7,41,76
"17149","1600-1659",2020-11-23,36,1,48,84
"17150","1600-1659",2020-11-24,34,2,44,78
"17151","1600-1659",2020-11-25,37,3,45,82
"17152","1600-1659",2020-11-26,12,4,32,44
"17153","1600-1659",2020-11-27,31,5,39,70
"17154","1600-1659",2020-11-28,36,6,40,76
"17155","1600-1659",2020-11-29,39,7,43,82
"17156","1600-1659",2020-11-30,36,1,46,82
"17157","1700-1759",2020-11-01,46,7,38,84
"17158","1700-1759",2020-11-02,47,1,36,83
"17159","1700-1759",2020-11-03,45,2,29,74
"17160","1700-1759",2020-11-04,40,3,28,68
"17161","1700-1759",2020-11-05,45,4,36,81
"17162","1700-1759",2020-11-06,44,5,35,79
"17163","1700-1759",2020-11-07,39,6,34,73
"17164","1700-1759",2020-11-08,42,7,46,88
"17165","1700-1759",2020-11-09,43,1,44,87
"17166","1700-1759",2020-11-10,39,2,31,70
"17167","1700-1759",2020-11-11,40,3,32,72
"17168","1700-1759",2020-11-12,41,4,43,84
"17169","1700-1759",2020-11-13,42,5,39,81
"17170","1700-1759",2020-11-14,41,6,37,78
"17171","1700-1759",2020-11-15,41,7,46,87
"17172","1700-1759",2020-11-16,41,1,41,82
"17173","1700-1759",2020-11-17,40,2,32,72
"17174","1700-1759",2020-11-18,43,3,37,80
"17175","1700-1759",2020-11-19,43,4,47,90
"17176","1700-1759",2020-11-20,46,5,51,97
"17177","1700-1759",2020-11-21,45,6,48,93
"17178","1700-1759",2020-11-22,44,7,53,97
"17179","1700-1759",2020-11-23,45,1,52,97
"17180","1700-1759",2020-11-24,44,2,57,101
"17181","1700-1759",2020-11-25,46,3,57,103
"17182","1700-1759",2020-11-26,26,4,28,54
"17183","1700-1759",2020-11-27,38,5,51,89
"17184","1700-1759",2020-11-28,45,6,53,98
"17185","1700-1759",2020-11-29,45,7,56,101
"17186","1700-1759",2020-11-30,46,1,55,101
"17187","1800-1859",2020-11-01,31,7,46,77
"17188","1800-1859",2020-11-02,31,1,49,80
"17189","1800-1859",2020-11-03,26,2,42,68
"17190","1800-1859",2020-11-04,29,3,41,70
"17191","1800-1859",2020-11-05,33,4,48,81
"17192","1800-1859",2020-11-06,34,5,47,81
"17193","1800-1859",2020-11-07,28,6,39,67
"17194","1800-1859",2020-11-08,38,7,47,85
"17195","1800-1859",2020-11-09,37,1,47,84
"17196","1800-1859",2020-11-10,34,2,38,72
"17197","1800-1859",2020-11-11,33,3,39,72
"17198","1800-1859",2020-11-12,37,4,46,83
"17199","1800-1859",2020-11-13,38,5,46,84
"17200","1800-1859",2020-11-14,34,6,41,75
"17201","1800-1859",2020-11-15,38,7,45,83
"17202","1800-1859",2020-11-16,36,1,47,83
"17203","1800-1859",2020-11-17,34,2,39,73
"17204","1800-1859",2020-11-18,34,3,36,70
"17205","1800-1859",2020-11-19,40,4,42,82
"17206","1800-1859",2020-11-20,40,5,41,81
"17207","1800-1859",2020-11-21,42,6,40,82
"17208","1800-1859",2020-11-22,40,7,43,83
"17209","1800-1859",2020-11-23,37,1,37,74
"17210","1800-1859",2020-11-24,38,2,35,73
"17211","1800-1859",2020-11-25,39,3,36,75
"17212","1800-1859",2020-11-26,9,4,21,30
"17213","1800-1859",2020-11-27,38,5,39,77
"17214","1800-1859",2020-11-28,45,6,40,85
"17215","1800-1859",2020-11-29,40,7,39,79
"17216","1800-1859",2020-11-30,38,1,36,74
"17217","1900-1959",2020-11-01,32,7,33,65
"17218","1900-1959",2020-11-02,34,1,35,69
"17219","1900-1959",2020-11-03,29,2,29,58
"17220","1900-1959",2020-11-04,26,3,36,62
"17221","1900-1959",2020-11-05,35,4,40,75
"17222","1900-1959",2020-11-06,35,5,39,74
"17223","1900-1959",2020-11-07,27,6,40,67
"17224","1900-1959",2020-11-08,39,7,36,75
"17225","1900-1959",2020-11-09,38,1,38,76
"17226","1900-1959",2020-11-10,29,2,34,63
"17227","1900-1959",2020-11-11,30,3,35,65
"17228","1900-1959",2020-11-12,37,4,39,76
"17229","1900-1959",2020-11-13,36,5,37,73
"17230","1900-1959",2020-11-14,29,6,40,69
"17231","1900-1959",2020-11-15,37,7,36,73
"17232","1900-1959",2020-11-16,36,1,37,73
"17233","1900-1959",2020-11-17,29,2,34,63
"17234","1900-1959",2020-11-18,33,3,36,69
"17235","1900-1959",2020-11-19,45,4,40,85
"17236","1900-1959",2020-11-20,50,5,41,91
"17237","1900-1959",2020-11-21,47,6,47,94
"17238","1900-1959",2020-11-22,48,7,42,90
"17239","1900-1959",2020-11-23,47,1,42,89
"17240","1900-1959",2020-11-24,50,2,42,92
"17241","1900-1959",2020-11-25,50,3,41,91
"17242","1900-1959",2020-11-26,17,4,20,37
"17243","1900-1959",2020-11-27,46,5,39,85
"17244","1900-1959",2020-11-28,46,6,47,93
"17245","1900-1959",2020-11-29,51,7,43,94
"17246","1900-1959",2020-11-30,48,1,41,89
"17247","2000-2059",2020-11-01,23,7,33,56
"17248","2000-2059",2020-11-02,22,1,33,55
"17249","2000-2059",2020-11-03,18,2,34,52
"17250","2000-2059",2020-11-04,15,3,34,49
"17251","2000-2059",2020-11-05,25,4,33,58
"17252","2000-2059",2020-11-06,25,5,32,57
"17253","2000-2059",2020-11-07,17,6,29,46
"17254","2000-2059",2020-11-08,25,7,36,61
"17255","2000-2059",2020-11-09,23,1,34,57
"17256","2000-2059",2020-11-10,18,2,34,52
"17257","2000-2059",2020-11-11,17,3,35,52
"17258","2000-2059",2020-11-12,24,4,33,57
"17259","2000-2059",2020-11-13,25,5,32,57
"17260","2000-2059",2020-11-14,17,6,32,49
"17261","2000-2059",2020-11-15,25,7,34,59
"17262","2000-2059",2020-11-16,23,1,32,55
"17263","2000-2059",2020-11-17,18,2,34,52
"17264","2000-2059",2020-11-18,19,3,37,56
"17265","2000-2059",2020-11-19,25,4,39,64
"17266","2000-2059",2020-11-20,30,5,39,69
"17267","2000-2059",2020-11-21,32,6,39,71
"17268","2000-2059",2020-11-22,31,7,40,71
"17269","2000-2059",2020-11-23,31,1,40,71
"17270","2000-2059",2020-11-24,31,2,39,70
"17271","2000-2059",2020-11-25,31,3,41,72
"17272","2000-2059",2020-11-26,10,4,16,26
"17273","2000-2059",2020-11-27,27,5,38,65
"17274","2000-2059",2020-11-28,35,6,43,78
"17275","2000-2059",2020-11-29,35,7,45,80
"17276","2000-2059",2020-11-30,31,1,40,71
"17277","2100-2159",2020-11-01,11,7,46,57
"17278","2100-2159",2020-11-02,11,1,47,58
"17279","2100-2159",2020-11-03,8,2,35,43
"17280","2100-2159",2020-11-04,9,3,32,41
"17281","2100-2159",2020-11-05,11,4,45,56
"17282","2100-2159",2020-11-06,12,5,44,56
"17283","2100-2159",2020-11-07,14,6,33,47
"17284","2100-2159",2020-11-08,14,7,49,63
"17285","2100-2159",2020-11-09,13,1,47,60
"17286","2100-2159",2020-11-10,10,2,34,44
"17287","2100-2159",2020-11-11,11,3,35,46
"17288","2100-2159",2020-11-12,13,4,47,60
"17289","2100-2159",2020-11-13,14,5,48,62
"17290","2100-2159",2020-11-14,15,6,37,52
"17291","2100-2159",2020-11-15,14,7,49,63
"17292","2100-2159",2020-11-16,13,1,47,60
"17293","2100-2159",2020-11-17,10,2,33,43
"17294","2100-2159",2020-11-18,17,3,33,50
"17295","2100-2159",2020-11-19,18,4,46,64
"17296","2100-2159",2020-11-20,19,5,54,73
"17297","2100-2159",2020-11-21,18,6,52,70
"17298","2100-2159",2020-11-22,19,7,53,72
"17299","2100-2159",2020-11-23,23,1,51,74
"17300","2100-2159",2020-11-24,22,2,52,74
"17301","2100-2159",2020-11-25,24,3,54,78
"17302","2100-2159",2020-11-26,8,4,21,29
"17303","2100-2159",2020-11-27,16,5,49,65
"17304","2100-2159",2020-11-28,22,6,54,76
"17305","2100-2159",2020-11-29,27,7,56,83
"17306","2100-2159",2020-11-30,24,1,52,76
"17307","2200-2259",2020-11-01,12,7,35,47
"17308","2200-2259",2020-11-02,12,1,33,45
"17309","2200-2259",2020-11-03,10,2,26,36
"17310","2200-2259",2020-11-04,9,3,29,38
"17311","2200-2259",2020-11-05,12,4,37,49
"17312","2200-2259",2020-11-06,12,5,39,51
"17313","2200-2259",2020-11-07,10,6,35,45
"17314","2200-2259",2020-11-08,16,7,46,62
"17315","2200-2259",2020-11-09,15,1,41,56
"17316","2200-2259",2020-11-10,11,2,34,45
"17317","2200-2259",2020-11-11,11,3,35,46
"17318","2200-2259",2020-11-12,16,4,42,58
"17319","2200-2259",2020-11-13,16,5,42,58
"17320","2200-2259",2020-11-14,15,6,38,53
"17321","2200-2259",2020-11-15,16,7,45,61
"17322","2200-2259",2020-11-16,15,1,40,55
"17323","2200-2259",2020-11-17,11,2,34,45
"17324","2200-2259",2020-11-18,13,3,38,51
"17325","2200-2259",2020-11-19,18,4,45,63
"17326","2200-2259",2020-11-20,20,5,46,66
"17327","2200-2259",2020-11-21,20,6,49,69
"17328","2200-2259",2020-11-22,20,7,46,66
"17329","2200-2259",2020-11-23,18,1,49,67
"17330","2200-2259",2020-11-24,20,2,51,71
"17331","2200-2259",2020-11-25,21,3,51,72
"17332","2200-2259",2020-11-26,12,4,17,29
"17333","2200-2259",2020-11-27,19,5,42,61
"17334","2200-2259",2020-11-28,22,6,49,71
"17335","2200-2259",2020-11-29,22,7,55,77
"17336","2200-2259",2020-11-30,20,1,52,72
"17337","2300-2359",2020-11-01,12,7,17,29
"17338","2300-2359",2020-11-02,11,1,18,29
"17339","2300-2359",2020-11-03,11,2,15,26
"17340","2300-2359",2020-11-04,11,3,12,23
"17341","2300-2359",2020-11-05,11,4,17,28
"17342","2300-2359",2020-11-06,12,5,16,28
"17343","2300-2359",2020-11-07,12,6,11,23
"17344","2300-2359",2020-11-08,12,7,18,30
"17345","2300-2359",2020-11-09,12,1,17,29
"17346","2300-2359",2020-11-10,11,2,14,25
"17347","2300-2359",2020-11-11,11,3,13,24
"17348","2300-2359",2020-11-12,12,4,17,29
"17349","2300-2359",2020-11-13,12,5,17,29
"17350","2300-2359",2020-11-14,13,6,12,25
"17351","2300-2359",2020-11-15,12,7,17,29
"17352","2300-2359",2020-11-16,12,1,17,29
"17353","2300-2359",2020-11-17,10,2,14,24
"17354","2300-2359",2020-11-18,12,3,18,30
"17355","2300-2359",2020-11-19,13,4,24,37
"17356","2300-2359",2020-11-20,17,5,30,47
"17357","2300-2359",2020-11-21,20,6,30,50
"17358","2300-2359",2020-11-22,16,7,29,45
"17359","2300-2359",2020-11-23,14,1,34,48
"17360","2300-2359",2020-11-24,14,2,34,48
"17361","2300-2359",2020-11-25,14,3,36,50
"17362","2300-2359",2020-11-26,7,4,11,18
"17363","2300-2359",2020-11-27,15,5,22,37
"17364","2300-2359",2020-11-28,19,6,35,54
"17365","2300-2359",2020-11-29,16,7,38,54
"17366","2300-2359",2020-11-30,14,1,37,51
"17367","0001-0559",2020-12-01,9,2,21,30
"17368","0001-0559",2020-12-02,8,3,9,17
"17369","0001-0559",2020-12-03,8,4,13,21
"17370","0001-0559",2020-12-04,10,5,17,27
"17371","0001-0559",2020-12-05,10,6,12,22
"17372","0001-0559",2020-12-06,9,7,15,24
"17373","0001-0559",2020-12-07,10,1,15,25
"17374","0001-0559",2020-12-08,10,2,10,20
"17375","0001-0559",2020-12-09,7,3,8,15
"17376","0001-0559",2020-12-10,8,4,12,20
"17377","0001-0559",2020-12-11,10,5,17,27
"17378","0001-0559",2020-12-12,10,6,12,22
"17379","0001-0559",2020-12-13,9,7,15,24
"17380","0001-0559",2020-12-14,10,1,15,25
"17381","0001-0559",2020-12-15,10,2,10,20
"17382","0001-0559",2020-12-16,7,3,12,19
"17383","0001-0559",2020-12-17,11,4,22,33
"17384","0001-0559",2020-12-18,11,5,30,41
"17385","0001-0559",2020-12-19,12,6,32,44
"17386","0001-0559",2020-12-20,11,7,29,40
"17387","0001-0559",2020-12-21,10,1,28,38
"17388","0001-0559",2020-12-22,11,2,29,40
"17389","0001-0559",2020-12-23,11,3,27,38
"17390","0001-0559",2020-12-24,8,4,16,24
"17391","0001-0559",2020-12-25,4,5,20,24
"17392","0001-0559",2020-12-26,10,6,31,41
"17393","0001-0559",2020-12-27,11,7,29,40
"17394","0001-0559",2020-12-28,10,1,27,37
"17395","0001-0559",2020-12-29,11,2,26,37
"17396","0001-0559",2020-12-30,11,3,27,38
"17397","0001-0559",2020-12-31,8,4,15,23
"17398","0600-0659",2020-12-01,39,2,13,52
"17399","0600-0659",2020-12-02,26,3,15,41
"17400","0600-0659",2020-12-03,28,4,14,42
"17401","0600-0659",2020-12-04,30,5,17,47
"17402","0600-0659",2020-12-05,32,6,17,49
"17403","0600-0659",2020-12-06,29,7,16,45
"17404","0600-0659",2020-12-07,29,1,15,44
"17405","0600-0659",2020-12-08,28,2,13,41
"17406","0600-0659",2020-12-09,27,3,14,41
"17407","0600-0659",2020-12-10,28,4,13,41
"17408","0600-0659",2020-12-11,30,5,16,46
"17409","0600-0659",2020-12-12,32,6,16,48
"17410","0600-0659",2020-12-13,29,7,14,43
"17411","0600-0659",2020-12-14,29,1,15,44
"17412","0600-0659",2020-12-15,28,2,14,42
"17413","0600-0659",2020-12-16,31,3,18,49
"17414","0600-0659",2020-12-17,42,4,20,62
"17415","0600-0659",2020-12-18,52,5,23,75
"17416","0600-0659",2020-12-19,47,6,23,70
"17417","0600-0659",2020-12-20,49,7,22,71
"17418","0600-0659",2020-12-21,53,1,22,75
"17419","0600-0659",2020-12-22,49,2,22,71
"17420","0600-0659",2020-12-23,59,3,20,79
"17421","0600-0659",2020-12-24,40,4,13,53
"17422","0600-0659",2020-12-25,26,5,16,42
"17423","0600-0659",2020-12-26,44,6,23,67
"17424","0600-0659",2020-12-27,61,7,21,82
"17425","0600-0659",2020-12-28,47,1,20,67
"17426","0600-0659",2020-12-29,46,2,21,67
"17427","0600-0659",2020-12-30,47,3,21,68
"17428","0600-0659",2020-12-31,39,4,12,51
"17429","0700-0759",2020-12-01,60,2,26,86
"17430","0700-0759",2020-12-02,52,3,20,72
"17431","0700-0759",2020-12-03,55,4,21,76
"17432","0700-0759",2020-12-04,56,5,21,77
"17433","0700-0759",2020-12-05,54,6,22,76
"17434","0700-0759",2020-12-06,53,7,21,74
"17435","0700-0759",2020-12-07,55,1,21,76
"17436","0700-0759",2020-12-08,48,2,22,70
"17437","0700-0759",2020-12-09,46,3,20,66
"17438","0700-0759",2020-12-10,55,4,21,76
"17439","0700-0759",2020-12-11,55,5,21,76
"17440","0700-0759",2020-12-12,54,6,22,76
"17441","0700-0759",2020-12-13,53,7,21,74
"17442","0700-0759",2020-12-14,55,1,21,76
"17443","0700-0759",2020-12-15,50,2,22,72
"17444","0700-0759",2020-12-16,51,3,21,72
"17445","0700-0759",2020-12-17,61,4,27,88
"17446","0700-0759",2020-12-18,63,5,29,92
"17447","0700-0759",2020-12-19,60,6,29,89
"17448","0700-0759",2020-12-20,65,7,28,93
"17449","0700-0759",2020-12-21,62,1,29,91
"17450","0700-0759",2020-12-22,61,2,29,90
"17451","0700-0759",2020-12-23,60,3,34,94
"17452","0700-0759",2020-12-24,52,4,19,71
"17453","0700-0759",2020-12-25,42,5,12,54
"17454","0700-0759",2020-12-26,57,6,27,84
"17455","0700-0759",2020-12-27,59,7,34,93
"17456","0700-0759",2020-12-28,62,1,27,89
"17457","0700-0759",2020-12-29,62,2,28,90
"17458","0700-0759",2020-12-30,63,3,27,90
"17459","0700-0759",2020-12-31,53,4,19,72
"17460","0800-0859",2020-12-01,54,2,31,85
"17461","0800-0859",2020-12-02,56,3,26,82
"17462","0800-0859",2020-12-03,58,4,28,86
"17463","0800-0859",2020-12-04,60,5,29,89
"17464","0800-0859",2020-12-05,49,6,29,78
"17465","0800-0859",2020-12-06,62,7,26,88
"17466","0800-0859",2020-12-07,60,1,29,89
"17467","0800-0859",2020-12-08,52,2,26,78
"17468","0800-0859",2020-12-09,55,3,25,80
"17469","0800-0859",2020-12-10,59,4,28,87
"17470","0800-0859",2020-12-11,60,5,29,89
"17471","0800-0859",2020-12-12,50,6,29,79
"17472","0800-0859",2020-12-13,59,7,26,85
"17473","0800-0859",2020-12-14,60,1,29,89
"17474","0800-0859",2020-12-15,52,2,26,78
"17475","0800-0859",2020-12-16,55,3,24,79
"17476","0800-0859",2020-12-17,63,4,27,90
"17477","0800-0859",2020-12-18,68,5,30,98
"17478","0800-0859",2020-12-19,67,6,30,97
"17479","0800-0859",2020-12-20,69,7,31,100
"17480","0800-0859",2020-12-21,69,1,32,101
"17481","0800-0859",2020-12-22,67,2,29,96
"17482","0800-0859",2020-12-23,70,3,33,103
"17483","0800-0859",2020-12-24,65,4,27,92
"17484","0800-0859",2020-12-25,48,5,19,67
"17485","0800-0859",2020-12-26,65,6,28,93
"17486","0800-0859",2020-12-27,72,7,37,109
"17487","0800-0859",2020-12-28,71,1,29,100
"17488","0800-0859",2020-12-29,65,2,30,95
"17489","0800-0859",2020-12-30,69,3,29,98
"17490","0800-0859",2020-12-31,64,4,26,90
"17491","0900-0959",2020-12-01,47,2,31,78
"17492","0900-0959",2020-12-02,34,3,24,58
"17493","0900-0959",2020-12-03,43,4,24,67
"17494","0900-0959",2020-12-04,43,5,25,68
"17495","0900-0959",2020-12-05,42,6,24,66
"17496","0900-0959",2020-12-06,43,7,25,68
"17497","0900-0959",2020-12-07,42,1,25,67
"17498","0900-0959",2020-12-08,35,2,23,58
"17499","0900-0959",2020-12-09,34,3,22,56
"17500","0900-0959",2020-12-10,43,4,24,67
"17501","0900-0959",2020-12-11,43,5,25,68
"17502","0900-0959",2020-12-12,42,6,25,67
"17503","0900-0959",2020-12-13,43,7,24,67
"17504","0900-0959",2020-12-14,43,1,25,68
"17505","0900-0959",2020-12-15,36,2,23,59
"17506","0900-0959",2020-12-16,36,3,26,62
"17507","0900-0959",2020-12-17,48,4,33,81
"17508","0900-0959",2020-12-18,46,5,39,85
"17509","0900-0959",2020-12-19,45,6,36,81
"17510","0900-0959",2020-12-20,46,7,39,85
"17511","0900-0959",2020-12-21,49,1,38,87
"17512","0900-0959",2020-12-22,45,2,38,83
"17513","0900-0959",2020-12-23,45,3,35,80
"17514","0900-0959",2020-12-24,37,4,36,73
"17515","0900-0959",2020-12-25,32,5,28,60
"17516","0900-0959",2020-12-26,45,6,36,81
"17517","0900-0959",2020-12-27,46,7,34,80
"17518","0900-0959",2020-12-28,44,1,38,82
"17519","0900-0959",2020-12-29,50,2,37,87
"17520","0900-0959",2020-12-30,49,3,38,87
"17521","0900-0959",2020-12-31,37,4,36,73
"17522","1000-1059",2020-12-01,39,2,35,74
"17523","1000-1059",2020-12-02,42,3,28,70
"17524","1000-1059",2020-12-03,46,4,34,80
"17525","1000-1059",2020-12-04,48,5,35,83
"17526","1000-1059",2020-12-05,35,6,31,66
"17527","1000-1059",2020-12-06,46,7,34,80
"17528","1000-1059",2020-12-07,47,1,34,81
"17529","1000-1059",2020-12-08,37,2,26,63
"17530","1000-1059",2020-12-09,41,3,27,68
"17531","1000-1059",2020-12-10,45,4,35,80
"17532","1000-1059",2020-12-11,46,5,36,82
"17533","1000-1059",2020-12-12,35,6,31,66
"17534","1000-1059",2020-12-13,46,7,34,80
"17535","1000-1059",2020-12-14,46,1,35,81
"17536","1000-1059",2020-12-15,36,2,28,64
"17537","1000-1059",2020-12-16,42,3,31,73
"17538","1000-1059",2020-12-17,50,4,40,90
"17539","1000-1059",2020-12-18,56,5,39,95
"17540","1000-1059",2020-12-19,51,6,40,91
"17541","1000-1059",2020-12-20,54,7,40,94
"17542","1000-1059",2020-12-21,52,1,40,92
"17543","1000-1059",2020-12-22,51,2,40,91
"17544","1000-1059",2020-12-23,54,3,42,96
"17545","1000-1059",2020-12-24,52,4,31,83
"17546","1000-1059",2020-12-25,45,5,23,68
"17547","1000-1059",2020-12-26,53,6,36,89
"17548","1000-1059",2020-12-27,55,7,41,96
"17549","1000-1059",2020-12-28,54,1,43,97
"17550","1000-1059",2020-12-29,49,2,39,88
"17551","1000-1059",2020-12-30,53,3,40,93
"17552","1000-1059",2020-12-31,51,4,32,83
"17553","1100-1159",2020-12-01,42,2,31,73
"17554","1100-1159",2020-12-02,36,3,30,66
"17555","1100-1159",2020-12-03,42,4,35,77
"17556","1100-1159",2020-12-04,42,5,34,76
"17557","1100-1159",2020-12-05,45,6,34,79
"17558","1100-1159",2020-12-06,42,7,34,76
"17559","1100-1159",2020-12-07,41,1,35,76
"17560","1100-1159",2020-12-08,32,2,29,61
"17561","1100-1159",2020-12-09,33,3,30,63
"17562","1100-1159",2020-12-10,42,4,35,77
"17563","1100-1159",2020-12-11,42,5,33,75
"17564","1100-1159",2020-12-12,44,6,34,78
"17565","1100-1159",2020-12-13,42,7,33,75
"17566","1100-1159",2020-12-14,41,1,34,75
"17567","1100-1159",2020-12-15,35,2,31,66
"17568","1100-1159",2020-12-16,36,3,33,69
"17569","1100-1159",2020-12-17,45,4,34,79
"17570","1100-1159",2020-12-18,48,5,39,87
"17571","1100-1159",2020-12-19,43,6,38,81
"17572","1100-1159",2020-12-20,46,7,40,86
"17573","1100-1159",2020-12-21,47,1,40,87
"17574","1100-1159",2020-12-22,45,2,38,83
"17575","1100-1159",2020-12-23,49,3,37,86
"17576","1100-1159",2020-12-24,33,4,38,71
"17577","1100-1159",2020-12-25,29,5,29,58
"17578","1100-1159",2020-12-26,42,6,38,80
"17579","1100-1159",2020-12-27,47,7,41,88
"17580","1100-1159",2020-12-28,47,1,38,85
"17581","1100-1159",2020-12-29,46,2,38,84
"17582","1100-1159",2020-12-30,44,3,38,82
"17583","1100-1159",2020-12-31,34,4,37,71
"17584","1200-1259",2020-12-01,29,2,53,82
"17585","1200-1259",2020-12-02,24,3,48,72
"17586","1200-1259",2020-12-03,33,4,50,83
"17587","1200-1259",2020-12-04,31,5,53,84
"17588","1200-1259",2020-12-05,22,6,48,70
"17589","1200-1259",2020-12-06,32,7,53,85
"17590","1200-1259",2020-12-07,32,1,51,83
"17591","1200-1259",2020-12-08,27,2,47,74
"17592","1200-1259",2020-12-09,25,3,48,73
"17593","1200-1259",2020-12-10,32,4,49,81
"17594","1200-1259",2020-12-11,29,5,53,82
"17595","1200-1259",2020-12-12,22,6,48,70
"17596","1200-1259",2020-12-13,32,7,53,85
"17597","1200-1259",2020-12-14,31,1,52,83
"17598","1200-1259",2020-12-15,27,2,46,73
"17599","1200-1259",2020-12-16,27,3,47,74
"17600","1200-1259",2020-12-17,37,4,54,91
"17601","1200-1259",2020-12-18,36,5,59,95
"17602","1200-1259",2020-12-19,36,6,52,88
"17603","1200-1259",2020-12-20,40,7,52,92
"17604","1200-1259",2020-12-21,39,1,56,95
"17605","1200-1259",2020-12-22,39,2,52,91
"17606","1200-1259",2020-12-23,37,3,56,93
"17607","1200-1259",2020-12-24,39,4,46,85
"17608","1200-1259",2020-12-25,38,5,46,84
"17609","1200-1259",2020-12-26,35,6,54,89
"17610","1200-1259",2020-12-27,43,7,54,97
"17611","1200-1259",2020-12-28,39,1,52,91
"17612","1200-1259",2020-12-29,39,2,52,91
"17613","1200-1259",2020-12-30,40,3,54,94
"17614","1200-1259",2020-12-31,42,4,46,88
"17615","1300-1359",2020-12-01,41,2,35,76
"17616","1300-1359",2020-12-02,39,3,34,73
"17617","1300-1359",2020-12-03,47,4,38,85
"17618","1300-1359",2020-12-04,46,5,39,85
"17619","1300-1359",2020-12-05,44,6,35,79
"17620","1300-1359",2020-12-06,47,7,38,85
"17621","1300-1359",2020-12-07,48,1,38,86
"17622","1300-1359",2020-12-08,32,2,31,63
"17623","1300-1359",2020-12-09,38,3,32,70
"17624","1300-1359",2020-12-10,45,4,37,82
"17625","1300-1359",2020-12-11,45,5,36,81
"17626","1300-1359",2020-12-12,43,6,34,77
"17627","1300-1359",2020-12-13,45,7,38,83
"17628","1300-1359",2020-12-14,48,1,37,85
"17629","1300-1359",2020-12-15,33,2,30,63
"17630","1300-1359",2020-12-16,39,3,32,71
"17631","1300-1359",2020-12-17,44,4,46,90
"17632","1300-1359",2020-12-18,47,5,42,89
"17633","1300-1359",2020-12-19,43,6,40,83
"17634","1300-1359",2020-12-20,39,7,43,82
"17635","1300-1359",2020-12-21,40,1,42,82
"17636","1300-1359",2020-12-22,38,2,40,78
"17637","1300-1359",2020-12-23,44,3,40,84
"17638","1300-1359",2020-12-24,27,4,40,67
"17639","1300-1359",2020-12-25,33,5,33,66
"17640","1300-1359",2020-12-26,45,6,42,87
"17641","1300-1359",2020-12-27,41,7,42,83
"17642","1300-1359",2020-12-28,39,1,40,79
"17643","1300-1359",2020-12-29,39,2,41,80
"17644","1300-1359",2020-12-30,41,3,40,81
"17645","1300-1359",2020-12-31,29,4,40,69
"17646","1400-1459",2020-12-01,35,2,33,68
"17647","1400-1459",2020-12-02,33,3,29,62
"17648","1400-1459",2020-12-03,36,4,35,71
"17649","1400-1459",2020-12-04,38,5,34,72
"17650","1400-1459",2020-12-05,30,6,30,60
"17651","1400-1459",2020-12-06,39,7,35,74
"17652","1400-1459",2020-12-07,35,1,34,69
"17653","1400-1459",2020-12-08,33,2,25,58
"17654","1400-1459",2020-12-09,32,3,26,58
"17655","1400-1459",2020-12-10,35,4,36,71
"17656","1400-1459",2020-12-11,37,5,34,71
"17657","1400-1459",2020-12-12,29,6,30,59
"17658","1400-1459",2020-12-13,39,7,35,74
"17659","1400-1459",2020-12-14,35,1,34,69
"17660","1400-1459",2020-12-15,32,2,28,60
"17661","1400-1459",2020-12-16,35,3,30,65
"17662","1400-1459",2020-12-17,41,4,41,82
"17663","1400-1459",2020-12-18,42,5,44,86
"17664","1400-1459",2020-12-19,45,6,44,89
"17665","1400-1459",2020-12-20,45,7,46,91
"17666","1400-1459",2020-12-21,45,1,44,89
"17667","1400-1459",2020-12-22,43,2,43,86
"17668","1400-1459",2020-12-23,47,3,47,94
"17669","1400-1459",2020-12-24,38,4,33,71
"17670","1400-1459",2020-12-25,38,5,34,72
"17671","1400-1459",2020-12-26,46,6,44,90
"17672","1400-1459",2020-12-27,46,7,49,95
"17673","1400-1459",2020-12-28,43,1,45,88
"17674","1400-1459",2020-12-29,42,2,42,84
"17675","1400-1459",2020-12-30,42,3,45,87
"17676","1400-1459",2020-12-31,37,4,36,73
"17677","1500-1559",2020-12-01,37,2,33,70
"17678","1500-1559",2020-12-02,33,3,28,61
"17679","1500-1559",2020-12-03,38,4,37,75
"17680","1500-1559",2020-12-04,34,5,35,69
"17681","1500-1559",2020-12-05,39,6,33,72
"17682","1500-1559",2020-12-06,35,7,38,73
"17683","1500-1559",2020-12-07,36,1,37,73
"17684","1500-1559",2020-12-08,30,2,28,58
"17685","1500-1559",2020-12-09,32,3,29,61
"17686","1500-1559",2020-12-10,38,4,36,74
"17687","1500-1559",2020-12-11,34,5,33,67
"17688","1500-1559",2020-12-12,39,6,32,71
"17689","1500-1559",2020-12-13,35,7,38,73
"17690","1500-1559",2020-12-14,36,1,36,72
"17691","1500-1559",2020-12-15,29,2,28,57
"17692","1500-1559",2020-12-16,33,3,31,64
"17693","1500-1559",2020-12-17,41,4,43,84
"17694","1500-1559",2020-12-18,43,5,46,89
"17695","1500-1559",2020-12-19,41,6,48,89
"17696","1500-1559",2020-12-20,41,7,47,88
"17697","1500-1559",2020-12-21,41,1,46,87
"17698","1500-1559",2020-12-22,42,2,46,88
"17699","1500-1559",2020-12-23,39,3,49,88
"17700","1500-1559",2020-12-24,31,4,41,72
"17701","1500-1559",2020-12-25,36,5,37,73
"17702","1500-1559",2020-12-26,39,6,47,86
"17703","1500-1559",2020-12-27,40,7,51,91
"17704","1500-1559",2020-12-28,46,1,44,90
"17705","1500-1559",2020-12-29,42,2,47,89
"17706","1500-1559",2020-12-30,43,3,48,91
"17707","1500-1559",2020-12-31,33,4,42,75
"17708","1600-1659",2020-12-01,24,2,38,62
"17709","1600-1659",2020-12-02,24,3,40,64
"17710","1600-1659",2020-12-03,30,4,44,74
"17711","1600-1659",2020-12-04,30,5,42,72
"17712","1600-1659",2020-12-05,26,6,35,61
"17713","1600-1659",2020-12-06,32,7,43,75
"17714","1600-1659",2020-12-07,34,1,41,75
"17715","1600-1659",2020-12-08,22,2,36,58
"17716","1600-1659",2020-12-09,25,3,39,64
"17717","1600-1659",2020-12-10,31,4,43,74
"17718","1600-1659",2020-12-11,30,5,42,72
"17719","1600-1659",2020-12-12,26,6,36,62
"17720","1600-1659",2020-12-13,32,7,42,74
"17721","1600-1659",2020-12-14,33,1,42,75
"17722","1600-1659",2020-12-15,23,2,35,58
"17723","1600-1659",2020-12-16,29,3,41,70
"17724","1600-1659",2020-12-17,40,4,45,85
"17725","1600-1659",2020-12-18,43,5,41,84
"17726","1600-1659",2020-12-19,47,6,39,86
"17727","1600-1659",2020-12-20,45,7,43,88
"17728","1600-1659",2020-12-21,43,1,43,86
"17729","1600-1659",2020-12-22,44,2,43,87
"17730","1600-1659",2020-12-23,51,3,46,97
"17731","1600-1659",2020-12-24,33,4,31,64
"17732","1600-1659",2020-12-25,40,5,31,71
"17733","1600-1659",2020-12-26,48,6,39,87
"17734","1600-1659",2020-12-27,50,7,46,96
"17735","1600-1659",2020-12-28,42,1,44,86
"17736","1600-1659",2020-12-29,44,2,42,86
"17737","1600-1659",2020-12-30,47,3,43,90
"17738","1600-1659",2020-12-31,35,4,31,66
"17739","1700-1759",2020-12-01,44,2,50,94
"17740","1700-1759",2020-12-02,39,3,39,78
"17741","1700-1759",2020-12-03,44,4,47,91
"17742","1700-1759",2020-12-04,43,5,46,89
"17743","1700-1759",2020-12-05,37,6,40,77
"17744","1700-1759",2020-12-06,47,7,50,97
"17745","1700-1759",2020-12-07,44,1,47,91
"17746","1700-1759",2020-12-08,38,2,37,75
"17747","1700-1759",2020-12-09,38,3,38,76
"17748","1700-1759",2020-12-10,45,4,46,91
"17749","1700-1759",2020-12-11,43,5,45,88
"17750","1700-1759",2020-12-12,37,6,38,75
"17751","1700-1759",2020-12-13,45,7,48,93
"17752","1700-1759",2020-12-14,44,1,47,91
"17753","1700-1759",2020-12-15,38,2,37,75
"17754","1700-1759",2020-12-16,41,3,40,81
"17755","1700-1759",2020-12-17,44,4,54,98
"17756","1700-1759",2020-12-18,43,5,53,96
"17757","1700-1759",2020-12-19,46,6,47,93
"17758","1700-1759",2020-12-20,44,7,52,96
"17759","1700-1759",2020-12-21,43,1,51,94
"17760","1700-1759",2020-12-22,42,2,49,91
"17761","1700-1759",2020-12-23,46,3,54,100
"17762","1700-1759",2020-12-24,28,4,42,70
"17763","1700-1759",2020-12-25,29,5,46,75
"17764","1700-1759",2020-12-26,47,6,46,93
"17765","1700-1759",2020-12-27,44,7,52,96
"17766","1700-1759",2020-12-28,44,1,54,98
"17767","1700-1759",2020-12-29,42,2,51,93
"17768","1700-1759",2020-12-30,43,3,54,97
"17769","1700-1759",2020-12-31,28,4,45,73
"17770","1800-1859",2020-12-01,34,2,40,74
"17771","1800-1859",2020-12-02,33,3,37,70
"17772","1800-1859",2020-12-03,41,4,46,87
"17773","1800-1859",2020-12-04,39,5,43,82
"17774","1800-1859",2020-12-05,31,6,41,72
"17775","1800-1859",2020-12-06,40,7,44,84
"17776","1800-1859",2020-12-07,38,1,48,86
"17777","1800-1859",2020-12-08,29,2,36,65
"17778","1800-1859",2020-12-09,30,3,37,67
"17779","1800-1859",2020-12-10,42,4,48,90
"17780","1800-1859",2020-12-11,40,5,44,84
"17781","1800-1859",2020-12-12,31,6,42,73
"17782","1800-1859",2020-12-13,40,7,44,84
"17783","1800-1859",2020-12-14,38,1,47,85
"17784","1800-1859",2020-12-15,28,2,36,64
"17785","1800-1859",2020-12-16,34,3,41,75
"17786","1800-1859",2020-12-17,40,4,38,78
"17787","1800-1859",2020-12-18,45,5,45,90
"17788","1800-1859",2020-12-19,49,6,42,91
"17789","1800-1859",2020-12-20,45,7,42,87
"17790","1800-1859",2020-12-21,44,1,42,86
"17791","1800-1859",2020-12-22,44,2,40,84
"17792","1800-1859",2020-12-23,46,3,40,86
"17793","1800-1859",2020-12-24,16,4,35,51
"17794","1800-1859",2020-12-25,20,5,38,58
"17795","1800-1859",2020-12-26,49,6,43,92
"17796","1800-1859",2020-12-27,43,7,38,81
"17797","1800-1859",2020-12-28,47,1,43,90
"17798","1800-1859",2020-12-29,44,2,40,84
"17799","1800-1859",2020-12-30,46,3,45,91
"17800","1800-1859",2020-12-31,17,4,34,51
"17801","1900-1959",2020-12-01,48,2,34,82
"17802","1900-1959",2020-12-02,37,3,32,69
"17803","1900-1959",2020-12-03,39,4,39,78
"17804","1900-1959",2020-12-04,39,5,37,76
"17805","1900-1959",2020-12-05,34,6,34,68
"17806","1900-1959",2020-12-06,39,7,38,77
"17807","1900-1959",2020-12-07,39,1,36,75
"17808","1900-1959",2020-12-08,36,2,32,68
"17809","1900-1959",2020-12-09,36,3,32,68
"17810","1900-1959",2020-12-10,39,4,38,77
"17811","1900-1959",2020-12-11,39,5,37,76
"17812","1900-1959",2020-12-12,34,6,33,67
"17813","1900-1959",2020-12-13,39,7,37,76
"17814","1900-1959",2020-12-14,39,1,35,74
"17815","1900-1959",2020-12-15,35,2,30,65
"17816","1900-1959",2020-12-16,39,3,32,71
"17817","1900-1959",2020-12-17,53,4,38,91
"17818","1900-1959",2020-12-18,53,5,38,91
"17819","1900-1959",2020-12-19,52,6,41,93
"17820","1900-1959",2020-12-20,52,7,42,94
"17821","1900-1959",2020-12-21,51,1,39,90
"17822","1900-1959",2020-12-22,51,2,38,89
"17823","1900-1959",2020-12-23,52,3,42,94
"17824","1900-1959",2020-12-24,32,4,27,59
"17825","1900-1959",2020-12-25,38,5,30,68
"17826","1900-1959",2020-12-26,52,6,43,95
"17827","1900-1959",2020-12-27,53,7,40,93
"17828","1900-1959",2020-12-28,51,1,41,92
"17829","1900-1959",2020-12-29,51,2,38,89
"17830","1900-1959",2020-12-30,51,3,40,91
"17831","1900-1959",2020-12-31,30,4,26,56
"17832","2000-2059",2020-12-01,25,2,34,59
"17833","2000-2059",2020-12-02,16,3,32,48
"17834","2000-2059",2020-12-03,20,4,37,57
"17835","2000-2059",2020-12-04,21,5,38,59
"17836","2000-2059",2020-12-05,17,6,29,46
"17837","2000-2059",2020-12-06,20,7,40,60
"17838","2000-2059",2020-12-07,20,1,37,57
"17839","2000-2059",2020-12-08,17,2,31,48
"17840","2000-2059",2020-12-09,16,3,32,48
"17841","2000-2059",2020-12-10,20,4,37,57
"17842","2000-2059",2020-12-11,21,5,37,58
"17843","2000-2059",2020-12-12,17,6,29,46
"17844","2000-2059",2020-12-13,20,7,39,59
"17845","2000-2059",2020-12-14,20,1,37,57
"17846","2000-2059",2020-12-15,17,2,32,49
"17847","2000-2059",2020-12-16,17,3,36,53
"17848","2000-2059",2020-12-17,24,4,42,66
"17849","2000-2059",2020-12-18,27,5,43,70
"17850","2000-2059",2020-12-19,26,6,46,72
"17851","2000-2059",2020-12-20,30,7,40,70
"17852","2000-2059",2020-12-21,27,1,40,67
"17853","2000-2059",2020-12-22,26,2,42,68
"17854","2000-2059",2020-12-23,28,3,43,71
"17855","2000-2059",2020-12-24,8,4,26,34
"17856","2000-2059",2020-12-25,8,5,28,36
"17857","2000-2059",2020-12-26,24,6,46,70
"17858","2000-2059",2020-12-27,32,7,42,74
"17859","2000-2059",2020-12-28,26,1,42,68
"17860","2000-2059",2020-12-29,25,2,42,67
"17861","2000-2059",2020-12-30,25,3,41,66
"17862","2000-2059",2020-12-31,8,4,26,34
"17863","2100-2159",2020-12-01,15,2,48,63
"17864","2100-2159",2020-12-02,11,3,46,57
"17865","2100-2159",2020-12-03,12,4,50,62
"17866","2100-2159",2020-12-04,12,5,51,63
"17867","2100-2159",2020-12-05,12,6,45,57
"17868","2100-2159",2020-12-06,12,7,50,62
"17869","2100-2159",2020-12-07,12,1,51,63
"17870","2100-2159",2020-12-08,11,2,42,53
"17871","2100-2159",2020-12-09,11,3,43,54
"17872","2100-2159",2020-12-10,11,4,51,62
"17873","2100-2159",2020-12-11,12,5,51,63
"17874","2100-2159",2020-12-12,13,6,45,58
"17875","2100-2159",2020-12-13,12,7,50,62
"17876","2100-2159",2020-12-14,12,1,51,63
"17877","2100-2159",2020-12-15,11,2,42,53
"17878","2100-2159",2020-12-16,12,3,45,57
"17879","2100-2159",2020-12-17,17,4,65,82
"17880","2100-2159",2020-12-18,18,5,72,90
"17881","2100-2159",2020-12-19,19,6,73,92
"17882","2100-2159",2020-12-20,18,7,70,88
"17883","2100-2159",2020-12-21,20,1,74,94
"17884","2100-2159",2020-12-22,18,2,70,88
"17885","2100-2159",2020-12-23,23,3,72,95
"17886","2100-2159",2020-12-24,8,4,37,45
"17887","2100-2159",2020-12-25,11,5,42,53
"17888","2100-2159",2020-12-26,20,6,72,92
"17889","2100-2159",2020-12-27,23,7,71,94
"17890","2100-2159",2020-12-28,19,1,73,92
"17891","2100-2159",2020-12-29,16,2,69,85
"17892","2100-2159",2020-12-30,16,3,71,87
"17893","2100-2159",2020-12-31,7,4,39,46
"17894","2200-2259",2020-12-01,16,2,43,59
"17895","2200-2259",2020-12-02,9,3,31,40
"17896","2200-2259",2020-12-03,14,4,33,47
"17897","2200-2259",2020-12-04,14,5,32,46
"17898","2200-2259",2020-12-05,11,6,29,40
"17899","2200-2259",2020-12-06,14,7,33,47
"17900","2200-2259",2020-12-07,14,1,32,46
"17901","2200-2259",2020-12-08,8,2,29,37
"17902","2200-2259",2020-12-09,9,3,30,39
"17903","2200-2259",2020-12-10,13,4,33,46
"17904","2200-2259",2020-12-11,14,5,32,46
"17905","2200-2259",2020-12-12,10,6,29,39
"17906","2200-2259",2020-12-13,14,7,33,47
"17907","2200-2259",2020-12-14,14,1,32,46
"17908","2200-2259",2020-12-15,9,2,28,37
"17909","2200-2259",2020-12-16,15,3,34,49
"17910","2200-2259",2020-12-17,23,4,41,64
"17911","2200-2259",2020-12-18,26,5,41,67
"17912","2200-2259",2020-12-19,27,6,42,69
"17913","2200-2259",2020-12-20,28,7,43,71
"17914","2200-2259",2020-12-21,26,1,39,65
"17915","2200-2259",2020-12-22,27,2,40,67
"17916","2200-2259",2020-12-23,24,3,45,69
"17917","2200-2259",2020-12-24,15,4,22,37
"17918","2200-2259",2020-12-25,21,5,22,43
"17919","2200-2259",2020-12-26,27,6,41,68
"17920","2200-2259",2020-12-27,25,7,49,74
"17921","2200-2259",2020-12-28,22,1,39,61
"17922","2200-2259",2020-12-29,25,2,39,64
"17923","2200-2259",2020-12-30,25,3,40,65
"17924","2200-2259",2020-12-31,16,4,22,38
"17925","2300-2359",2020-12-01,14,2,23,37
"17926","2300-2359",2020-12-02,11,3,15,26
"17927","2300-2359",2020-12-03,12,4,21,33
"17928","2300-2359",2020-12-04,14,5,22,36
"17929","2300-2359",2020-12-05,14,6,16,30
"17930","2300-2359",2020-12-06,13,7,21,34
"17931","2300-2359",2020-12-07,12,1,22,34
"17932","2300-2359",2020-12-08,10,2,12,22
"17933","2300-2359",2020-12-09,10,3,13,23
"17934","2300-2359",2020-12-10,11,4,20,31
"17935","2300-2359",2020-12-11,13,5,22,35
"17936","2300-2359",2020-12-12,13,6,16,29
"17937","2300-2359",2020-12-13,11,7,21,32
"17938","2300-2359",2020-12-14,12,1,22,34
"17939","2300-2359",2020-12-15,10,2,13,23
"17940","2300-2359",2020-12-16,11,3,16,27
"17941","2300-2359",2020-12-17,13,4,27,40
"17942","2300-2359",2020-12-18,16,5,30,46
"17943","2300-2359",2020-12-19,16,6,30,46
"17944","2300-2359",2020-12-20,14,7,32,46
"17945","2300-2359",2020-12-21,15,1,31,46
"17946","2300-2359",2020-12-22,14,2,29,43
"17947","2300-2359",2020-12-23,12,3,35,47
"17948","2300-2359",2020-12-24,7,4,9,16
"17949","2300-2359",2020-12-25,11,5,15,26
"17950","2300-2359",2020-12-26,17,6,29,46
"17951","2300-2359",2020-12-27,14,7,34,48
"17952","2300-2359",2020-12-28,14,1,28,42
"17953","2300-2359",2020-12-29,13,2,29,42
"17954","2300-2359",2020-12-30,14,3,28,42
"17955","2300-2359",2020-12-31,6,4,10,16
"17956","0001-0559",2021-01-01,3,5,20,23
"17957","0001-0559",2021-01-02,12,6,33,45
"17958","0001-0559",2021-01-03,12,7,31,43
"17959","0001-0559",2021-01-04,12,1,26,38
"17960","0001-0559",2021-01-05,9,2,14,23
"17961","0001-0559",2021-01-06,6,3,7,13
"17962","0001-0559",2021-01-07,6,4,13,19
"17963","0001-0559",2021-01-08,9,5,13,22
"17964","0001-0559",2021-01-09,8,6,9,17
"17965","0001-0559",2021-01-10,5,7,12,17
"17966","0001-0559",2021-01-11,9,1,13,22
"17967","0001-0559",2021-01-12,9,2,11,20
"17968","0001-0559",2021-01-13,6,3,8,14
"17969","0001-0559",2021-01-14,6,4,13,19
"17970","0001-0559",2021-01-15,9,5,13,22
"17971","0001-0559",2021-01-16,8,6,9,17
"17972","0001-0559",2021-01-17,5,7,11,16
"17973","0001-0559",2021-01-18,6,1,11,17
"17974","0001-0559",2021-01-19,8,2,10,18
"17975","0001-0559",2021-01-20,6,3,8,14
"17976","0001-0559",2021-01-21,6,4,13,19
"17977","0001-0559",2021-01-22,9,5,13,22
"17978","0001-0559",2021-01-23,9,6,10,19
"17979","0001-0559",2021-01-24,5,7,12,17
"17980","0001-0559",2021-01-25,9,1,13,22
"17981","0001-0559",2021-01-26,8,2,10,18
"17982","0001-0559",2021-01-27,6,3,8,14
"17983","0001-0559",2021-01-28,6,4,13,19
"17984","0001-0559",2021-01-29,9,5,13,22
"17985","0001-0559",2021-01-30,9,6,10,19
"17986","0001-0559",2021-01-31,5,7,12,17
"17987","0600-0659",2021-01-01,32,5,20,52
"17988","0600-0659",2021-01-02,46,6,23,69
"17989","0600-0659",2021-01-03,62,7,23,85
"17990","0600-0659",2021-01-04,52,1,21,73
"17991","0600-0659",2021-01-05,34,2,13,47
"17992","0600-0659",2021-01-06,34,3,15,49
"17993","0600-0659",2021-01-07,35,4,13,48
"17994","0600-0659",2021-01-08,35,5,17,52
"17995","0600-0659",2021-01-09,32,6,16,48
"17996","0600-0659",2021-01-10,33,7,14,47
"17997","0600-0659",2021-01-11,35,1,14,49
"17998","0600-0659",2021-01-12,31,2,10,41
"17999","0600-0659",2021-01-13,31,3,12,43
"18000","0600-0659",2021-01-14,34,4,11,45
"18001","0600-0659",2021-01-15,34,5,16,50
"18002","0600-0659",2021-01-16,32,6,15,47
"18003","0600-0659",2021-01-17,31,7,14,45
"18004","0600-0659",2021-01-18,34,1,14,48
"18005","0600-0659",2021-01-19,32,2,10,42
"18006","0600-0659",2021-01-20,31,3,13,44
"18007","0600-0659",2021-01-21,34,4,11,45
"18008","0600-0659",2021-01-22,35,5,16,51
"18009","0600-0659",2021-01-23,32,6,15,47
"18010","0600-0659",2021-01-24,33,7,14,47
"18011","0600-0659",2021-01-25,34,1,14,48
"18012","0600-0659",2021-01-26,30,2,10,40
"18013","0600-0659",2021-01-27,30,3,13,43
"18014","0600-0659",2021-01-28,33,4,11,44
"18015","0600-0659",2021-01-29,33,5,16,49
"18016","0600-0659",2021-01-30,31,6,15,46
"18017","0600-0659",2021-01-31,32,7,14,46
"18018","0700-0759",2021-01-01,39,5,19,58
"18019","0700-0759",2021-01-02,56,6,29,85
"18020","0700-0759",2021-01-03,62,7,35,97
"18021","0700-0759",2021-01-04,61,1,28,89
"18022","0700-0759",2021-01-05,63,2,21,84
"18023","0700-0759",2021-01-06,55,3,22,77
"18024","0700-0759",2021-01-07,54,4,24,78
"18025","0700-0759",2021-01-08,54,5,24,78
"18026","0700-0759",2021-01-09,54,6,21,75
"18027","0700-0759",2021-01-10,56,7,22,78
"18028","0700-0759",2021-01-11,53,1,23,76
"18029","0700-0759",2021-01-12,48,2,20,68
"18030","0700-0759",2021-01-13,45,3,20,65
"18031","0700-0759",2021-01-14,52,4,23,75
"18032","0700-0759",2021-01-15,54,5,22,76
"18033","0700-0759",2021-01-16,53,6,20,73
"18034","0700-0759",2021-01-17,54,7,21,75
"18035","0700-0759",2021-01-18,55,1,20,75
"18036","0700-0759",2021-01-19,48,2,21,69
"18037","0700-0759",2021-01-20,45,3,20,65
"18038","0700-0759",2021-01-21,53,4,23,76
"18039","0700-0759",2021-01-22,54,5,24,78
"18040","0700-0759",2021-01-23,52,6,20,72
"18041","0700-0759",2021-01-24,54,7,21,75
"18042","0700-0759",2021-01-25,54,1,21,75
"18043","0700-0759",2021-01-26,48,2,19,67
"18044","0700-0759",2021-01-27,45,3,19,64
"18045","0700-0759",2021-01-28,52,4,22,74
"18046","0700-0759",2021-01-29,53,5,21,74
"18047","0700-0759",2021-01-30,52,6,20,72
"18048","0700-0759",2021-01-31,55,7,20,75
"18049","0800-0859",2021-01-01,58,5,15,73
"18050","0800-0859",2021-01-02,65,6,29,94
"18051","0800-0859",2021-01-03,73,7,37,110
"18052","0800-0859",2021-01-04,70,1,30,100
"18053","0800-0859",2021-01-05,55,2,30,85
"18054","0800-0859",2021-01-06,54,3,31,85
"18055","0800-0859",2021-01-07,61,4,32,93
"18056","0800-0859",2021-01-08,63,5,31,94
"18057","0800-0859",2021-01-09,59,6,30,89
"18058","0800-0859",2021-01-10,63,7,31,94
"18059","0800-0859",2021-01-11,62,1,30,92
"18060","0800-0859",2021-01-12,55,2,27,82
"18061","0800-0859",2021-01-13,56,3,27,83
"18062","0800-0859",2021-01-14,61,4,32,93
"18063","0800-0859",2021-01-15,62,5,31,93
"18064","0800-0859",2021-01-16,59,6,29,88
"18065","0800-0859",2021-01-17,64,7,28,92
"18066","0800-0859",2021-01-18,61,1,31,92
"18067","0800-0859",2021-01-19,54,2,27,81
"18068","0800-0859",2021-01-20,56,3,27,83
"18069","0800-0859",2021-01-21,61,4,33,94
"18070","0800-0859",2021-01-22,63,5,30,93
"18071","0800-0859",2021-01-23,59,6,29,88
"18072","0800-0859",2021-01-24,63,7,30,93
"18073","0800-0859",2021-01-25,60,1,31,91
"18074","0800-0859",2021-01-26,54,2,27,81
"18075","0800-0859",2021-01-27,56,3,27,83
"18076","0800-0859",2021-01-28,62,4,32,94
"18077","0800-0859",2021-01-29,63,5,30,93
"18078","0800-0859",2021-01-30,59,6,29,88
"18079","0800-0859",2021-01-31,64,7,31,95
"18080","0900-0959",2021-01-01,33,5,32,65
"18081","0900-0959",2021-01-02,45,6,35,80
"18082","0900-0959",2021-01-03,48,7,37,85
"18083","0900-0959",2021-01-04,46,1,39,85
"18084","0900-0959",2021-01-05,46,2,32,78
"18085","0900-0959",2021-01-06,44,3,29,73
"18086","0900-0959",2021-01-07,44,4,32,76
"18087","0900-0959",2021-01-08,43,5,33,76
"18088","0900-0959",2021-01-09,46,6,33,79
"18089","0900-0959",2021-01-10,45,7,33,78
"18090","0900-0959",2021-01-11,42,1,35,77
"18091","0900-0959",2021-01-12,39,2,31,70
"18092","0900-0959",2021-01-13,39,3,29,68
"18093","0900-0959",2021-01-14,48,4,31,79
"18094","0900-0959",2021-01-15,44,5,33,77
"18095","0900-0959",2021-01-16,45,6,34,79
"18096","0900-0959",2021-01-17,44,7,33,77
"18097","0900-0959",2021-01-18,44,1,35,79
"18098","0900-0959",2021-01-19,39,2,30,69
"18099","0900-0959",2021-01-20,39,3,29,68
"18100","0900-0959",2021-01-21,48,4,31,79
"18101","0900-0959",2021-01-22,45,5,34,79
"18102","0900-0959",2021-01-23,45,6,33,78
"18103","0900-0959",2021-01-24,46,7,33,79
"18104","0900-0959",2021-01-25,44,1,34,78
"18105","0900-0959",2021-01-26,39,2,30,69
"18106","0900-0959",2021-01-27,39,3,29,68
"18107","0900-0959",2021-01-28,48,4,31,79
"18108","0900-0959",2021-01-29,44,5,33,77
"18109","0900-0959",2021-01-30,45,6,33,78
"18110","0900-0959",2021-01-31,49,7,34,83
"18111","1000-1059",2021-01-01,48,5,24,72
"18112","1000-1059",2021-01-02,52,6,38,90
"18113","1000-1059",2021-01-03,56,7,42,98
"18114","1000-1059",2021-01-04,54,1,40,94
"18115","1000-1059",2021-01-05,42,2,32,74
"18116","1000-1059",2021-01-06,37,3,27,64
"18117","1000-1059",2021-01-07,46,4,26,72
"18118","1000-1059",2021-01-08,46,5,26,72
"18119","1000-1059",2021-01-09,38,6,27,65
"18120","1000-1059",2021-01-10,45,7,26,71
"18121","1000-1059",2021-01-11,48,1,23,71
"18122","1000-1059",2021-01-12,39,2,22,61
"18123","1000-1059",2021-01-13,39,3,21,60
"18124","1000-1059",2021-01-14,46,4,25,71
"18125","1000-1059",2021-01-15,46,5,25,71
"18126","1000-1059",2021-01-16,39,6,25,64
"18127","1000-1059",2021-01-17,44,7,25,69
"18128","1000-1059",2021-01-18,48,1,24,72
"18129","1000-1059",2021-01-19,38,2,22,60
"18130","1000-1059",2021-01-20,39,3,21,60
"18131","1000-1059",2021-01-21,46,4,25,71
"18132","1000-1059",2021-01-22,46,5,25,71
"18133","1000-1059",2021-01-23,37,6,24,61
"18134","1000-1059",2021-01-24,45,7,26,71
"18135","1000-1059",2021-01-25,48,1,24,72
"18136","1000-1059",2021-01-26,38,2,22,60
"18137","1000-1059",2021-01-27,39,3,21,60
"18138","1000-1059",2021-01-28,46,4,25,71
"18139","1000-1059",2021-01-29,46,5,25,71
"18140","1000-1059",2021-01-30,38,6,24,62
"18141","1000-1059",2021-01-31,45,7,26,71
"18142","1100-1159",2021-01-01,29,5,32,61
"18143","1100-1159",2021-01-02,44,6,37,81
"18144","1100-1159",2021-01-03,49,7,41,90
"18145","1100-1159",2021-01-04,46,1,41,87
"18146","1100-1159",2021-01-05,34,2,38,72
"18147","1100-1159",2021-01-06,32,3,35,67
"18148","1100-1159",2021-01-07,32,4,34,66
"18149","1100-1159",2021-01-08,33,5,35,68
"18150","1100-1159",2021-01-09,38,6,37,75
"18151","1100-1159",2021-01-10,33,7,34,67
"18152","1100-1159",2021-01-11,30,1,35,65
"18153","1100-1159",2021-01-12,26,2,33,59
"18154","1100-1159",2021-01-13,26,3,33,59
"18155","1100-1159",2021-01-14,34,4,36,70
"18156","1100-1159",2021-01-15,34,5,35,69
"18157","1100-1159",2021-01-16,38,6,37,75
"18158","1100-1159",2021-01-17,35,7,35,70
"18159","1100-1159",2021-01-18,32,1,36,68
"18160","1100-1159",2021-01-19,26,2,33,59
"18161","1100-1159",2021-01-20,26,3,33,59
"18162","1100-1159",2021-01-21,32,4,36,68
"18163","1100-1159",2021-01-22,33,5,36,69
"18164","1100-1159",2021-01-23,36,6,38,74
"18165","1100-1159",2021-01-24,34,7,35,69
"18166","1100-1159",2021-01-25,31,1,36,67
"18167","1100-1159",2021-01-26,26,2,33,59
"18168","1100-1159",2021-01-27,26,3,33,59
"18169","1100-1159",2021-01-28,33,4,36,69
"18170","1100-1159",2021-01-29,33,5,36,69
"18171","1100-1159",2021-01-30,36,6,38,74
"18172","1100-1159",2021-01-31,34,7,34,68
"18173","1200-1259",2021-01-01,40,5,43,83
"18174","1200-1259",2021-01-02,37,6,53,90
"18175","1200-1259",2021-01-03,42,7,56,98
"18176","1200-1259",2021-01-04,41,1,53,94
"18177","1200-1259",2021-01-05,33,2,47,80
"18178","1200-1259",2021-01-06,34,3,47,81
"18179","1200-1259",2021-01-07,41,4,53,94
"18180","1200-1259",2021-01-08,42,5,54,96
"18181","1200-1259",2021-01-09,32,6,45,77
"18182","1200-1259",2021-01-10,43,7,54,97
"18183","1200-1259",2021-01-11,41,1,56,97
"18184","1200-1259",2021-01-12,37,2,48,85
"18185","1200-1259",2021-01-13,37,3,47,84
"18186","1200-1259",2021-01-14,42,4,55,97
"18187","1200-1259",2021-01-15,42,5,54,96
"18188","1200-1259",2021-01-16,31,6,46,77
"18189","1200-1259",2021-01-17,42,7,54,96
"18190","1200-1259",2021-01-18,42,1,55,97
"18191","1200-1259",2021-01-19,37,2,47,84
"18192","1200-1259",2021-01-20,37,3,47,84
"18193","1200-1259",2021-01-21,42,4,55,97
"18194","1200-1259",2021-01-22,43,5,55,98
"18195","1200-1259",2021-01-23,32,6,45,77
"18196","1200-1259",2021-01-24,44,7,54,98
"18197","1200-1259",2021-01-25,42,1,55,97
"18198","1200-1259",2021-01-26,37,2,47,84
"18199","1200-1259",2021-01-27,37,3,47,84
"18200","1200-1259",2021-01-28,42,4,55,97
"18201","1200-1259",2021-01-29,43,5,55,98
"18202","1200-1259",2021-01-30,32,6,45,77
"18203","1200-1259",2021-01-31,43,7,54,97
"18204","1300-1359",2021-01-01,35,5,38,73
"18205","1300-1359",2021-01-02,43,6,42,85
"18206","1300-1359",2021-01-03,41,7,43,84
"18207","1300-1359",2021-01-04,40,1,42,82
"18208","1300-1359",2021-01-05,34,2,35,69
"18209","1300-1359",2021-01-06,34,3,31,65
"18210","1300-1359",2021-01-07,43,4,35,78
"18211","1300-1359",2021-01-08,42,5,37,79
"18212","1300-1359",2021-01-09,36,6,33,69
"18213","1300-1359",2021-01-10,39,7,37,76
"18214","1300-1359",2021-01-11,43,1,35,78
"18215","1300-1359",2021-01-12,31,2,31,62
"18216","1300-1359",2021-01-13,32,3,30,62
"18217","1300-1359",2021-01-14,42,4,36,78
"18218","1300-1359",2021-01-15,43,5,39,82
"18219","1300-1359",2021-01-16,35,6,33,68
"18220","1300-1359",2021-01-17,39,7,37,76
"18221","1300-1359",2021-01-18,43,1,35,78
"18222","1300-1359",2021-01-19,31,2,31,62
"18223","1300-1359",2021-01-20,32,3,30,62
"18224","1300-1359",2021-01-21,42,4,35,77
"18225","1300-1359",2021-01-22,42,5,37,79
"18226","1300-1359",2021-01-23,35,6,33,68
"18227","1300-1359",2021-01-24,40,7,37,77
"18228","1300-1359",2021-01-25,42,1,34,76
"18229","1300-1359",2021-01-26,31,2,31,62
"18230","1300-1359",2021-01-27,32,3,30,62
"18231","1300-1359",2021-01-28,41,4,35,76
"18232","1300-1359",2021-01-29,42,5,37,79
"18233","1300-1359",2021-01-30,34,6,33,67
"18234","1300-1359",2021-01-31,40,7,37,77
"18235","1400-1459",2021-01-01,43,5,33,76
"18236","1400-1459",2021-01-02,46,6,43,89
"18237","1400-1459",2021-01-03,49,7,49,98
"18238","1400-1459",2021-01-04,41,1,44,85
"18239","1400-1459",2021-01-05,33,2,37,70
"18240","1400-1459",2021-01-06,32,3,36,68
"18241","1400-1459",2021-01-07,44,4,43,87
"18242","1400-1459",2021-01-08,43,5,42,85
"18243","1400-1459",2021-01-09,38,6,37,75
"18244","1400-1459",2021-01-10,46,7,40,86
"18245","1400-1459",2021-01-11,43,1,43,86
"18246","1400-1459",2021-01-12,35,2,34,69
"18247","1400-1459",2021-01-13,36,3,32,68
"18248","1400-1459",2021-01-14,45,4,43,88
"18249","1400-1459",2021-01-15,45,5,42,87
"18250","1400-1459",2021-01-16,39,6,36,75
"18251","1400-1459",2021-01-17,47,7,41,88
"18252","1400-1459",2021-01-18,42,1,45,87
"18253","1400-1459",2021-01-19,35,2,34,69
"18254","1400-1459",2021-01-20,36,3,32,68
"18255","1400-1459",2021-01-21,45,4,43,88
"18256","1400-1459",2021-01-22,43,5,42,85
"18257","1400-1459",2021-01-23,38,6,35,73
"18258","1400-1459",2021-01-24,47,7,41,88
"18259","1400-1459",2021-01-25,41,1,43,84
"18260","1400-1459",2021-01-26,35,2,34,69
"18261","1400-1459",2021-01-27,37,3,32,69
"18262","1400-1459",2021-01-28,46,4,42,88
"18263","1400-1459",2021-01-29,44,5,40,84
"18264","1400-1459",2021-01-30,38,6,36,74
"18265","1400-1459",2021-01-31,47,7,41,88
"18266","1500-1559",2021-01-01,36,5,45,81
"18267","1500-1559",2021-01-02,44,6,48,92
"18268","1500-1559",2021-01-03,41,7,52,93
"18269","1500-1559",2021-01-04,45,1,47,92
"18270","1500-1559",2021-01-05,32,2,32,64
"18271","1500-1559",2021-01-06,37,3,29,66
"18272","1500-1559",2021-01-07,37,4,37,74
"18273","1500-1559",2021-01-08,36,5,38,74
"18274","1500-1559",2021-01-09,29,6,37,66
"18275","1500-1559",2021-01-10,38,7,41,79
"18276","1500-1559",2021-01-11,37,1,34,71
"18277","1500-1559",2021-01-12,28,2,26,54
"18278","1500-1559",2021-01-13,33,3,30,63
"18279","1500-1559",2021-01-14,39,4,36,75
"18280","1500-1559",2021-01-15,39,5,39,78
"18281","1500-1559",2021-01-16,29,6,37,66
"18282","1500-1559",2021-01-17,32,7,41,73
"18283","1500-1559",2021-01-18,40,1,36,76
"18284","1500-1559",2021-01-19,28,2,26,54
"18285","1500-1559",2021-01-20,32,3,30,62
"18286","1500-1559",2021-01-21,38,4,35,73
"18287","1500-1559",2021-01-22,37,5,37,74
"18288","1500-1559",2021-01-23,29,6,35,64
"18289","1500-1559",2021-01-24,37,7,42,79
"18290","1500-1559",2021-01-25,38,1,36,74
"18291","1500-1559",2021-01-26,28,2,26,54
"18292","1500-1559",2021-01-27,33,3,30,63
"18293","1500-1559",2021-01-28,38,4,36,74
"18294","1500-1559",2021-01-29,38,5,39,77
"18295","1500-1559",2021-01-30,29,6,35,64
"18296","1500-1559",2021-01-31,39,7,41,80
"18297","1600-1659",2021-01-01,41,5,34,75
"18298","1600-1659",2021-01-02,46,6,39,85
"18299","1600-1659",2021-01-03,50,7,46,96
"18300","1600-1659",2021-01-04,43,1,43,86
"18301","1600-1659",2021-01-05,28,2,41,69
"18302","1600-1659",2021-01-06,29,3,42,71
"18303","1600-1659",2021-01-07,40,4,48,88
"18304","1600-1659",2021-01-08,39,5,42,81
"18305","1600-1659",2021-01-09,33,6,39,72
"18306","1600-1659",2021-01-10,40,7,45,85
"18307","1600-1659",2021-01-11,36,1,44,80
"18308","1600-1659",2021-01-12,31,2,38,69
"18309","1600-1659",2021-01-13,31,3,39,70
"18310","1600-1659",2021-01-14,39,4,50,89
"18311","1600-1659",2021-01-15,39,5,44,83
"18312","1600-1659",2021-01-16,33,6,40,73
"18313","1600-1659",2021-01-17,40,7,43,83
"18314","1600-1659",2021-01-18,36,1,45,81
"18315","1600-1659",2021-01-19,31,2,38,69
"18316","1600-1659",2021-01-20,31,3,39,70
"18317","1600-1659",2021-01-21,39,4,49,88
"18318","1600-1659",2021-01-22,38,5,43,81
"18319","1600-1659",2021-01-23,33,6,39,72
"18320","1600-1659",2021-01-24,40,7,45,85
"18321","1600-1659",2021-01-25,35,1,43,78
"18322","1600-1659",2021-01-26,31,2,38,69
"18323","1600-1659",2021-01-27,31,3,40,71
"18324","1600-1659",2021-01-28,39,4,50,89
"18325","1600-1659",2021-01-29,38,5,43,81
"18326","1600-1659",2021-01-30,34,6,39,73
"18327","1600-1659",2021-01-31,40,7,47,87
"18328","1700-1759",2021-01-01,30,5,47,77
"18329","1700-1759",2021-01-02,47,6,47,94
"18330","1700-1759",2021-01-03,46,7,56,102
"18331","1700-1759",2021-01-04,45,1,51,96
"18332","1700-1759",2021-01-05,33,2,42,75
"18333","1700-1759",2021-01-06,34,3,42,76
"18334","1700-1759",2021-01-07,42,4,48,90
"18335","1700-1759",2021-01-08,42,5,50,92
"18336","1700-1759",2021-01-09,37,6,43,80
"18337","1700-1759",2021-01-10,44,7,52,96
"18338","1700-1759",2021-01-11,37,1,48,85
"18339","1700-1759",2021-01-12,30,2,43,73
"18340","1700-1759",2021-01-13,32,3,44,76
"18341","1700-1759",2021-01-14,42,4,48,90
"18342","1700-1759",2021-01-15,44,5,51,95
"18343","1700-1759",2021-01-16,37,6,43,80
"18344","1700-1759",2021-01-17,41,7,50,91
"18345","1700-1759",2021-01-18,37,1,49,86
"18346","1700-1759",2021-01-19,30,2,43,73
"18347","1700-1759",2021-01-20,32,3,44,76
"18348","1700-1759",2021-01-21,42,4,48,90
"18349","1700-1759",2021-01-22,44,5,50,94
"18350","1700-1759",2021-01-23,37,6,43,80
"18351","1700-1759",2021-01-24,45,7,52,97
"18352","1700-1759",2021-01-25,37,1,49,86
"18353","1700-1759",2021-01-26,30,2,43,73
"18354","1700-1759",2021-01-27,32,3,44,76
"18355","1700-1759",2021-01-28,42,4,49,91
"18356","1700-1759",2021-01-29,44,5,52,96
"18357","1700-1759",2021-01-30,37,6,43,80
"18358","1700-1759",2021-01-31,47,7,54,101
"18359","1800-1859",2021-01-01,26,5,34,60
"18360","1800-1859",2021-01-02,52,6,41,93
"18361","1800-1859",2021-01-03,47,7,37,84
"18362","1800-1859",2021-01-04,46,1,43,89
"18363","1800-1859",2021-01-05,36,2,34,70
"18364","1800-1859",2021-01-06,34,3,35,69
"18365","1800-1859",2021-01-07,40,4,41,81
"18366","1800-1859",2021-01-08,36,5,42,78
"18367","1800-1859",2021-01-09,27,6,34,61
"18368","1800-1859",2021-01-10,38,7,41,79
"18369","1800-1859",2021-01-11,39,1,40,79
"18370","1800-1859",2021-01-12,35,2,30,65
"18371","1800-1859",2021-01-13,35,3,33,68
"18372","1800-1859",2021-01-14,42,4,41,83
"18373","1800-1859",2021-01-15,36,5,42,78
"18374","1800-1859",2021-01-16,27,6,33,60
"18375","1800-1859",2021-01-17,31,7,38,69
"18376","1800-1859",2021-01-18,39,1,40,79
"18377","1800-1859",2021-01-19,35,2,30,65
"18378","1800-1859",2021-01-20,35,3,32,67
"18379","1800-1859",2021-01-21,42,4,41,83
"18380","1800-1859",2021-01-22,36,5,42,78
"18381","1800-1859",2021-01-23,27,6,33,60
"18382","1800-1859",2021-01-24,38,7,40,78
"18383","1800-1859",2021-01-25,39,1,38,77
"18384","1800-1859",2021-01-26,35,2,30,65
"18385","1800-1859",2021-01-27,35,3,33,68
"18386","1800-1859",2021-01-28,43,4,41,84
"18387","1800-1859",2021-01-29,37,5,41,78
"18388","1800-1859",2021-01-30,27,6,34,61
"18389","1800-1859",2021-01-31,41,7,42,83
"18390","1900-1959",2021-01-01,41,5,34,75
"18391","1900-1959",2021-01-02,51,6,45,96
"18392","1900-1959",2021-01-03,53,7,43,96
"18393","1900-1959",2021-01-04,50,1,43,93
"18394","1900-1959",2021-01-05,37,2,31,68
"18395","1900-1959",2021-01-06,35,3,31,66
"18396","1900-1959",2021-01-07,34,4,35,69
"18397","1900-1959",2021-01-08,38,5,34,72
"18398","1900-1959",2021-01-09,29,6,33,62
"18399","1900-1959",2021-01-10,39,7,34,73
"18400","1900-1959",2021-01-11,36,1,34,70
"18401","1900-1959",2021-01-12,30,2,33,63
"18402","1900-1959",2021-01-13,30,3,33,63
"18403","1900-1959",2021-01-14,34,4,37,71
"18404","1900-1959",2021-01-15,38,5,36,74
"18405","1900-1959",2021-01-16,29,6,33,62
"18406","1900-1959",2021-01-17,31,7,32,63
"18407","1900-1959",2021-01-18,36,1,34,70
"18408","1900-1959",2021-01-19,30,2,33,63
"18409","1900-1959",2021-01-20,30,3,33,63
"18410","1900-1959",2021-01-21,35,4,37,72
"18411","1900-1959",2021-01-22,39,5,35,74
"18412","1900-1959",2021-01-23,30,6,34,64
"18413","1900-1959",2021-01-24,39,7,35,74
"18414","1900-1959",2021-01-25,35,1,34,69
"18415","1900-1959",2021-01-26,30,2,33,63
"18416","1900-1959",2021-01-27,30,3,33,63
"18417","1900-1959",2021-01-28,34,4,37,71
"18418","1900-1959",2021-01-29,38,5,35,73
"18419","1900-1959",2021-01-30,29,6,33,62
"18420","1900-1959",2021-01-31,40,7,37,77
"18421","2000-2059",2021-01-01,12,5,29,41
"18422","2000-2059",2021-01-02,28,6,43,71
"18423","2000-2059",2021-01-03,36,7,42,78
"18424","2000-2059",2021-01-04,26,1,41,67
"18425","2000-2059",2021-01-05,19,2,36,55
"18426","2000-2059",2021-01-06,20,3,38,58
"18427","2000-2059",2021-01-07,25,4,43,68
"18428","2000-2059",2021-01-08,25,5,41,66
"18429","2000-2059",2021-01-09,21,6,30,51
"18430","2000-2059",2021-01-10,26,7,45,71
"18431","2000-2059",2021-01-11,25,1,40,65
"18432","2000-2059",2021-01-12,17,2,34,51
"18433","2000-2059",2021-01-13,17,3,38,55
"18434","2000-2059",2021-01-14,24,4,44,68
"18435","2000-2059",2021-01-15,25,5,41,66
"18436","2000-2059",2021-01-16,20,6,31,51
"18437","2000-2059",2021-01-17,21,7,44,65
"18438","2000-2059",2021-01-18,24,1,41,65
"18439","2000-2059",2021-01-19,17,2,34,51
"18440","2000-2059",2021-01-20,16,3,38,54
"18441","2000-2059",2021-01-21,23,4,44,67
"18442","2000-2059",2021-01-22,24,5,42,66
"18443","2000-2059",2021-01-23,19,6,31,50
"18444","2000-2059",2021-01-24,24,7,46,70
"18445","2000-2059",2021-01-25,23,1,40,63
"18446","2000-2059",2021-01-26,16,2,33,49
"18447","2000-2059",2021-01-27,16,3,37,53
"18448","2000-2059",2021-01-28,23,4,43,66
"18449","2000-2059",2021-01-29,24,5,41,65
"18450","2000-2059",2021-01-30,19,6,30,49
"18451","2000-2059",2021-01-31,24,7,48,72
"18452","2100-2159",2021-01-01,12,5,54,66
"18453","2100-2159",2021-01-02,20,6,74,94
"18454","2100-2159",2021-01-03,24,7,73,97
"18455","2100-2159",2021-01-04,16,1,72,88
"18456","2100-2159",2021-01-05,12,2,46,58
"18457","2100-2159",2021-01-06,10,3,47,57
"18458","2100-2159",2021-01-07,14,4,53,67
"18459","2100-2159",2021-01-08,12,5,55,67
"18460","2100-2159",2021-01-09,9,6,49,58
"18461","2100-2159",2021-01-10,14,7,54,68
"18462","2100-2159",2021-01-11,12,1,54,66
"18463","2100-2159",2021-01-12,10,2,42,52
"18464","2100-2159",2021-01-13,10,3,42,52
"18465","2100-2159",2021-01-14,14,4,54,68
"18466","2100-2159",2021-01-15,12,5,56,68
"18467","2100-2159",2021-01-16,9,6,48,57
"18468","2100-2159",2021-01-17,12,7,43,55
"18469","2100-2159",2021-01-18,12,1,52,64
"18470","2100-2159",2021-01-19,10,2,42,52
"18471","2100-2159",2021-01-20,10,3,42,52
"18472","2100-2159",2021-01-21,14,4,54,68
"18473","2100-2159",2021-01-22,12,5,55,67
"18474","2100-2159",2021-01-23,9,6,48,57
"18475","2100-2159",2021-01-24,14,7,54,68
"18476","2100-2159",2021-01-25,12,1,52,64
"18477","2100-2159",2021-01-26,10,2,42,52
"18478","2100-2159",2021-01-27,10,3,42,52
"18479","2100-2159",2021-01-28,14,4,55,69
"18480","2100-2159",2021-01-29,12,5,57,69
"18481","2100-2159",2021-01-30,9,6,48,57
"18482","2100-2159",2021-01-31,14,7,54,68
"18483","2200-2259",2021-01-01,21,5,25,46
"18484","2200-2259",2021-01-02,27,6,44,71
"18485","2200-2259",2021-01-03,28,7,52,80
"18486","2200-2259",2021-01-04,25,1,35,60
"18487","2200-2259",2021-01-05,15,2,30,45
"18488","2200-2259",2021-01-06,13,3,30,43
"18489","2200-2259",2021-01-07,16,4,34,50
"18490","2200-2259",2021-01-08,16,5,33,49
"18491","2200-2259",2021-01-09,14,6,23,37
"18492","2200-2259",2021-01-10,16,7,36,52
"18493","2200-2259",2021-01-11,16,1,31,47
"18494","2200-2259",2021-01-12,11,2,26,37
"18495","2200-2259",2021-01-13,12,3,27,39
"18496","2200-2259",2021-01-14,15,4,32,47
"18497","2200-2259",2021-01-15,15,5,34,49
"18498","2200-2259",2021-01-16,13,6,22,35
"18499","2200-2259",2021-01-17,13,7,31,44
"18500","2200-2259",2021-01-18,16,1,31,47
"18501","2200-2259",2021-01-19,11,2,26,37
"18502","2200-2259",2021-01-20,12,3,26,38
"18503","2200-2259",2021-01-21,15,4,32,47
"18504","2200-2259",2021-01-22,16,5,34,50
"18505","2200-2259",2021-01-23,13,6,22,35
"18506","2200-2259",2021-01-24,16,7,34,50
"18507","2200-2259",2021-01-25,15,1,30,45
"18508","2200-2259",2021-01-26,11,2,26,37
"18509","2200-2259",2021-01-27,12,3,27,39
"18510","2200-2259",2021-01-28,15,4,32,47
"18511","2200-2259",2021-01-29,16,5,34,50
"18512","2200-2259",2021-01-30,13,6,22,35
"18513","2200-2259",2021-01-31,16,7,36,52
"18514","2300-2359",2021-01-01,15,5,16,31
"18515","2300-2359",2021-01-02,17,6,35,52
"18516","2300-2359",2021-01-03,15,7,39,54
"18517","2300-2359",2021-01-04,13,1,33,46
"18518","2300-2359",2021-01-05,13,2,17,30
"18519","2300-2359",2021-01-06,16,3,16,32
"18520","2300-2359",2021-01-07,16,4,26,42
"18521","2300-2359",2021-01-08,17,5,24,41
"18522","2300-2359",2021-01-09,16,6,20,36
"18523","2300-2359",2021-01-10,15,7,27,42
"18524","2300-2359",2021-01-11,14,1,26,40
"18525","2300-2359",2021-01-12,11,2,14,25
"18526","2300-2359",2021-01-13,12,3,14,26
"18527","2300-2359",2021-01-14,14,4,26,40
"18528","2300-2359",2021-01-15,16,5,24,40
"18529","2300-2359",2021-01-16,15,6,20,35
"18530","2300-2359",2021-01-17,14,7,19,33
"18531","2300-2359",2021-01-18,13,1,26,39
"18532","2300-2359",2021-01-19,11,2,14,25
"18533","2300-2359",2021-01-20,13,3,14,27
"18534","2300-2359",2021-01-21,14,4,26,40
"18535","2300-2359",2021-01-22,16,5,25,41
"18536","2300-2359",2021-01-23,15,6,20,35
"18537","2300-2359",2021-01-24,14,7,27,41
"18538","2300-2359",2021-01-25,13,1,25,38
"18539","2300-2359",2021-01-26,11,2,14,25
"18540","2300-2359",2021-01-27,13,3,14,27
"18541","2300-2359",2021-01-28,14,4,26,40
"18542","2300-2359",2021-01-29,16,5,25,41
"18543","2300-2359",2021-01-30,16,6,20,36
"18544","2300-2359",2021-01-31,14,7,27,41
"18545","0001-0559",2021-02-01,9,1,12,21
"18546","0001-0559",2021-02-02,9,2,10,19
"18547","0001-0559",2021-02-03,6,3,8,14
"18548","0001-0559",2021-02-04,6,4,13,19
"18549","0001-0559",2021-02-05,9,5,12,21
"18550","0001-0559",2021-02-06,9,6,9,18
"18551","0001-0559",2021-02-07,5,7,10,15
"18552","0001-0559",2021-02-08,7,1,12,19
"18553","0001-0559",2021-02-09,9,2,10,19
"18554","0001-0559",2021-02-10,6,3,9,15
"18555","0001-0559",2021-02-11,5,4,14,19
"18556","0001-0559",2021-02-12,8,5,15,23
"18557","0001-0559",2021-02-13,8,6,12,20
"18558","0001-0559",2021-02-14,3,7,11,14
"18559","0001-0559",2021-02-15,6,1,14,20
"18560","0001-0559",2021-02-16,9,2,12,21
"18561","0001-0559",2021-02-17,6,3,10,16
"18562","0001-0559",2021-02-18,5,4,13,18
"18563","0001-0559",2021-02-19,8,5,14,22
"18564","0001-0559",2021-02-20,8,6,12,20
"18565","0001-0559",2021-02-21,4,7,13,17
"18566","0001-0559",2021-02-22,8,1,14,22
"18567","0001-0559",2021-02-23,9,2,12,21
"18568","0001-0559",2021-02-24,6,3,10,16
"18569","0001-0559",2021-02-25,5,4,13,18
"18570","0001-0559",2021-02-26,8,5,14,22
"18571","0001-0559",2021-02-27,8,6,12,20
"18572","0001-0559",2021-02-28,4,7,13,17
"18573","0600-0659",2021-02-01,34,1,15,49
"18574","0600-0659",2021-02-02,31,2,11,42
"18575","0600-0659",2021-02-03,31,3,13,44
"18576","0600-0659",2021-02-04,34,4,11,45
"18577","0600-0659",2021-02-05,35,5,17,52
"18578","0600-0659",2021-02-06,32,6,16,48
"18579","0600-0659",2021-02-07,31,7,14,45
"18580","0600-0659",2021-02-08,35,1,14,49
"18581","0600-0659",2021-02-09,31,2,11,42
"18582","0600-0659",2021-02-10,31,3,12,43
"18583","0600-0659",2021-02-11,41,4,13,54
"18584","0600-0659",2021-02-12,44,5,17,61
"18585","0600-0659",2021-02-13,39,6,14,53
"18586","0600-0659",2021-02-14,38,7,14,52
"18587","0600-0659",2021-02-15,43,1,15,58
"18588","0600-0659",2021-02-16,35,2,12,47
"18589","0600-0659",2021-02-17,34,3,13,47
"18590","0600-0659",2021-02-18,44,4,14,58
"18591","0600-0659",2021-02-19,42,5,17,59
"18592","0600-0659",2021-02-20,39,6,15,54
"18593","0600-0659",2021-02-21,42,7,16,58
"18594","0600-0659",2021-02-22,43,1,15,58
"18595","0600-0659",2021-02-23,35,2,11,46
"18596","0600-0659",2021-02-24,34,3,12,46
"18597","0600-0659",2021-02-25,45,4,13,58
"18598","0600-0659",2021-02-26,43,5,16,59
"18599","0600-0659",2021-02-27,39,6,15,54
"18600","0600-0659",2021-02-28,43,7,16,59
"18601","0700-0759",2021-02-01,54,1,21,75
"18602","0700-0759",2021-02-02,48,2,20,68
"18603","0700-0759",2021-02-03,45,3,20,65
"18604","0700-0759",2021-02-04,51,4,22,73
"18605","0700-0759",2021-02-05,53,5,22,75
"18606","0700-0759",2021-02-06,53,6,20,73
"18607","0700-0759",2021-02-07,54,7,20,74
"18608","0700-0759",2021-02-08,53,1,20,73
"18609","0700-0759",2021-02-09,48,2,20,68
"18610","0700-0759",2021-02-10,46,3,19,65
"18611","0700-0759",2021-02-11,45,4,25,70
"18612","0700-0759",2021-02-12,53,5,25,78
"18613","0700-0759",2021-02-13,51,6,24,75
"18614","0700-0759",2021-02-14,53,7,23,76
"18615","0700-0759",2021-02-15,53,1,23,76
"18616","0700-0759",2021-02-16,48,2,23,71
"18617","0700-0759",2021-02-17,49,3,24,73
"18618","0700-0759",2021-02-18,52,4,25,77
"18619","0700-0759",2021-02-19,53,5,24,77
"18620","0700-0759",2021-02-20,51,6,24,75
"18621","0700-0759",2021-02-21,52,7,23,75
"18622","0700-0759",2021-02-22,53,1,24,77
"18623","0700-0759",2021-02-23,47,2,23,70
"18624","0700-0759",2021-02-24,47,3,24,71
"18625","0700-0759",2021-02-25,50,4,25,75
"18626","0700-0759",2021-02-26,52,5,24,76
"18627","0700-0759",2021-02-27,50,6,24,74
"18628","0700-0759",2021-02-28,51,7,23,74
"18629","0800-0859",2021-02-01,62,1,32,94
"18630","0800-0859",2021-02-02,55,2,28,83
"18631","0800-0859",2021-02-03,57,3,28,85
"18632","0800-0859",2021-02-04,62,4,31,93
"18633","0800-0859",2021-02-05,64,5,31,95
"18634","0800-0859",2021-02-06,59,6,30,89
"18635","0800-0859",2021-02-07,63,7,28,91
"18636","0800-0859",2021-02-08,63,1,31,94
"18637","0800-0859",2021-02-09,55,2,28,83
"18638","0800-0859",2021-02-10,57,3,27,84
"18639","0800-0859",2021-02-11,63,4,27,90
"18640","0800-0859",2021-02-12,62,5,33,95
"18641","0800-0859",2021-02-13,55,6,28,83
"18642","0800-0859",2021-02-14,63,7,27,90
"18643","0800-0859",2021-02-15,63,1,32,95
"18644","0800-0859",2021-02-16,58,2,25,83
"18645","0800-0859",2021-02-17,57,3,27,84
"18646","0800-0859",2021-02-18,65,4,32,97
"18647","0800-0859",2021-02-19,62,5,33,95
"18648","0800-0859",2021-02-20,55,6,28,83
"18649","0800-0859",2021-02-21,64,7,31,95
"18650","0800-0859",2021-02-22,63,1,33,96
"18651","0800-0859",2021-02-23,59,2,25,84
"18652","0800-0859",2021-02-24,58,3,26,84
"18653","0800-0859",2021-02-25,66,4,32,98
"18654","0800-0859",2021-02-26,63,5,33,96
"18655","0800-0859",2021-02-27,56,6,28,84
"18656","0800-0859",2021-02-28,64,7,31,95
"18657","0900-0959",2021-02-01,46,1,35,81
"18658","0900-0959",2021-02-02,40,2,31,71
"18659","0900-0959",2021-02-03,40,3,30,70
"18660","0900-0959",2021-02-04,49,4,34,83
"18661","0900-0959",2021-02-05,47,5,35,82
"18662","0900-0959",2021-02-06,46,6,34,80
"18663","0900-0959",2021-02-07,43,7,35,78
"18664","0900-0959",2021-02-08,44,1,36,80
"18665","0900-0959",2021-02-09,39,2,31,70
"18666","0900-0959",2021-02-10,38,3,33,71
"18667","0900-0959",2021-02-11,50,4,32,82
"18668","0900-0959",2021-02-12,52,5,35,87
"18669","0900-0959",2021-02-13,46,6,35,81
"18670","0900-0959",2021-02-14,45,7,37,82
"18671","0900-0959",2021-02-15,51,1,36,87
"18672","0900-0959",2021-02-16,45,2,35,80
"18673","0900-0959",2021-02-17,44,3,34,78
"18674","0900-0959",2021-02-18,53,4,37,90
"18675","0900-0959",2021-02-19,52,5,35,87
"18676","0900-0959",2021-02-20,46,6,35,81
"18677","0900-0959",2021-02-21,51,7,36,87
"18678","0900-0959",2021-02-22,52,1,36,88
"18679","0900-0959",2021-02-23,45,2,35,80
"18680","0900-0959",2021-02-24,44,3,34,78
"18681","0900-0959",2021-02-25,53,4,37,90
"18682","0900-0959",2021-02-26,52,5,35,87
"18683","0900-0959",2021-02-27,46,6,35,81
"18684","0900-0959",2021-02-28,52,7,37,89
"18685","1000-1059",2021-02-01,48,1,24,72
"18686","1000-1059",2021-02-02,38,2,23,61
"18687","1000-1059",2021-02-03,39,3,22,61
"18688","1000-1059",2021-02-04,48,4,26,74
"18689","1000-1059",2021-02-05,46,5,26,72
"18690","1000-1059",2021-02-06,38,6,25,63
"18691","1000-1059",2021-02-07,45,7,26,71
"18692","1000-1059",2021-02-08,48,1,25,73
"18693","1000-1059",2021-02-09,39,2,23,62
"18694","1000-1059",2021-02-10,43,3,22,65
"18695","1000-1059",2021-02-11,45,4,25,70
"18696","1000-1059",2021-02-12,48,5,26,74
"18697","1000-1059",2021-02-13,39,6,22,61
"18698","1000-1059",2021-02-14,45,7,23,68
"18699","1000-1059",2021-02-15,48,1,27,75
"18700","1000-1059",2021-02-16,41,2,24,65
"18701","1000-1059",2021-02-17,42,3,23,65
"18702","1000-1059",2021-02-18,49,4,25,74
"18703","1000-1059",2021-02-19,48,5,26,74
"18704","1000-1059",2021-02-20,39,6,22,61
"18705","1000-1059",2021-02-21,45,7,25,70
"18706","1000-1059",2021-02-22,48,1,26,74
"18707","1000-1059",2021-02-23,41,2,24,65
"18708","1000-1059",2021-02-24,42,3,23,65
"18709","1000-1059",2021-02-25,48,4,25,73
"18710","1000-1059",2021-02-26,48,5,27,75
"18711","1000-1059",2021-02-27,39,6,22,61
"18712","1000-1059",2021-02-28,46,7,25,71
"18713","1100-1159",2021-02-01,30,1,35,65
"18714","1100-1159",2021-02-02,26,2,32,58
"18715","1100-1159",2021-02-03,26,3,32,58
"18716","1100-1159",2021-02-04,32,4,35,67
"18717","1100-1159",2021-02-05,32,5,35,67
"18718","1100-1159",2021-02-06,38,6,37,75
"18719","1100-1159",2021-02-07,35,7,32,67
"18720","1100-1159",2021-02-08,30,1,35,65
"18721","1100-1159",2021-02-09,26,2,32,58
"18722","1100-1159",2021-02-10,26,3,33,59
"18723","1100-1159",2021-02-11,31,4,42,73
"18724","1100-1159",2021-02-12,35,5,42,77
"18725","1100-1159",2021-02-13,33,6,39,72
"18726","1100-1159",2021-02-14,33,7,40,73
"18727","1100-1159",2021-02-15,35,1,43,78
"18728","1100-1159",2021-02-16,26,2,35,61
"18729","1100-1159",2021-02-17,27,3,34,61
"18730","1100-1159",2021-02-18,32,4,43,75
"18731","1100-1159",2021-02-19,32,5,41,73
"18732","1100-1159",2021-02-20,33,6,39,72
"18733","1100-1159",2021-02-21,33,7,42,75
"18734","1100-1159",2021-02-22,34,1,43,77
"18735","1100-1159",2021-02-23,26,2,35,61
"18736","1100-1159",2021-02-24,26,3,34,60
"18737","1100-1159",2021-02-25,32,4,43,75
"18738","1100-1159",2021-02-26,34,5,41,75
"18739","1100-1159",2021-02-27,34,6,39,73
"18740","1100-1159",2021-02-28,33,7,42,75
"18741","1200-1259",2021-02-01,40,1,54,94
"18742","1200-1259",2021-02-02,35,2,46,81
"18743","1200-1259",2021-02-03,36,3,46,82
"18744","1200-1259",2021-02-04,39,4,54,93
"18745","1200-1259",2021-02-05,41,5,54,95
"18746","1200-1259",2021-02-06,30,6,44,74
"18747","1200-1259",2021-02-07,38,7,52,90
"18748","1200-1259",2021-02-08,40,1,53,93
"18749","1200-1259",2021-02-09,35,2,45,80
"18750","1200-1259",2021-02-10,36,3,44,80
"18751","1200-1259",2021-02-11,49,4,50,99
"18752","1200-1259",2021-02-12,48,5,55,103
"18753","1200-1259",2021-02-13,31,6,45,76
"18754","1200-1259",2021-02-14,49,7,51,100
"18755","1200-1259",2021-02-15,49,1,55,104
"18756","1200-1259",2021-02-16,39,2,50,89
"18757","1200-1259",2021-02-17,38,3,48,86
"18758","1200-1259",2021-02-18,49,4,54,103
"18759","1200-1259",2021-02-19,48,5,55,103
"18760","1200-1259",2021-02-20,31,6,45,76
"18761","1200-1259",2021-02-21,52,7,51,103
"18762","1200-1259",2021-02-22,48,1,55,103
"18763","1200-1259",2021-02-23,39,2,50,89
"18764","1200-1259",2021-02-24,38,3,48,86
"18765","1200-1259",2021-02-25,48,4,53,101
"18766","1200-1259",2021-02-26,49,5,55,104
"18767","1200-1259",2021-02-27,31,6,45,76
"18768","1200-1259",2021-02-28,51,7,52,103
"18769","1300-1359",2021-02-01,43,1,35,78
"18770","1300-1359",2021-02-02,31,2,31,62
"18771","1300-1359",2021-02-03,32,3,30,62
"18772","1300-1359",2021-02-04,42,4,36,78
"18773","1300-1359",2021-02-05,42,5,37,79
"18774","1300-1359",2021-02-06,35,6,33,68
"18775","1300-1359",2021-02-07,38,7,37,75
"18776","1300-1359",2021-02-08,43,1,35,78
"18777","1300-1359",2021-02-09,31,2,32,63
"18778","1300-1359",2021-02-10,32,3,30,62
"18779","1300-1359",2021-02-11,48,4,37,85
"18780","1300-1359",2021-02-12,49,5,41,90
"18781","1300-1359",2021-02-13,44,6,36,80
"18782","1300-1359",2021-02-14,43,7,41,84
"18783","1300-1359",2021-02-15,49,1,41,90
"18784","1300-1359",2021-02-16,41,2,31,72
"18785","1300-1359",2021-02-17,41,3,30,71
"18786","1300-1359",2021-02-18,49,4,40,89
"18787","1300-1359",2021-02-19,49,5,40,89
"18788","1300-1359",2021-02-20,46,6,36,82
"18789","1300-1359",2021-02-21,45,7,41,86
"18790","1300-1359",2021-02-22,49,1,39,88
"18791","1300-1359",2021-02-23,40,2,31,71
"18792","1300-1359",2021-02-24,40,3,30,70
"18793","1300-1359",2021-02-25,46,4,39,85
"18794","1300-1359",2021-02-26,47,5,41,88
"18795","1300-1359",2021-02-27,44,6,36,80
"18796","1300-1359",2021-02-28,44,7,41,85
"18797","1400-1459",2021-02-01,42,1,41,83
"18798","1400-1459",2021-02-02,35,2,33,68
"18799","1400-1459",2021-02-03,36,3,31,67
"18800","1400-1459",2021-02-04,43,4,41,84
"18801","1400-1459",2021-02-05,44,5,40,84
"18802","1400-1459",2021-02-06,37,6,36,73
"18803","1400-1459",2021-02-07,47,7,40,87
"18804","1400-1459",2021-02-08,42,1,40,82
"18805","1400-1459",2021-02-09,32,2,33,65
"18806","1400-1459",2021-02-10,36,3,32,68
"18807","1400-1459",2021-02-11,38,4,39,77
"18808","1400-1459",2021-02-12,40,5,39,79
"18809","1400-1459",2021-02-13,36,6,32,68
"18810","1400-1459",2021-02-14,39,7,35,74
"18811","1400-1459",2021-02-15,38,1,38,76
"18812","1400-1459",2021-02-16,35,2,35,70
"18813","1400-1459",2021-02-17,36,3,37,73
"18814","1400-1459",2021-02-18,39,4,40,79
"18815","1400-1459",2021-02-19,40,5,39,79
"18816","1400-1459",2021-02-20,36,6,32,68
"18817","1400-1459",2021-02-21,39,7,37,76
"18818","1400-1459",2021-02-22,38,1,40,78
"18819","1400-1459",2021-02-23,36,2,37,73
"18820","1400-1459",2021-02-24,36,3,38,74
"18821","1400-1459",2021-02-25,40,4,42,82
"18822","1400-1459",2021-02-26,41,5,42,83
"18823","1400-1459",2021-02-27,38,6,33,71
"18824","1400-1459",2021-02-28,40,7,38,78
"18825","1500-1559",2021-02-01,40,1,37,77
"18826","1500-1559",2021-02-02,30,2,24,54
"18827","1500-1559",2021-02-03,33,3,28,61
"18828","1500-1559",2021-02-04,40,4,35,75
"18829","1500-1559",2021-02-05,40,5,38,78
"18830","1500-1559",2021-02-06,32,6,36,68
"18831","1500-1559",2021-02-07,34,7,40,74
"18832","1500-1559",2021-02-08,40,1,36,76
"18833","1500-1559",2021-02-09,30,2,23,53
"18834","1500-1559",2021-02-10,35,3,27,62
"18835","1500-1559",2021-02-11,38,4,40,78
"18836","1500-1559",2021-02-12,40,5,46,86
"18837","1500-1559",2021-02-13,29,6,35,64
"18838","1500-1559",2021-02-14,34,7,47,81
"18839","1500-1559",2021-02-15,39,1,41,80
"18840","1500-1559",2021-02-16,34,2,34,68
"18841","1500-1559",2021-02-17,36,3,33,69
"18842","1500-1559",2021-02-18,37,4,42,79
"18843","1500-1559",2021-02-19,39,5,44,83
"18844","1500-1559",2021-02-20,28,6,35,63
"18845","1500-1559",2021-02-21,39,7,50,89
"18846","1500-1559",2021-02-22,38,1,40,78
"18847","1500-1559",2021-02-23,33,2,32,65
"18848","1500-1559",2021-02-24,34,3,31,65
"18849","1500-1559",2021-02-25,36,4,40,76
"18850","1500-1559",2021-02-26,39,5,42,81
"18851","1500-1559",2021-02-27,28,6,35,63
"18852","1500-1559",2021-02-28,39,7,48,87
"18853","1600-1659",2021-02-01,34,1,45,79
"18854","1600-1659",2021-02-02,30,2,39,69
"18855","1600-1659",2021-02-03,30,3,41,71
"18856","1600-1659",2021-02-04,36,4,47,83
"18857","1600-1659",2021-02-05,37,5,44,81
"18858","1600-1659",2021-02-06,34,6,40,74
"18859","1600-1659",2021-02-07,39,7,44,83
"18860","1600-1659",2021-02-08,34,1,45,79
"18861","1600-1659",2021-02-09,29,2,39,68
"18862","1600-1659",2021-02-10,31,3,41,72
"18863","1600-1659",2021-02-11,39,4,50,89
"18864","1600-1659",2021-02-12,40,5,49,89
"18865","1600-1659",2021-02-13,33,6,47,80
"18866","1600-1659",2021-02-14,39,7,44,83
"18867","1600-1659",2021-02-15,39,1,49,88
"18868","1600-1659",2021-02-16,28,2,45,73
"18869","1600-1659",2021-02-17,29,3,45,74
"18870","1600-1659",2021-02-18,39,4,47,86
"18871","1600-1659",2021-02-19,38,5,48,86
"18872","1600-1659",2021-02-20,33,6,46,79
"18873","1600-1659",2021-02-21,39,7,44,83
"18874","1600-1659",2021-02-22,38,1,49,87
"18875","1600-1659",2021-02-23,28,2,45,73
"18876","1600-1659",2021-02-24,29,3,45,74
"18877","1600-1659",2021-02-25,39,4,46,85
"18878","1600-1659",2021-02-26,38,5,48,86
"18879","1600-1659",2021-02-27,33,6,46,79
"18880","1600-1659",2021-02-28,39,7,43,82
"18881","1700-1759",2021-02-01,40,1,52,92
"18882","1700-1759",2021-02-02,30,2,45,75
"18883","1700-1759",2021-02-03,32,3,47,79
"18884","1700-1759",2021-02-04,42,4,51,93
"18885","1700-1759",2021-02-05,46,5,54,100
"18886","1700-1759",2021-02-06,38,6,42,80
"18887","1700-1759",2021-02-07,42,7,52,94
"18888","1700-1759",2021-02-08,40,1,52,92
"18889","1700-1759",2021-02-09,31,2,45,76
"18890","1700-1759",2021-02-10,32,3,50,82
"18891","1700-1759",2021-02-11,38,4,51,89
"18892","1700-1759",2021-02-12,44,5,54,98
"18893","1700-1759",2021-02-13,36,6,37,73
"18894","1700-1759",2021-02-14,40,7,47,87
"18895","1700-1759",2021-02-15,39,1,51,90
"18896","1700-1759",2021-02-16,32,2,44,76
"18897","1700-1759",2021-02-17,30,3,46,76
"18898","1700-1759",2021-02-18,37,4,53,90
"18899","1700-1759",2021-02-19,44,5,53,97
"18900","1700-1759",2021-02-20,35,6,38,73
"18901","1700-1759",2021-02-21,43,7,51,94
"18902","1700-1759",2021-02-22,39,1,50,89
"18903","1700-1759",2021-02-23,32,2,44,76
"18904","1700-1759",2021-02-24,30,3,46,76
"18905","1700-1759",2021-02-25,37,4,53,90
"18906","1700-1759",2021-02-26,44,5,55,99
"18907","1700-1759",2021-02-27,35,6,38,73
"18908","1700-1759",2021-02-28,43,7,51,94
"18909","1800-1859",2021-02-01,41,1,39,80
"18910","1800-1859",2021-02-02,38,2,31,69
"18911","1800-1859",2021-02-03,38,3,31,69
"18912","1800-1859",2021-02-04,43,4,40,83
"18913","1800-1859",2021-02-05,37,5,41,78
"18914","1800-1859",2021-02-06,27,6,35,62
"18915","1800-1859",2021-02-07,32,7,38,70
"18916","1800-1859",2021-02-08,40,1,39,79
"18917","1800-1859",2021-02-09,37,2,31,68
"18918","1800-1859",2021-02-10,40,3,32,72
"18919","1800-1859",2021-02-11,50,4,39,89
"18920","1800-1859",2021-02-12,50,5,37,87
"18921","1800-1859",2021-02-13,35,6,33,68
"18922","1800-1859",2021-02-14,40,7,36,76
"18923","1800-1859",2021-02-15,51,1,41,92
"18924","1800-1859",2021-02-16,45,2,30,75
"18925","1800-1859",2021-02-17,47,3,33,80
"18926","1800-1859",2021-02-18,50,4,39,89
"18927","1800-1859",2021-02-19,49,5,37,86
"18928","1800-1859",2021-02-20,35,6,34,69
"18929","1800-1859",2021-02-21,48,7,39,87
"18930","1800-1859",2021-02-22,50,1,41,91
"18931","1800-1859",2021-02-23,45,2,30,75
"18932","1800-1859",2021-02-24,47,3,32,79
"18933","1800-1859",2021-02-25,50,4,39,89
"18934","1800-1859",2021-02-26,49,5,36,85
"18935","1800-1859",2021-02-27,35,6,33,68
"18936","1800-1859",2021-02-28,48,7,40,88
"18937","1900-1959",2021-02-01,38,1,36,74
"18938","1900-1959",2021-02-02,32,2,34,66
"18939","1900-1959",2021-02-03,31,3,34,65
"18940","1900-1959",2021-02-04,36,4,37,73
"18941","1900-1959",2021-02-05,40,5,36,76
"18942","1900-1959",2021-02-06,31,6,35,66
"18943","1900-1959",2021-02-07,33,7,33,66
"18944","1900-1959",2021-02-08,39,1,36,75
"18945","1900-1959",2021-02-09,32,2,34,66
"18946","1900-1959",2021-02-10,33,3,37,70
"18947","1900-1959",2021-02-11,43,4,40,83
"18948","1900-1959",2021-02-12,44,5,42,86
"18949","1900-1959",2021-02-13,29,6,37,66
"18950","1900-1959",2021-02-14,38,7,38,76
"18951","1900-1959",2021-02-15,41,1,41,82
"18952","1900-1959",2021-02-16,33,2,39,72
"18953","1900-1959",2021-02-17,34,3,37,71
"18954","1900-1959",2021-02-18,42,4,39,81
"18955","1900-1959",2021-02-19,43,5,41,84
"18956","1900-1959",2021-02-20,30,6,36,66
"18957","1900-1959",2021-02-21,45,7,42,87
"18958","1900-1959",2021-02-22,41,1,39,80
"18959","1900-1959",2021-02-23,33,2,38,71
"18960","1900-1959",2021-02-24,34,3,36,70
"18961","1900-1959",2021-02-25,42,4,38,80
"18962","1900-1959",2021-02-26,43,5,40,83
"18963","1900-1959",2021-02-27,29,6,36,65
"18964","1900-1959",2021-02-28,45,7,41,86
"18965","2000-2059",2021-02-01,25,1,42,67
"18966","2000-2059",2021-02-02,17,2,34,51
"18967","2000-2059",2021-02-03,17,3,38,55
"18968","2000-2059",2021-02-04,24,4,45,69
"18969","2000-2059",2021-02-05,25,5,43,68
"18970","2000-2059",2021-02-06,20,6,32,52
"18971","2000-2059",2021-02-07,21,7,42,63
"18972","2000-2059",2021-02-08,25,1,43,68
"18973","2000-2059",2021-02-09,17,2,35,52
"18974","2000-2059",2021-02-10,16,3,37,53
"18975","2000-2059",2021-02-11,24,4,38,62
"18976","2000-2059",2021-02-12,23,5,37,60
"18977","2000-2059",2021-02-13,17,6,31,48
"18978","2000-2059",2021-02-14,20,7,36,56
"18979","2000-2059",2021-02-15,23,1,36,59
"18980","2000-2059",2021-02-16,17,2,30,47
"18981","2000-2059",2021-02-17,18,3,30,48
"18982","2000-2059",2021-02-18,24,4,38,62
"18983","2000-2059",2021-02-19,23,5,37,60
"18984","2000-2059",2021-02-20,17,6,31,48
"18985","2000-2059",2021-02-21,24,7,38,62
"18986","2000-2059",2021-02-22,23,1,36,59
"18987","2000-2059",2021-02-23,17,2,30,47
"18988","2000-2059",2021-02-24,18,3,30,48
"18989","2000-2059",2021-02-25,23,4,38,61
"18990","2000-2059",2021-02-26,23,5,37,60
"18991","2000-2059",2021-02-27,17,6,30,47
"18992","2000-2059",2021-02-28,23,7,40,63
"18993","2100-2159",2021-02-01,12,1,53,65
"18994","2100-2159",2021-02-02,10,2,43,53
"18995","2100-2159",2021-02-03,10,3,43,53
"18996","2100-2159",2021-02-04,14,4,53,67
"18997","2100-2159",2021-02-05,12,5,57,69
"18998","2100-2159",2021-02-06,8,6,50,58
"18999","2100-2159",2021-02-07,11,7,44,55
"19000","2100-2159",2021-02-08,12,1,53,65
"19001","2100-2159",2021-02-09,10,2,42,52
"19002","2100-2159",2021-02-10,10,3,44,54
"19003","2100-2159",2021-02-11,13,4,58,71
"19004","2100-2159",2021-02-12,12,5,64,76
"19005","2100-2159",2021-02-13,8,6,44,52
"19006","2100-2159",2021-02-14,11,7,52,63
"19007","2100-2159",2021-02-15,11,1,60,71
"19008","2100-2159",2021-02-16,10,2,47,57
"19009","2100-2159",2021-02-17,8,3,53,61
"19010","2100-2159",2021-02-18,12,4,59,71
"19011","2100-2159",2021-02-19,11,5,64,75
"19012","2100-2159",2021-02-20,8,6,45,53
"19013","2100-2159",2021-02-21,14,7,61,75
"19014","2100-2159",2021-02-22,11,1,60,71
"19015","2100-2159",2021-02-23,10,2,47,57
"19016","2100-2159",2021-02-24,8,3,52,60
"19017","2100-2159",2021-02-25,12,4,57,69
"19018","2100-2159",2021-02-26,11,5,63,74
"19019","2100-2159",2021-02-27,8,6,45,53
"19020","2100-2159",2021-02-28,14,7,59,73
"19021","2200-2259",2021-02-01,17,1,33,50
"19022","2200-2259",2021-02-02,12,2,28,40
"19023","2200-2259",2021-02-03,13,3,28,41
"19024","2200-2259",2021-02-04,16,4,32,48
"19025","2200-2259",2021-02-05,17,5,34,51
"19026","2200-2259",2021-02-06,14,6,21,35
"19027","2200-2259",2021-02-07,15,7,30,45
"19028","2200-2259",2021-02-08,17,1,32,49
"19029","2200-2259",2021-02-09,12,2,25,37
"19030","2200-2259",2021-02-10,13,3,28,41
"19031","2200-2259",2021-02-11,14,4,44,58
"19032","2200-2259",2021-02-12,12,5,43,55
"19033","2200-2259",2021-02-13,10,6,28,38
"19034","2200-2259",2021-02-14,12,7,39,51
"19035","2200-2259",2021-02-15,12,1,41,53
"19036","2200-2259",2021-02-16,10,2,34,44
"19037","2200-2259",2021-02-17,10,3,32,42
"19038","2200-2259",2021-02-18,14,4,43,57
"19039","2200-2259",2021-02-19,12,5,41,53
"19040","2200-2259",2021-02-20,10,6,28,38
"19041","2200-2259",2021-02-21,13,7,45,58
"19042","2200-2259",2021-02-22,11,1,41,52
"19043","2200-2259",2021-02-23,9,2,34,43
"19044","2200-2259",2021-02-24,9,3,32,41
"19045","2200-2259",2021-02-25,12,4,44,56
"19046","2200-2259",2021-02-26,11,5,42,53
"19047","2200-2259",2021-02-27,10,6,29,39
"19048","2200-2259",2021-02-28,13,7,45,58
"19049","2300-2359",2021-02-01,13,1,27,40
"19050","2300-2359",2021-02-02,11,2,15,26
"19051","2300-2359",2021-02-03,13,3,15,28
"19052","2300-2359",2021-02-04,13,4,27,40
"19053","2300-2359",2021-02-05,15,5,26,41
"19054","2300-2359",2021-02-06,15,6,21,36
"19055","2300-2359",2021-02-07,13,7,22,35
"19056","2300-2359",2021-02-08,12,1,27,39
"19057","2300-2359",2021-02-09,11,2,15,26
"19058","2300-2359",2021-02-10,12,3,16,28
"19059","2300-2359",2021-02-11,16,4,26,42
"19060","2300-2359",2021-02-12,19,5,23,42
"19061","2300-2359",2021-02-13,16,6,16,32
"19062","2300-2359",2021-02-14,17,7,21,38
"19063","2300-2359",2021-02-15,17,1,23,40
"19064","2300-2359",2021-02-16,12,2,13,25
"19065","2300-2359",2021-02-17,16,3,13,29
"19066","2300-2359",2021-02-18,17,4,26,43
"19067","2300-2359",2021-02-19,19,5,23,42
"19068","2300-2359",2021-02-20,17,6,16,33
"19069","2300-2359",2021-02-21,18,7,25,43
"19070","2300-2359",2021-02-22,17,1,23,40
"19071","2300-2359",2021-02-23,12,2,13,25
"19072","2300-2359",2021-02-24,16,3,13,29
"19073","2300-2359",2021-02-25,17,4,24,41
"19074","2300-2359",2021-02-26,19,5,23,42
"19075","2300-2359",2021-02-27,17,6,16,33
"19076","2300-2359",2021-02-28,18,7,25,43
"19077","0001-0559",2021-03-01,8,1,15,23
"19078","0001-0559",2021-03-02,9,2,15,24
"19079","0001-0559",2021-03-03,6,3,16,22
"19080","0001-0559",2021-03-04,7,4,18,25
"19081","0001-0559",2021-03-05,10,5,22,32
"19082","0001-0559",2021-03-06,10,6,20,30
"19083","0001-0559",2021-03-07,6,7,20,26
"19084","0001-0559",2021-03-08,10,1,19,29
"19085","0001-0559",2021-03-09,9,2,15,24
"19086","0001-0559",2021-03-10,8,3,22,30
"19087","0001-0559",2021-03-11,8,4,25,33
"19088","0001-0559",2021-03-12,10,5,26,36
"19089","0001-0559",2021-03-13,14,6,18,32
"19090","0001-0559",2021-03-14,6,7,25,31
"19091","0001-0559",2021-03-15,10,1,24,34
"19092","0001-0559",2021-03-16,9,2,20,29
"19093","0001-0559",2021-03-17,8,3,22,30
"19094","0001-0559",2021-03-18,8,4,25,33
"19095","0001-0559",2021-03-19,10,5,25,35
"19096","0001-0559",2021-03-20,14,6,25,39
"19097","0001-0559",2021-03-21,7,7,27,34
"19098","0001-0559",2021-03-22,10,1,24,34
"19099","0001-0559",2021-03-23,9,2,20,29
"19100","0001-0559",2021-03-24,8,3,22,30
"19101","0001-0559",2021-03-25,8,4,25,33
"19102","0001-0559",2021-03-26,10,5,25,35
"19103","0001-0559",2021-03-27,15,6,27,42
"19104","0001-0559",2021-03-28,7,7,27,34
"19105","0001-0559",2021-03-29,11,1,25,36
"19106","0001-0559",2021-03-30,10,2,21,31
"19107","0001-0559",2021-03-31,9,3,23,32
"19108","0600-0659",2021-03-01,45,1,17,62
"19109","0600-0659",2021-03-02,36,2,11,47
"19110","0600-0659",2021-03-03,37,3,12,49
"19111","0600-0659",2021-03-04,45,4,19,64
"19112","0600-0659",2021-03-05,44,5,21,65
"19113","0600-0659",2021-03-06,43,6,21,64
"19114","0600-0659",2021-03-07,46,7,19,65
"19115","0600-0659",2021-03-08,48,1,19,67
"19116","0600-0659",2021-03-09,39,2,18,57
"19117","0600-0659",2021-03-10,39,3,16,55
"19118","0600-0659",2021-03-11,55,4,18,73
"19119","0600-0659",2021-03-12,55,5,20,75
"19120","0600-0659",2021-03-13,44,6,20,64
"19121","0600-0659",2021-03-14,54,7,17,71
"19122","0600-0659",2021-03-15,57,1,17,74
"19123","0600-0659",2021-03-16,54,2,17,71
"19124","0600-0659",2021-03-17,54,3,16,70
"19125","0600-0659",2021-03-18,59,4,17,76
"19126","0600-0659",2021-03-19,58,5,19,77
"19127","0600-0659",2021-03-20,50,6,19,69
"19128","0600-0659",2021-03-21,57,7,17,74
"19129","0600-0659",2021-03-22,59,1,17,76
"19130","0600-0659",2021-03-23,56,2,16,72
"19131","0600-0659",2021-03-24,56,3,15,71
"19132","0600-0659",2021-03-25,59,4,17,76
"19133","0600-0659",2021-03-26,58,5,19,77
"19134","0600-0659",2021-03-27,49,6,19,68
"19135","0600-0659",2021-03-28,55,7,16,71
"19136","0600-0659",2021-03-29,58,1,16,74
"19137","0600-0659",2021-03-30,55,2,15,70
"19138","0600-0659",2021-03-31,55,3,13,68
"19139","0700-0759",2021-03-01,52,1,24,76
"19140","0700-0759",2021-03-02,48,2,21,69
"19141","0700-0759",2021-03-03,48,3,23,71
"19142","0700-0759",2021-03-04,58,4,26,84
"19143","0700-0759",2021-03-05,60,5,26,86
"19144","0700-0759",2021-03-06,59,6,25,84
"19145","0700-0759",2021-03-07,69,7,26,95
"19146","0700-0759",2021-03-08,70,1,25,95
"19147","0700-0759",2021-03-09,56,2,23,79
"19148","0700-0759",2021-03-10,54,3,26,80
"19149","0700-0759",2021-03-11,65,4,34,99
"19150","0700-0759",2021-03-12,65,5,33,98
"19151","0700-0759",2021-03-13,62,6,34,96
"19152","0700-0759",2021-03-14,64,7,34,98
"19153","0700-0759",2021-03-15,63,1,34,97
"19154","0700-0759",2021-03-16,57,2,33,90
"19155","0700-0759",2021-03-17,54,3,34,88
"19156","0700-0759",2021-03-18,63,4,41,104
"19157","0700-0759",2021-03-19,64,5,40,104
"19158","0700-0759",2021-03-20,58,6,40,98
"19159","0700-0759",2021-03-21,64,7,40,104
"19160","0700-0759",2021-03-22,63,1,39,102
"19161","0700-0759",2021-03-23,58,2,38,96
"19162","0700-0759",2021-03-24,56,3,39,95
"19163","0700-0759",2021-03-25,64,4,41,105
"19164","0700-0759",2021-03-26,65,5,40,105
"19165","0700-0759",2021-03-27,58,6,38,96
"19166","0700-0759",2021-03-28,68,7,41,109
"19167","0700-0759",2021-03-29,62,1,40,102
"19168","0700-0759",2021-03-30,57,2,39,96
"19169","0700-0759",2021-03-31,53,3,40,93
"19170","0800-0859",2021-03-01,62,1,33,95
"19171","0800-0859",2021-03-02,55,2,26,81
"19172","0800-0859",2021-03-03,55,3,29,84
"19173","0800-0859",2021-03-04,58,4,34,92
"19174","0800-0859",2021-03-05,55,5,36,91
"19175","0800-0859",2021-03-06,51,6,33,84
"19176","0800-0859",2021-03-07,53,7,36,89
"19177","0800-0859",2021-03-08,51,1,40,91
"19178","0800-0859",2021-03-09,53,2,30,83
"19179","0800-0859",2021-03-10,55,3,30,85
"19180","0800-0859",2021-03-11,59,4,37,96
"19181","0800-0859",2021-03-12,56,5,40,96
"19182","0800-0859",2021-03-13,53,6,39,92
"19183","0800-0859",2021-03-14,63,7,37,100
"19184","0800-0859",2021-03-15,61,1,39,100
"19185","0800-0859",2021-03-16,59,2,34,93
"19186","0800-0859",2021-03-17,61,3,34,95
"19187","0800-0859",2021-03-18,69,4,35,104
"19188","0800-0859",2021-03-19,66,5,38,104
"19189","0800-0859",2021-03-20,62,6,33,95
"19190","0800-0859",2021-03-21,70,7,33,103
"19191","0800-0859",2021-03-22,65,1,36,101
"19192","0800-0859",2021-03-23,63,2,33,96
"19193","0800-0859",2021-03-24,65,3,34,99
"19194","0800-0859",2021-03-25,70,4,36,106
"19195","0800-0859",2021-03-26,66,5,39,105
"19196","0800-0859",2021-03-27,63,6,34,97
"19197","0800-0859",2021-03-28,73,7,35,108
"19198","0800-0859",2021-03-29,67,1,35,102
"19199","0800-0859",2021-03-30,66,2,33,99
"19200","0800-0859",2021-03-31,68,3,32,100
"19201","0900-0959",2021-03-01,52,1,36,88
"19202","0900-0959",2021-03-02,49,2,35,84
"19203","0900-0959",2021-03-03,48,3,34,82
"19204","0900-0959",2021-03-04,61,4,35,96
"19205","0900-0959",2021-03-05,61,5,35,96
"19206","0900-0959",2021-03-06,56,6,37,93
"19207","0900-0959",2021-03-07,70,7,39,109
"19208","0900-0959",2021-03-08,68,1,37,105
"19209","0900-0959",2021-03-09,56,2,35,91
"19210","0900-0959",2021-03-10,53,3,34,87
"19211","0900-0959",2021-03-11,64,4,38,102
"19212","0900-0959",2021-03-12,62,5,37,99
"19213","0900-0959",2021-03-13,54,6,39,93
"19214","0900-0959",2021-03-14,60,7,40,100
"19215","0900-0959",2021-03-15,58,1,36,94
"19216","0900-0959",2021-03-16,54,2,35,89
"19217","0900-0959",2021-03-17,52,3,34,86
"19218","0900-0959",2021-03-18,58,4,38,96
"19219","0900-0959",2021-03-19,57,5,38,95
"19220","0900-0959",2021-03-20,50,6,38,88
"19221","0900-0959",2021-03-21,57,7,42,99
"19222","0900-0959",2021-03-22,55,1,39,94
"19223","0900-0959",2021-03-23,51,2,36,87
"19224","0900-0959",2021-03-24,49,3,35,84
"19225","0900-0959",2021-03-25,58,4,39,97
"19226","0900-0959",2021-03-26,57,5,38,95
"19227","0900-0959",2021-03-27,50,6,38,88
"19228","0900-0959",2021-03-28,53,7,41,94
"19229","0900-0959",2021-03-29,51,1,40,91
"19230","0900-0959",2021-03-30,46,2,37,83
"19231","0900-0959",2021-03-31,45,3,36,81
"19232","1000-1059",2021-03-01,48,1,27,75
"19233","1000-1059",2021-03-02,40,2,23,63
"19234","1000-1059",2021-03-03,40,3,23,63
"19235","1000-1059",2021-03-04,46,4,27,73
"19236","1000-1059",2021-03-05,50,5,29,79
"19237","1000-1059",2021-03-06,44,6,25,69
"19238","1000-1059",2021-03-07,42,7,32,74
"19239","1000-1059",2021-03-08,46,1,35,81
"19240","1000-1059",2021-03-09,42,2,26,68
"19241","1000-1059",2021-03-10,41,3,23,64
"19242","1000-1059",2021-03-11,43,4,32,75
"19243","1000-1059",2021-03-12,46,5,34,80
"19244","1000-1059",2021-03-13,46,6,28,74
"19245","1000-1059",2021-03-14,43,7,32,75
"19246","1000-1059",2021-03-15,45,1,35,80
"19247","1000-1059",2021-03-16,38,2,30,68
"19248","1000-1059",2021-03-17,39,3,28,67
"19249","1000-1059",2021-03-18,50,4,33,83
"19250","1000-1059",2021-03-19,49,5,35,84
"19251","1000-1059",2021-03-20,48,6,29,77
"19252","1000-1059",2021-03-21,49,7,31,80
"19253","1000-1059",2021-03-22,49,1,34,83
"19254","1000-1059",2021-03-23,44,2,30,74
"19255","1000-1059",2021-03-24,43,3,28,71
"19256","1000-1059",2021-03-25,50,4,32,82
"19257","1000-1059",2021-03-26,49,5,35,84
"19258","1000-1059",2021-03-27,45,6,29,74
"19259","1000-1059",2021-03-28,50,7,29,79
"19260","1000-1059",2021-03-29,50,1,31,81
"19261","1000-1059",2021-03-30,47,2,27,74
"19262","1000-1059",2021-03-31,44,3,25,69
"19263","1100-1159",2021-03-01,34,1,43,77
"19264","1100-1159",2021-03-02,26,2,37,63
"19265","1100-1159",2021-03-03,26,3,35,61
"19266","1100-1159",2021-03-04,36,4,48,84
"19267","1100-1159",2021-03-05,40,5,48,88
"19268","1100-1159",2021-03-06,37,6,45,82
"19269","1100-1159",2021-03-07,46,7,48,94
"19270","1100-1159",2021-03-08,44,1,47,91
"19271","1100-1159",2021-03-09,32,2,39,71
"19272","1100-1159",2021-03-10,31,3,39,70
"19273","1100-1159",2021-03-11,41,4,45,86
"19274","1100-1159",2021-03-12,42,5,44,86
"19275","1100-1159",2021-03-13,34,6,44,78
"19276","1100-1159",2021-03-14,43,7,50,93
"19277","1100-1159",2021-03-15,41,1,48,89
"19278","1100-1159",2021-03-16,35,2,42,77
"19279","1100-1159",2021-03-17,34,3,42,76
"19280","1100-1159",2021-03-18,40,4,56,96
"19281","1100-1159",2021-03-19,39,5,54,93
"19282","1100-1159",2021-03-20,35,6,55,90
"19283","1100-1159",2021-03-21,42,7,56,98
"19284","1100-1159",2021-03-22,39,1,52,91
"19285","1100-1159",2021-03-23,33,2,47,80
"19286","1100-1159",2021-03-24,34,3,47,81
"19287","1100-1159",2021-03-25,41,4,56,97
"19288","1100-1159",2021-03-26,39,5,54,93
"19289","1100-1159",2021-03-27,36,6,53,89
"19290","1100-1159",2021-03-28,39,7,57,96
"19291","1100-1159",2021-03-29,39,1,53,92
"19292","1100-1159",2021-03-30,32,2,50,82
"19293","1100-1159",2021-03-31,35,3,49,84
"19294","1200-1259",2021-03-01,48,1,56,104
"19295","1200-1259",2021-03-02,42,2,46,88
"19296","1200-1259",2021-03-03,41,3,43,84
"19297","1200-1259",2021-03-04,49,4,49,98
"19298","1200-1259",2021-03-05,51,5,52,103
"19299","1200-1259",2021-03-06,40,6,46,86
"19300","1200-1259",2021-03-07,48,7,52,100
"19301","1200-1259",2021-03-08,49,1,52,101
"19302","1200-1259",2021-03-09,44,2,46,90
"19303","1200-1259",2021-03-10,42,3,45,87
"19304","1200-1259",2021-03-11,45,4,50,95
"19305","1200-1259",2021-03-12,47,5,52,99
"19306","1200-1259",2021-03-13,40,6,48,88
"19307","1200-1259",2021-03-14,54,7,52,106
"19308","1200-1259",2021-03-15,53,1,53,106
"19309","1200-1259",2021-03-16,43,2,49,92
"19310","1200-1259",2021-03-17,43,3,47,90
"19311","1200-1259",2021-03-18,56,4,53,109
"19312","1200-1259",2021-03-19,58,5,50,108
"19313","1200-1259",2021-03-20,50,6,46,96
"19314","1200-1259",2021-03-21,58,7,52,110
"19315","1200-1259",2021-03-22,57,1,50,107
"19316","1200-1259",2021-03-23,48,2,48,96
"19317","1200-1259",2021-03-24,47,3,45,92
"19318","1200-1259",2021-03-25,56,4,53,109
"19319","1200-1259",2021-03-26,58,5,50,108
"19320","1200-1259",2021-03-27,49,6,46,95
"19321","1200-1259",2021-03-28,58,7,49,107
"19322","1200-1259",2021-03-29,58,1,46,104
"19323","1200-1259",2021-03-30,48,2,43,91
"19324","1200-1259",2021-03-31,49,3,41,90
"19325","1300-1359",2021-03-01,48,1,39,87
"19326","1300-1359",2021-03-02,36,2,32,68
"19327","1300-1359",2021-03-03,38,3,31,69
"19328","1300-1359",2021-03-04,48,4,45,93
"19329","1300-1359",2021-03-05,50,5,47,97
"19330","1300-1359",2021-03-06,50,6,45,95
"19331","1300-1359",2021-03-07,51,7,47,98
"19332","1300-1359",2021-03-08,49,1,49,98
"19333","1300-1359",2021-03-09,42,2,43,85
"19334","1300-1359",2021-03-10,45,3,42,87
"19335","1300-1359",2021-03-11,51,4,50,101
"19336","1300-1359",2021-03-12,51,5,52,103
"19337","1300-1359",2021-03-13,48,6,41,89
"19338","1300-1359",2021-03-14,48,7,44,92
"19339","1300-1359",2021-03-15,47,1,47,94
"19340","1300-1359",2021-03-16,43,2,38,81
"19341","1300-1359",2021-03-17,47,3,40,87
"19342","1300-1359",2021-03-18,46,4,47,93
"19343","1300-1359",2021-03-19,45,5,49,94
"19344","1300-1359",2021-03-20,42,6,43,85
"19345","1300-1359",2021-03-21,45,7,47,92
"19346","1300-1359",2021-03-22,44,1,49,93
"19347","1300-1359",2021-03-23,42,2,41,83
"19348","1300-1359",2021-03-24,44,3,44,88
"19349","1300-1359",2021-03-25,46,4,47,93
"19350","1300-1359",2021-03-26,44,5,49,93
"19351","1300-1359",2021-03-27,40,6,42,82
"19352","1300-1359",2021-03-28,43,7,48,91
"19353","1300-1359",2021-03-29,40,1,50,90
"19354","1300-1359",2021-03-30,39,2,42,81
"19355","1300-1359",2021-03-31,41,3,45,86
"19356","1400-1459",2021-03-01,38,1,42,80
"19357","1400-1459",2021-03-02,37,2,35,72
"19358","1400-1459",2021-03-03,37,3,37,74
"19359","1400-1459",2021-03-04,40,4,46,86
"19360","1400-1459",2021-03-05,42,5,48,90
"19361","1400-1459",2021-03-06,32,6,35,67
"19362","1400-1459",2021-03-07,37,7,49,86
"19363","1400-1459",2021-03-08,40,1,47,87
"19364","1400-1459",2021-03-09,38,2,37,75
"19365","1400-1459",2021-03-10,40,3,38,78
"19366","1400-1459",2021-03-11,42,4,48,90
"19367","1400-1459",2021-03-12,46,5,48,94
"19368","1400-1459",2021-03-13,34,6,37,71
"19369","1400-1459",2021-03-14,41,7,48,89
"19370","1400-1459",2021-03-15,45,1,46,91
"19371","1400-1459",2021-03-16,38,2,40,78
"19372","1400-1459",2021-03-17,39,3,41,80
"19373","1400-1459",2021-03-18,46,4,47,93
"19374","1400-1459",2021-03-19,49,5,46,95
"19375","1400-1459",2021-03-20,41,6,32,73
"19376","1400-1459",2021-03-21,47,7,49,96
"19377","1400-1459",2021-03-22,49,1,46,95
"19378","1400-1459",2021-03-23,39,2,40,79
"19379","1400-1459",2021-03-24,40,3,40,80
"19380","1400-1459",2021-03-25,45,4,47,92
"19381","1400-1459",2021-03-26,50,5,46,96
"19382","1400-1459",2021-03-27,42,6,34,76
"19383","1400-1459",2021-03-28,49,7,49,98
"19384","1400-1459",2021-03-29,49,1,48,97
"19385","1400-1459",2021-03-30,39,2,42,81
"19386","1400-1459",2021-03-31,41,3,43,84
"19387","1500-1559",2021-03-01,39,1,37,76
"19388","1500-1559",2021-03-02,32,2,36,68
"19389","1500-1559",2021-03-03,33,3,36,69
"19390","1500-1559",2021-03-04,35,4,35,70
"19391","1500-1559",2021-03-05,38,5,35,73
"19392","1500-1559",2021-03-06,34,6,35,69
"19393","1500-1559",2021-03-07,42,7,37,79
"19394","1500-1559",2021-03-08,40,1,35,75
"19395","1500-1559",2021-03-09,34,2,37,71
"19396","1500-1559",2021-03-10,34,3,37,71
"19397","1500-1559",2021-03-11,31,4,35,66
"19398","1500-1559",2021-03-12,36,5,34,70
"19399","1500-1559",2021-03-13,32,6,35,67
"19400","1500-1559",2021-03-14,35,7,38,73
"19401","1500-1559",2021-03-15,33,1,35,68
"19402","1500-1559",2021-03-16,31,2,34,65
"19403","1500-1559",2021-03-17,33,3,37,70
"19404","1500-1559",2021-03-18,33,4,37,70
"19405","1500-1559",2021-03-19,34,5,37,71
"19406","1500-1559",2021-03-20,33,6,37,70
"19407","1500-1559",2021-03-21,37,7,39,76
"19408","1500-1559",2021-03-22,34,1,37,71
"19409","1500-1559",2021-03-23,32,2,36,68
"19410","1500-1559",2021-03-24,33,3,37,70
"19411","1500-1559",2021-03-25,33,4,38,71
"19412","1500-1559",2021-03-26,32,5,36,68
"19413","1500-1559",2021-03-27,35,6,37,72
"19414","1500-1559",2021-03-28,37,7,39,76
"19415","1500-1559",2021-03-29,36,1,36,72
"19416","1500-1559",2021-03-30,34,2,35,69
"19417","1500-1559",2021-03-31,37,3,36,73
"19418","1600-1659",2021-03-01,38,1,48,86
"19419","1600-1659",2021-03-02,33,2,47,80
"19420","1600-1659",2021-03-03,34,3,47,81
"19421","1600-1659",2021-03-04,46,4,46,92
"19422","1600-1659",2021-03-05,46,5,50,96
"19423","1600-1659",2021-03-06,41,6,43,84
"19424","1600-1659",2021-03-07,46,7,52,98
"19425","1600-1659",2021-03-08,43,1,53,96
"19426","1600-1659",2021-03-09,39,2,46,85
"19427","1600-1659",2021-03-10,39,3,48,87
"19428","1600-1659",2021-03-11,44,4,47,91
"19429","1600-1659",2021-03-12,43,5,49,92
"19430","1600-1659",2021-03-13,42,6,42,84
"19431","1600-1659",2021-03-14,49,7,54,103
"19432","1600-1659",2021-03-15,46,1,54,100
"19433","1600-1659",2021-03-16,37,2,52,89
"19434","1600-1659",2021-03-17,39,3,51,90
"19435","1600-1659",2021-03-18,49,4,52,101
"19436","1600-1659",2021-03-19,49,5,53,102
"19437","1600-1659",2021-03-20,45,6,48,93
"19438","1600-1659",2021-03-21,52,7,54,106
"19439","1600-1659",2021-03-22,49,1,52,101
"19440","1600-1659",2021-03-23,38,2,50,88
"19441","1600-1659",2021-03-24,41,3,49,90
"19442","1600-1659",2021-03-25,49,4,52,101
"19443","1600-1659",2021-03-26,48,5,52,100
"19444","1600-1659",2021-03-27,45,6,46,91
"19445","1600-1659",2021-03-28,51,7,52,103
"19446","1600-1659",2021-03-29,48,1,51,99
"19447","1600-1659",2021-03-30,42,2,49,91
"19448","1600-1659",2021-03-31,42,3,48,90
"19449","1700-1759",2021-03-01,38,1,51,89
"19450","1700-1759",2021-03-02,30,2,43,73
"19451","1700-1759",2021-03-03,28,3,45,73
"19452","1700-1759",2021-03-04,38,4,54,92
"19453","1700-1759",2021-03-05,41,5,56,97
"19454","1700-1759",2021-03-06,28,6,48,76
"19455","1700-1759",2021-03-07,42,7,52,94
"19456","1700-1759",2021-03-08,41,1,52,93
"19457","1700-1759",2021-03-09,31,2,46,77
"19458","1700-1759",2021-03-10,31,3,48,79
"19459","1700-1759",2021-03-11,41,4,46,87
"19460","1700-1759",2021-03-12,45,5,50,95
"19461","1700-1759",2021-03-13,30,6,50,80
"19462","1700-1759",2021-03-14,44,7,46,90
"19463","1700-1759",2021-03-15,43,1,47,90
"19464","1700-1759",2021-03-16,35,2,35,70
"19465","1700-1759",2021-03-17,33,3,41,74
"19466","1700-1759",2021-03-18,41,4,48,89
"19467","1700-1759",2021-03-19,44,5,53,97
"19468","1700-1759",2021-03-20,30,6,50,80
"19469","1700-1759",2021-03-21,42,7,53,95
"19470","1700-1759",2021-03-22,42,1,53,95
"19471","1700-1759",2021-03-23,33,2,37,70
"19472","1700-1759",2021-03-24,33,3,43,76
"19473","1700-1759",2021-03-25,42,4,48,90
"19474","1700-1759",2021-03-26,44,5,53,97
"19475","1700-1759",2021-03-27,30,6,52,82
"19476","1700-1759",2021-03-28,42,7,55,97
"19477","1700-1759",2021-03-29,41,1,55,96
"19478","1700-1759",2021-03-30,32,2,41,73
"19479","1700-1759",2021-03-31,32,3,48,80
"19480","1800-1859",2021-03-01,49,1,40,89
"19481","1800-1859",2021-03-02,40,2,33,73
"19482","1800-1859",2021-03-03,42,3,36,78
"19483","1800-1859",2021-03-04,50,4,39,89
"19484","1800-1859",2021-03-05,49,5,40,89
"19485","1800-1859",2021-03-06,40,6,31,71
"19486","1800-1859",2021-03-07,50,7,40,90
"19487","1800-1859",2021-03-08,49,1,42,91
"19488","1800-1859",2021-03-09,43,2,33,76
"19489","1800-1859",2021-03-10,43,3,36,79
"19490","1800-1859",2021-03-11,50,4,43,93
"19491","1800-1859",2021-03-12,50,5,45,95
"19492","1800-1859",2021-03-13,44,6,32,76
"19493","1800-1859",2021-03-14,47,7,43,90
"19494","1800-1859",2021-03-15,47,1,44,91
"19495","1800-1859",2021-03-16,44,2,39,83
"19496","1800-1859",2021-03-17,43,3,39,82
"19497","1800-1859",2021-03-18,52,4,45,97
"19498","1800-1859",2021-03-19,52,5,46,98
"19499","1800-1859",2021-03-20,50,6,36,86
"19500","1800-1859",2021-03-21,52,7,43,95
"19501","1800-1859",2021-03-22,51,1,45,96
"19502","1800-1859",2021-03-23,47,2,40,87
"19503","1800-1859",2021-03-24,48,3,41,89
"19504","1800-1859",2021-03-25,53,4,45,98
"19505","1800-1859",2021-03-26,53,5,46,99
"19506","1800-1859",2021-03-27,49,6,35,84
"19507","1800-1859",2021-03-28,52,7,41,93
"19508","1800-1859",2021-03-29,52,1,43,95
"19509","1800-1859",2021-03-30,46,2,39,85
"19510","1800-1859",2021-03-31,48,3,39,87
"19511","1900-1959",2021-03-01,42,1,38,80
"19512","1900-1959",2021-03-02,39,2,35,74
"19513","1900-1959",2021-03-03,41,3,33,74
"19514","1900-1959",2021-03-04,51,4,40,91
"19515","1900-1959",2021-03-05,52,5,41,93
"19516","1900-1959",2021-03-06,35,6,39,74
"19517","1900-1959",2021-03-07,51,7,44,95
"19518","1900-1959",2021-03-08,52,1,40,92
"19519","1900-1959",2021-03-09,42,2,39,81
"19520","1900-1959",2021-03-10,45,3,37,82
"19521","1900-1959",2021-03-11,51,4,38,89
"19522","1900-1959",2021-03-12,54,5,41,95
"19523","1900-1959",2021-03-13,42,6,38,80
"19524","1900-1959",2021-03-14,53,7,42,95
"19525","1900-1959",2021-03-15,52,1,39,91
"19526","1900-1959",2021-03-16,46,2,34,80
"19527","1900-1959",2021-03-17,47,3,34,81
"19528","1900-1959",2021-03-18,52,4,38,90
"19529","1900-1959",2021-03-19,54,5,38,92
"19530","1900-1959",2021-03-20,45,6,36,81
"19531","1900-1959",2021-03-21,53,7,41,94
"19532","1900-1959",2021-03-22,54,1,38,92
"19533","1900-1959",2021-03-23,46,2,32,78
"19534","1900-1959",2021-03-24,48,3,33,81
"19535","1900-1959",2021-03-25,52,4,40,92
"19536","1900-1959",2021-03-26,55,5,38,93
"19537","1900-1959",2021-03-27,47,6,35,82
"19538","1900-1959",2021-03-28,58,7,43,101
"19539","1900-1959",2021-03-29,58,1,41,99
"19540","1900-1959",2021-03-30,49,2,34,83
"19541","1900-1959",2021-03-31,50,3,36,86
"19542","2000-2059",2021-03-01,24,1,36,60
"19543","2000-2059",2021-03-02,19,2,31,50
"19544","2000-2059",2021-03-03,20,3,31,51
"19545","2000-2059",2021-03-04,25,4,50,75
"19546","2000-2059",2021-03-05,26,5,47,73
"19547","2000-2059",2021-03-06,19,6,40,59
"19548","2000-2059",2021-03-07,30,7,49,79
"19549","2000-2059",2021-03-08,28,1,47,75
"19550","2000-2059",2021-03-09,19,2,43,62
"19551","2000-2059",2021-03-10,21,3,43,64
"19552","2000-2059",2021-03-11,30,4,56,86
"19553","2000-2059",2021-03-12,31,5,54,85
"19554","2000-2059",2021-03-13,29,6,41,70
"19555","2000-2059",2021-03-14,30,7,57,87
"19556","2000-2059",2021-03-15,28,1,54,82
"19557","2000-2059",2021-03-16,22,2,52,74
"19558","2000-2059",2021-03-17,22,3,52,74
"19559","2000-2059",2021-03-18,28,4,62,90
"19560","2000-2059",2021-03-19,27,5,60,87
"19561","2000-2059",2021-03-20,29,6,53,82
"19562","2000-2059",2021-03-21,29,7,62,91
"19563","2000-2059",2021-03-22,27,1,59,86
"19564","2000-2059",2021-03-23,23,2,56,79
"19565","2000-2059",2021-03-24,22,3,57,79
"19566","2000-2059",2021-03-25,28,4,62,90
"19567","2000-2059",2021-03-26,27,5,60,87
"19568","2000-2059",2021-03-27,28,6,53,81
"19569","2000-2059",2021-03-28,30,7,62,92
"19570","2000-2059",2021-03-29,28,1,59,87
"19571","2000-2059",2021-03-30,24,2,56,80
"19572","2000-2059",2021-03-31,23,3,57,80
"19573","2100-2159",2021-03-01,12,1,62,74
"19574","2100-2159",2021-03-02,12,2,47,59
"19575","2100-2159",2021-03-03,11,3,51,62
"19576","2100-2159",2021-03-04,18,4,54,72
"19577","2100-2159",2021-03-05,16,5,61,77
"19578","2100-2159",2021-03-06,13,6,47,60
"19579","2100-2159",2021-03-07,18,7,60,78
"19580","2100-2159",2021-03-08,17,1,62,79
"19581","2100-2159",2021-03-09,16,2,46,62
"19582","2100-2159",2021-03-10,18,3,48,66
"19583","2100-2159",2021-03-11,26,4,53,79
"19584","2100-2159",2021-03-12,23,5,61,84
"19585","2100-2159",2021-03-13,24,6,49,73
"19586","2100-2159",2021-03-14,31,7,55,86
"19587","2100-2159",2021-03-15,30,1,57,87
"19588","2100-2159",2021-03-16,30,2,49,79
"19589","2100-2159",2021-03-17,29,3,47,76
"19590","2100-2159",2021-03-18,35,4,58,93
"19591","2100-2159",2021-03-19,33,5,61,94
"19592","2100-2159",2021-03-20,26,6,53,79
"19593","2100-2159",2021-03-21,35,7,57,92
"19594","2100-2159",2021-03-22,34,1,58,92
"19595","2100-2159",2021-03-23,32,2,49,81
"19596","2100-2159",2021-03-24,33,3,49,82
"19597","2100-2159",2021-03-25,35,4,59,94
"19598","2100-2159",2021-03-26,33,5,61,94
"19599","2100-2159",2021-03-27,26,6,55,81
"19600","2100-2159",2021-03-28,34,7,56,90
"19601","2100-2159",2021-03-29,34,1,56,90
"19602","2100-2159",2021-03-30,32,2,48,80
"19603","2100-2159",2021-03-31,33,3,48,81
"19604","2200-2259",2021-03-01,13,1,39,52
"19605","2200-2259",2021-03-02,10,2,34,44
"19606","2200-2259",2021-03-03,13,3,33,46
"19607","2200-2259",2021-03-04,18,4,53,71
"19608","2200-2259",2021-03-05,19,5,50,69
"19609","2200-2259",2021-03-06,17,6,33,50
"19610","2200-2259",2021-03-07,17,7,50,67
"19611","2200-2259",2021-03-08,17,1,48,65
"19612","2200-2259",2021-03-09,14,2,43,57
"19613","2200-2259",2021-03-10,16,3,41,57
"19614","2200-2259",2021-03-11,21,4,55,76
"19615","2200-2259",2021-03-12,21,5,52,73
"19616","2200-2259",2021-03-13,14,6,45,59
"19617","2200-2259",2021-03-14,17,7,49,66
"19618","2200-2259",2021-03-15,14,1,46,60
"19619","2200-2259",2021-03-16,13,2,43,56
"19620","2200-2259",2021-03-17,14,3,42,56
"19621","2200-2259",2021-03-18,19,4,51,70
"19622","2200-2259",2021-03-19,19,5,47,66
"19623","2200-2259",2021-03-20,17,6,45,62
"19624","2200-2259",2021-03-21,19,7,51,70
"19625","2200-2259",2021-03-22,16,1,49,65
"19626","2200-2259",2021-03-23,15,2,45,60
"19627","2200-2259",2021-03-24,15,3,44,59
"19628","2200-2259",2021-03-25,19,4,50,69
"19629","2200-2259",2021-03-26,19,5,48,67
"19630","2200-2259",2021-03-27,19,6,45,64
"19631","2200-2259",2021-03-28,20,7,59,79
"19632","2200-2259",2021-03-29,16,1,53,69
"19633","2200-2259",2021-03-30,15,2,47,62
"19634","2200-2259",2021-03-31,15,3,47,62
"19635","2300-2359",2021-03-01,17,1,24,41
"19636","2300-2359",2021-03-02,12,2,18,30
"19637","2300-2359",2021-03-03,15,3,18,33
"19638","2300-2359",2021-03-04,18,4,29,47
"19639","2300-2359",2021-03-05,20,5,26,46
"19640","2300-2359",2021-03-06,18,6,19,37
"19641","2300-2359",2021-03-07,19,7,31,50
"19642","2300-2359",2021-03-08,16,1,29,45
"19643","2300-2359",2021-03-09,15,2,19,34
"19644","2300-2359",2021-03-10,17,3,19,36
"19645","2300-2359",2021-03-11,17,4,34,51
"19646","2300-2359",2021-03-12,20,5,31,51
"19647","2300-2359",2021-03-13,17,6,23,40
"19648","2300-2359",2021-03-14,15,7,34,49
"19649","2300-2359",2021-03-15,14,1,32,46
"19650","2300-2359",2021-03-16,13,2,25,38
"19651","2300-2359",2021-03-17,15,3,25,40
"19652","2300-2359",2021-03-18,15,4,36,51
"19653","2300-2359",2021-03-19,16,5,34,50
"19654","2300-2359",2021-03-20,18,6,25,43
"19655","2300-2359",2021-03-21,15,7,36,51
"19656","2300-2359",2021-03-22,14,1,34,48
"19657","2300-2359",2021-03-23,13,2,28,41
"19658","2300-2359",2021-03-24,15,3,28,43
"19659","2300-2359",2021-03-25,15,4,36,51
"19660","2300-2359",2021-03-26,16,5,34,50
"19661","2300-2359",2021-03-27,15,6,23,38
"19662","2300-2359",2021-03-28,16,7,36,52
"19663","2300-2359",2021-03-29,14,1,34,48
"19664","2300-2359",2021-03-30,13,2,28,41
"19665","2300-2359",2021-03-31,14,3,28,42
"19666","0001-0559",2021-04-01,9,4,27,36
"19667","0001-0559",2021-04-02,10,5,31,41
"19668","0001-0559",2021-04-03,13,6,25,38
"19669","0001-0559",2021-04-04,7,7,31,38
"19670","0001-0559",2021-04-05,9,1,26,35
"19671","0001-0559",2021-04-06,9,2,22,31
"19672","0001-0559",2021-04-07,8,3,25,33
"19673","0001-0559",2021-04-08,10,4,29,39
"19674","0001-0559",2021-04-09,10,5,28,38
"19675","0001-0559",2021-04-10,13,6,25,38
"19676","0001-0559",2021-04-11,7,7,29,36
"19677","0001-0559",2021-04-12,9,1,26,35
"19678","0001-0559",2021-04-13,8,2,20,28
"19679","0001-0559",2021-04-14,5,3,17,22
"19680","0001-0559",2021-04-15,6,4,20,26
"19681","0001-0559",2021-04-16,8,5,21,29
"19682","0001-0559",2021-04-17,7,6,18,25
"19683","0001-0559",2021-04-18,4,7,20,24
"19684","0001-0559",2021-04-19,7,1,19,26
"19685","0001-0559",2021-04-20,7,2,15,22
"19686","0001-0559",2021-04-21,5,3,17,22
"19687","0001-0559",2021-04-22,6,4,20,26
"19688","0001-0559",2021-04-23,8,5,21,29
"19689","0001-0559",2021-04-24,7,6,18,25
"19690","0001-0559",2021-04-25,4,7,20,24
"19691","0001-0559",2021-04-26,7,1,19,26
"19692","0001-0559",2021-04-27,7,2,15,22
"19693","0001-0559",2021-04-28,5,3,17,22
"19694","0001-0559",2021-04-29,6,4,20,26
"19695","0001-0559",2021-04-30,8,5,21,29
"19696","0600-0659",2021-04-01,59,4,17,76
"19697","0600-0659",2021-04-02,64,5,15,79
"19698","0600-0659",2021-04-03,49,6,15,64
"19699","0600-0659",2021-04-04,59,7,11,70
"19700","0600-0659",2021-04-05,63,1,12,75
"19701","0600-0659",2021-04-06,59,2,12,71
"19702","0600-0659",2021-04-07,59,3,13,72
"19703","0600-0659",2021-04-08,62,4,15,77
"19704","0600-0659",2021-04-09,62,5,17,79
"19705","0600-0659",2021-04-10,48,6,17,65
"19706","0600-0659",2021-04-11,58,7,13,71
"19707","0600-0659",2021-04-12,52,1,14,66
"19708","0600-0659",2021-04-13,46,2,14,60
"19709","0600-0659",2021-04-14,45,3,13,58
"19710","0600-0659",2021-04-15,52,4,16,68
"19711","0600-0659",2021-04-16,50,5,17,67
"19712","0600-0659",2021-04-17,51,6,16,67
"19713","0600-0659",2021-04-18,48,7,14,62
"19714","0600-0659",2021-04-19,51,1,13,64
"19715","0600-0659",2021-04-20,46,2,14,60
"19716","0600-0659",2021-04-21,45,3,13,58
"19717","0600-0659",2021-04-22,52,4,17,69
"19718","0600-0659",2021-04-23,50,5,17,67
"19719","0600-0659",2021-04-24,51,6,16,67
"19720","0600-0659",2021-04-25,48,7,14,62
"19721","0600-0659",2021-04-26,51,1,13,64
"19722","0600-0659",2021-04-27,46,2,14,60
"19723","0600-0659",2021-04-28,45,3,13,58
"19724","0600-0659",2021-04-29,52,4,16,68
"19725","0600-0659",2021-04-30,47,5,16,63
"19726","0700-0759",2021-04-01,65,4,42,107
"19727","0700-0759",2021-04-02,62,5,44,106
"19728","0700-0759",2021-04-03,65,6,43,108
"19729","0700-0759",2021-04-04,72,7,40,112
"19730","0700-0759",2021-04-05,68,1,41,109
"19731","0700-0759",2021-04-06,58,2,40,98
"19732","0700-0759",2021-04-07,56,3,39,95
"19733","0700-0759",2021-04-08,73,4,41,114
"19734","0700-0759",2021-04-09,70,5,40,110
"19735","0700-0759",2021-04-10,66,6,40,106
"19736","0700-0759",2021-04-11,72,7,39,111
"19737","0700-0759",2021-04-12,75,1,38,113
"19738","0700-0759",2021-04-13,59,2,35,94
"19739","0700-0759",2021-04-14,58,3,33,91
"19740","0700-0759",2021-04-15,76,4,34,110
"19741","0700-0759",2021-04-16,78,5,34,112
"19742","0700-0759",2021-04-17,68,6,35,103
"19743","0700-0759",2021-04-18,74,7,32,106
"19744","0700-0759",2021-04-19,78,1,34,112
"19745","0700-0759",2021-04-20,59,2,33,92
"19746","0700-0759",2021-04-21,58,3,33,91
"19747","0700-0759",2021-04-22,76,4,34,110
"19748","0700-0759",2021-04-23,78,5,34,112
"19749","0700-0759",2021-04-24,68,6,35,103
"19750","0700-0759",2021-04-25,74,7,32,106
"19751","0700-0759",2021-04-26,78,1,34,112
"19752","0700-0759",2021-04-27,59,2,33,92
"19753","0700-0759",2021-04-28,58,3,33,91
"19754","0700-0759",2021-04-29,76,4,34,110
"19755","0700-0759",2021-04-30,76,5,34,110
"19756","0800-0859",2021-04-01,71,4,35,106
"19757","0800-0859",2021-04-02,72,5,38,110
"19758","0800-0859",2021-04-03,68,6,34,102
"19759","0800-0859",2021-04-04,72,7,39,111
"19760","0800-0859",2021-04-05,68,1,42,110
"19761","0800-0859",2021-04-06,63,2,37,100
"19762","0800-0859",2021-04-07,65,3,37,102
"19763","0800-0859",2021-04-08,71,4,43,114
"19764","0800-0859",2021-04-09,69,5,41,110
"19765","0800-0859",2021-04-10,67,6,37,104
"19766","0800-0859",2021-04-11,71,7,39,110
"19767","0800-0859",2021-04-12,67,1,41,108
"19768","0800-0859",2021-04-13,59,2,33,92
"19769","0800-0859",2021-04-14,59,3,33,92
"19770","0800-0859",2021-04-15,70,4,44,114
"19771","0800-0859",2021-04-16,65,5,43,108
"19772","0800-0859",2021-04-17,64,6,41,105
"19773","0800-0859",2021-04-18,69,7,41,110
"19774","0800-0859",2021-04-19,66,1,44,110
"19775","0800-0859",2021-04-20,59,2,33,92
"19776","0800-0859",2021-04-21,59,3,33,92
"19777","0800-0859",2021-04-22,70,4,44,114
"19778","0800-0859",2021-04-23,65,5,43,108
"19779","0800-0859",2021-04-24,64,6,41,105
"19780","0800-0859",2021-04-25,69,7,40,109
"19781","0800-0859",2021-04-26,67,1,43,110
"19782","0800-0859",2021-04-27,59,2,33,92
"19783","0800-0859",2021-04-28,60,3,32,92
"19784","0800-0859",2021-04-29,70,4,43,113
"19785","0800-0859",2021-04-30,63,5,41,104
"19786","0900-0959",2021-04-01,52,4,42,94
"19787","0900-0959",2021-04-02,48,5,45,93
"19788","0900-0959",2021-04-03,46,6,48,94
"19789","0900-0959",2021-04-04,52,7,46,98
"19790","0900-0959",2021-04-05,56,1,45,101
"19791","0900-0959",2021-04-06,51,2,40,91
"19792","0900-0959",2021-04-07,49,3,39,88
"19793","0900-0959",2021-04-08,55,4,47,102
"19794","0900-0959",2021-04-09,56,5,45,101
"19795","0900-0959",2021-04-10,52,6,46,98
"19796","0900-0959",2021-04-11,56,7,46,102
"19797","0900-0959",2021-04-12,58,1,45,103
"19798","0900-0959",2021-04-13,52,2,38,90
"19799","0900-0959",2021-04-14,52,3,38,90
"19800","0900-0959",2021-04-15,56,4,46,102
"19801","0900-0959",2021-04-16,59,5,45,104
"19802","0900-0959",2021-04-17,54,6,45,99
"19803","0900-0959",2021-04-18,56,7,45,101
"19804","0900-0959",2021-04-19,59,1,46,105
"19805","0900-0959",2021-04-20,52,2,40,92
"19806","0900-0959",2021-04-21,53,3,38,91
"19807","0900-0959",2021-04-22,56,4,46,102
"19808","0900-0959",2021-04-23,59,5,45,104
"19809","0900-0959",2021-04-24,54,6,45,99
"19810","0900-0959",2021-04-25,56,7,46,102
"19811","0900-0959",2021-04-26,59,1,47,106
"19812","0900-0959",2021-04-27,52,2,40,92
"19813","0900-0959",2021-04-28,53,3,39,92
"19814","0900-0959",2021-04-29,56,4,47,103
"19815","0900-0959",2021-04-30,56,5,45,101
"19816","1000-1059",2021-04-01,52,4,27,79
"19817","1000-1059",2021-04-02,52,5,31,83
"19818","1000-1059",2021-04-03,51,6,28,79
"19819","1000-1059",2021-04-04,48,7,30,78
"19820","1000-1059",2021-04-05,47,1,32,79
"19821","1000-1059",2021-04-06,43,2,27,70
"19822","1000-1059",2021-04-07,42,3,26,68
"19823","1000-1059",2021-04-08,50,4,32,82
"19824","1000-1059",2021-04-09,48,5,33,81
"19825","1000-1059",2021-04-10,50,6,31,81
"19826","1000-1059",2021-04-11,50,7,33,83
"19827","1000-1059",2021-04-12,49,1,35,84
"19828","1000-1059",2021-04-13,44,2,28,72
"19829","1000-1059",2021-04-14,46,3,27,73
"19830","1000-1059",2021-04-15,56,4,34,90
"19831","1000-1059",2021-04-16,54,5,36,90
"19832","1000-1059",2021-04-17,52,6,31,83
"19833","1000-1059",2021-04-18,55,7,34,89
"19834","1000-1059",2021-04-19,54,1,36,90
"19835","1000-1059",2021-04-20,47,2,29,76
"19836","1000-1059",2021-04-21,46,3,28,74
"19837","1000-1059",2021-04-22,56,4,34,90
"19838","1000-1059",2021-04-23,54,5,36,90
"19839","1000-1059",2021-04-24,52,6,31,83
"19840","1000-1059",2021-04-25,55,7,34,89
"19841","1000-1059",2021-04-26,54,1,36,90
"19842","1000-1059",2021-04-27,47,2,29,76
"19843","1000-1059",2021-04-28,46,3,28,74
"19844","1000-1059",2021-04-29,56,4,34,90
"19845","1000-1059",2021-04-30,48,5,33,81
"19846","1100-1159",2021-04-01,38,4,56,94
"19847","1100-1159",2021-04-02,39,5,55,94
"19848","1100-1159",2021-04-03,34,6,55,89
"19849","1100-1159",2021-04-04,40,7,58,98
"19850","1100-1159",2021-04-05,40,1,55,95
"19851","1100-1159",2021-04-06,31,2,53,84
"19852","1100-1159",2021-04-07,33,3,50,83
"19853","1100-1159",2021-04-08,39,4,55,94
"19854","1100-1159",2021-04-09,40,5,56,96
"19855","1100-1159",2021-04-10,32,6,55,87
"19856","1100-1159",2021-04-11,40,7,56,96
"19857","1100-1159",2021-04-12,43,1,52,95
"19858","1100-1159",2021-04-13,36,2,50,86
"19859","1100-1159",2021-04-14,38,3,50,88
"19860","1100-1159",2021-04-15,40,4,52,92
"19861","1100-1159",2021-04-16,41,5,51,92
"19862","1100-1159",2021-04-17,37,6,55,92
"19863","1100-1159",2021-04-18,42,7,52,94
"19864","1100-1159",2021-04-19,41,1,52,93
"19865","1100-1159",2021-04-20,36,2,51,87
"19866","1100-1159",2021-04-21,38,3,50,88
"19867","1100-1159",2021-04-22,40,4,52,92
"19868","1100-1159",2021-04-23,41,5,51,92
"19869","1100-1159",2021-04-24,37,6,55,92
"19870","1100-1159",2021-04-25,42,7,52,94
"19871","1100-1159",2021-04-26,41,1,52,93
"19872","1100-1159",2021-04-27,36,2,51,87
"19873","1100-1159",2021-04-28,38,3,50,88
"19874","1100-1159",2021-04-29,40,4,52,92
"19875","1100-1159",2021-04-30,40,5,47,87
"19876","1200-1259",2021-04-01,53,4,50,103
"19877","1200-1259",2021-04-02,50,5,45,95
"19878","1200-1259",2021-04-03,42,6,41,83
"19879","1200-1259",2021-04-04,50,7,44,94
"19880","1200-1259",2021-04-05,48,1,44,92
"19881","1200-1259",2021-04-06,35,2,37,72
"19882","1200-1259",2021-04-07,39,3,38,77
"19883","1200-1259",2021-04-08,47,4,44,91
"19884","1200-1259",2021-04-09,51,5,43,94
"19885","1200-1259",2021-04-10,45,6,38,83
"19886","1200-1259",2021-04-11,52,7,44,96
"19887","1200-1259",2021-04-12,48,1,47,95
"19888","1200-1259",2021-04-13,38,2,37,75
"19889","1200-1259",2021-04-14,39,3,38,77
"19890","1200-1259",2021-04-15,46,4,45,91
"19891","1200-1259",2021-04-16,47,5,46,93
"19892","1200-1259",2021-04-17,42,6,43,85
"19893","1200-1259",2021-04-18,48,7,44,92
"19894","1200-1259",2021-04-19,48,1,46,94
"19895","1200-1259",2021-04-20,38,2,37,75
"19896","1200-1259",2021-04-21,39,3,38,77
"19897","1200-1259",2021-04-22,46,4,45,91
"19898","1200-1259",2021-04-23,47,5,46,93
"19899","1200-1259",2021-04-24,42,6,43,85
"19900","1200-1259",2021-04-25,48,7,44,92
"19901","1200-1259",2021-04-26,48,1,46,94
"19902","1200-1259",2021-04-27,38,2,37,75
"19903","1200-1259",2021-04-28,39,3,38,77
"19904","1200-1259",2021-04-29,46,4,45,91
"19905","1200-1259",2021-04-30,46,5,45,91
"19906","1300-1359",2021-04-01,43,4,49,92
"19907","1300-1359",2021-04-02,49,5,48,97
"19908","1300-1359",2021-04-03,45,6,44,89
"19909","1300-1359",2021-04-04,48,7,47,95
"19910","1300-1359",2021-04-05,47,1,50,97
"19911","1300-1359",2021-04-06,42,2,39,81
"19912","1300-1359",2021-04-07,42,3,42,84
"19913","1300-1359",2021-04-08,48,4,47,95
"19914","1300-1359",2021-04-09,47,5,50,97
"19915","1300-1359",2021-04-10,41,6,44,85
"19916","1300-1359",2021-04-11,47,7,47,94
"19917","1300-1359",2021-04-12,46,1,51,97
"19918","1300-1359",2021-04-13,40,2,36,76
"19919","1300-1359",2021-04-14,42,3,37,79
"19920","1300-1359",2021-04-15,49,4,50,99
"19921","1300-1359",2021-04-16,50,5,51,101
"19922","1300-1359",2021-04-17,48,6,45,93
"19923","1300-1359",2021-04-18,48,7,49,97
"19924","1300-1359",2021-04-19,49,1,50,99
"19925","1300-1359",2021-04-20,42,2,36,78
"19926","1300-1359",2021-04-21,42,3,37,79
"19927","1300-1359",2021-04-22,49,4,50,99
"19928","1300-1359",2021-04-23,50,5,51,101
"19929","1300-1359",2021-04-24,48,6,45,93
"19930","1300-1359",2021-04-25,48,7,50,98
"19931","1300-1359",2021-04-26,49,1,50,99
"19932","1300-1359",2021-04-27,43,2,36,79
"19933","1300-1359",2021-04-28,42,3,38,80
"19934","1300-1359",2021-04-29,49,4,50,99
"19935","1300-1359",2021-04-30,47,5,49,96
"19936","1400-1459",2021-04-01,46,4,44,90
"19937","1400-1459",2021-04-02,51,5,46,97
"19938","1400-1459",2021-04-03,43,6,35,78
"19939","1400-1459",2021-04-04,51,7,47,98
"19940","1400-1459",2021-04-05,50,1,42,92
"19941","1400-1459",2021-04-06,42,2,36,78
"19942","1400-1459",2021-04-07,45,3,37,82
"19943","1400-1459",2021-04-08,49,4,43,92
"19944","1400-1459",2021-04-09,54,5,45,99
"19945","1400-1459",2021-04-10,48,6,35,83
"19946","1400-1459",2021-04-11,51,7,46,97
"19947","1400-1459",2021-04-12,52,1,38,90
"19948","1400-1459",2021-04-13,44,2,38,82
"19949","1400-1459",2021-04-14,43,3,39,82
"19950","1400-1459",2021-04-15,50,4,39,89
"19951","1400-1459",2021-04-16,51,5,39,90
"19952","1400-1459",2021-04-17,42,6,38,80
"19953","1400-1459",2021-04-18,50,7,41,91
"19954","1400-1459",2021-04-19,49,1,39,88
"19955","1400-1459",2021-04-20,42,2,37,79
"19956","1400-1459",2021-04-21,43,3,39,82
"19957","1400-1459",2021-04-22,50,4,39,89
"19958","1400-1459",2021-04-23,51,5,39,90
"19959","1400-1459",2021-04-24,42,6,38,80
"19960","1400-1459",2021-04-25,50,7,40,90
"19961","1400-1459",2021-04-26,49,1,39,88
"19962","1400-1459",2021-04-27,42,2,38,80
"19963","1400-1459",2021-04-28,43,3,39,82
"19964","1400-1459",2021-04-29,50,4,39,89
"19965","1400-1459",2021-04-30,49,5,38,87
"19966","1500-1559",2021-04-01,36,4,40,76
"19967","1500-1559",2021-04-02,38,5,40,78
"19968","1500-1559",2021-04-03,35,6,37,72
"19969","1500-1559",2021-04-04,34,7,41,75
"19970","1500-1559",2021-04-05,34,1,38,72
"19971","1500-1559",2021-04-06,27,2,34,61
"19972","1500-1559",2021-04-07,29,3,37,66
"19973","1500-1559",2021-04-08,35,4,42,77
"19974","1500-1559",2021-04-09,35,5,41,76
"19975","1500-1559",2021-04-10,32,6,39,71
"19976","1500-1559",2021-04-11,36,7,42,78
"19977","1500-1559",2021-04-12,37,1,37,74
"19978","1500-1559",2021-04-13,30,2,30,60
"19979","1500-1559",2021-04-14,33,3,32,65
"19980","1500-1559",2021-04-15,39,4,42,81
"19981","1500-1559",2021-04-16,38,5,40,78
"19982","1500-1559",2021-04-17,34,6,34,68
"19983","1500-1559",2021-04-18,40,7,42,82
"19984","1500-1559",2021-04-19,38,1,39,77
"19985","1500-1559",2021-04-20,30,2,31,61
"19986","1500-1559",2021-04-21,33,3,32,65
"19987","1500-1559",2021-04-22,39,4,42,81
"19988","1500-1559",2021-04-23,38,5,40,78
"19989","1500-1559",2021-04-24,34,6,34,68
"19990","1500-1559",2021-04-25,40,7,42,82
"19991","1500-1559",2021-04-26,38,1,39,77
"19992","1500-1559",2021-04-27,30,2,31,61
"19993","1500-1559",2021-04-28,33,3,32,65
"19994","1500-1559",2021-04-29,39,4,42,81
"19995","1500-1559",2021-04-30,36,5,39,75
"19996","1600-1659",2021-04-01,47,4,50,97
"19997","1600-1659",2021-04-02,47,5,51,98
"19998","1600-1659",2021-04-03,42,6,46,88
"19999","1600-1659",2021-04-04,49,7,55,104
"20000","1600-1659",2021-04-05,45,1,54,99
"20001","1600-1659",2021-04-06,40,2,51,91
"20002","1600-1659",2021-04-07,40,3,50,90
"20003","1600-1659",2021-04-08,48,4,55,103
"20004","1600-1659",2021-04-09,47,5,55,102
"20005","1600-1659",2021-04-10,41,6,50,91
"20006","1600-1659",2021-04-11,49,7,56,105
"20007","1600-1659",2021-04-12,47,1,60,107
"20008","1600-1659",2021-04-13,41,2,61,102
"20009","1600-1659",2021-04-14,39,3,60,99
"20010","1600-1659",2021-04-15,48,4,60,108
"20011","1600-1659",2021-04-16,45,5,60,105
"20012","1600-1659",2021-04-17,39,6,56,95
"20013","1600-1659",2021-04-18,48,7,59,107
"20014","1600-1659",2021-04-19,45,1,60,105
"20015","1600-1659",2021-04-20,39,2,60,99
"20016","1600-1659",2021-04-21,39,3,60,99
"20017","1600-1659",2021-04-22,48,4,60,108
"20018","1600-1659",2021-04-23,45,5,60,105
"20019","1600-1659",2021-04-24,39,6,56,95
"20020","1600-1659",2021-04-25,48,7,59,107
"20021","1600-1659",2021-04-26,45,1,61,106
"20022","1600-1659",2021-04-27,39,2,60,99
"20023","1600-1659",2021-04-28,39,3,60,99
"20024","1600-1659",2021-04-29,48,4,60,108
"20025","1600-1659",2021-04-30,45,5,57,102
"20026","1700-1759",2021-04-01,43,4,52,95
"20027","1700-1759",2021-04-02,48,5,57,105
"20028","1700-1759",2021-04-03,35,6,52,87
"20029","1700-1759",2021-04-04,48,7,50,98
"20030","1700-1759",2021-04-05,49,1,52,101
"20031","1700-1759",2021-04-06,39,2,39,78
"20032","1700-1759",2021-04-07,39,3,43,82
"20033","1700-1759",2021-04-08,48,4,51,99
"20034","1700-1759",2021-04-09,50,5,52,102
"20035","1700-1759",2021-04-10,36,6,45,81
"20036","1700-1759",2021-04-11,47,7,52,99
"20037","1700-1759",2021-04-12,47,1,56,103
"20038","1700-1759",2021-04-13,36,2,44,80
"20039","1700-1759",2021-04-14,37,3,48,85
"20040","1700-1759",2021-04-15,48,4,58,106
"20041","1700-1759",2021-04-16,46,5,57,103
"20042","1700-1759",2021-04-17,38,6,44,82
"20043","1700-1759",2021-04-18,47,7,59,106
"20044","1700-1759",2021-04-19,45,1,56,101
"20045","1700-1759",2021-04-20,36,2,43,79
"20046","1700-1759",2021-04-21,37,3,48,85
"20047","1700-1759",2021-04-22,49,4,58,107
"20048","1700-1759",2021-04-23,46,5,57,103
"20049","1700-1759",2021-04-24,38,6,44,82
"20050","1700-1759",2021-04-25,47,7,59,106
"20051","1700-1759",2021-04-26,45,1,56,101
"20052","1700-1759",2021-04-27,36,2,43,79
"20053","1700-1759",2021-04-28,37,3,48,85
"20054","1700-1759",2021-04-29,48,4,58,106
"20055","1700-1759",2021-04-30,43,5,56,99
"20056","1800-1859",2021-04-01,51,4,42,93
"20057","1800-1859",2021-04-02,53,5,44,97
"20058","1800-1859",2021-04-03,49,6,35,84
"20059","1800-1859",2021-04-04,54,7,43,97
"20060","1800-1859",2021-04-05,53,1,45,98
"20061","1800-1859",2021-04-06,48,2,39,87
"20062","1800-1859",2021-04-07,50,3,39,89
"20063","1800-1859",2021-04-08,53,4,43,96
"20064","1800-1859",2021-04-09,52,5,46,98
"20065","1800-1859",2021-04-10,50,6,37,87
"20066","1800-1859",2021-04-11,53,7,44,97
"20067","1800-1859",2021-04-12,56,1,43,99
"20068","1800-1859",2021-04-13,47,2,37,84
"20069","1800-1859",2021-04-14,47,3,36,83
"20070","1800-1859",2021-04-15,56,4,43,99
"20071","1800-1859",2021-04-16,55,5,42,97
"20072","1800-1859",2021-04-17,50,6,35,85
"20073","1800-1859",2021-04-18,56,7,43,99
"20074","1800-1859",2021-04-19,56,1,43,99
"20075","1800-1859",2021-04-20,46,2,38,84
"20076","1800-1859",2021-04-21,47,3,36,83
"20077","1800-1859",2021-04-22,56,4,43,99
"20078","1800-1859",2021-04-23,55,5,42,97
"20079","1800-1859",2021-04-24,50,6,35,85
"20080","1800-1859",2021-04-25,57,7,43,100
"20081","1800-1859",2021-04-26,56,1,43,99
"20082","1800-1859",2021-04-27,46,2,38,84
"20083","1800-1859",2021-04-28,47,3,36,83
"20084","1800-1859",2021-04-29,56,4,43,99
"20085","1800-1859",2021-04-30,53,5,37,90
"20086","1900-1959",2021-04-01,59,4,38,97
"20087","1900-1959",2021-04-02,59,5,41,100
"20088","1900-1959",2021-04-03,49,6,38,87
"20089","1900-1959",2021-04-04,55,7,43,98
"20090","1900-1959",2021-04-05,56,1,40,96
"20091","1900-1959",2021-04-06,47,2,32,79
"20092","1900-1959",2021-04-07,49,3,33,82
"20093","1900-1959",2021-04-08,55,4,40,95
"20094","1900-1959",2021-04-09,56,5,40,96
"20095","1900-1959",2021-04-10,45,6,37,82
"20096","1900-1959",2021-04-11,56,7,42,98
"20097","1900-1959",2021-04-12,51,1,40,91
"20098","1900-1959",2021-04-13,38,2,31,69
"20099","1900-1959",2021-04-14,38,3,33,71
"20100","1900-1959",2021-04-15,47,4,44,91
"20101","1900-1959",2021-04-16,48,5,43,91
"20102","1900-1959",2021-04-17,40,6,40,80
"20103","1900-1959",2021-04-18,48,7,46,94
"20104","1900-1959",2021-04-19,48,1,43,91
"20105","1900-1959",2021-04-20,36,2,33,69
"20106","1900-1959",2021-04-21,38,3,33,71
"20107","1900-1959",2021-04-22,47,4,44,91
"20108","1900-1959",2021-04-23,48,5,43,91
"20109","1900-1959",2021-04-24,40,6,40,80
"20110","1900-1959",2021-04-25,48,7,46,94
"20111","1900-1959",2021-04-26,48,1,43,91
"20112","1900-1959",2021-04-27,36,2,33,69
"20113","1900-1959",2021-04-28,38,3,33,71
"20114","1900-1959",2021-04-29,47,4,44,91
"20115","1900-1959",2021-04-30,47,5,40,87
"20116","2000-2059",2021-04-01,28,4,65,93
"20117","2000-2059",2021-04-02,29,5,65,94
"20118","2000-2059",2021-04-03,27,6,53,80
"20119","2000-2059",2021-04-04,28,7,68,96
"20120","2000-2059",2021-04-05,28,1,67,95
"20121","2000-2059",2021-04-06,24,2,65,89
"20122","2000-2059",2021-04-07,24,3,68,92
"20123","2000-2059",2021-04-08,28,4,72,100
"20124","2000-2059",2021-04-09,28,5,71,99
"20125","2000-2059",2021-04-10,27,6,56,83
"20126","2000-2059",2021-04-11,27,7,71,98
"20127","2000-2059",2021-04-12,37,1,65,102
"20128","2000-2059",2021-04-13,30,2,58,88
"20129","2000-2059",2021-04-14,32,3,57,89
"20130","2000-2059",2021-04-15,39,4,62,101
"20131","2000-2059",2021-04-16,38,5,62,100
"20132","2000-2059",2021-04-17,29,6,53,82
"20133","2000-2059",2021-04-18,38,7,61,99
"20134","2000-2059",2021-04-19,39,1,61,100
"20135","2000-2059",2021-04-20,32,2,56,88
"20136","2000-2059",2021-04-21,32,3,57,89
"20137","2000-2059",2021-04-22,39,4,63,102
"20138","2000-2059",2021-04-23,38,5,62,100
"20139","2000-2059",2021-04-24,29,6,53,82
"20140","2000-2059",2021-04-25,38,7,62,100
"20141","2000-2059",2021-04-26,39,1,61,100
"20142","2000-2059",2021-04-27,32,2,56,88
"20143","2000-2059",2021-04-28,32,3,57,89
"20144","2000-2059",2021-04-29,39,4,62,101
"20145","2000-2059",2021-04-30,34,5,62,96
"20146","2100-2159",2021-04-01,34,4,55,89
"20147","2100-2159",2021-04-02,33,5,60,93
"20148","2100-2159",2021-04-03,23,6,53,76
"20149","2100-2159",2021-04-04,36,7,56,92
"20150","2100-2159",2021-04-05,38,1,57,95
"20151","2100-2159",2021-04-06,34,2,44,78
"20152","2100-2159",2021-04-07,36,3,44,80
"20153","2100-2159",2021-04-08,38,4,55,93
"20154","2100-2159",2021-04-09,36,5,57,93
"20155","2100-2159",2021-04-10,28,6,54,82
"20156","2100-2159",2021-04-11,38,7,54,92
"20157","2100-2159",2021-04-12,32,1,61,93
"20158","2100-2159",2021-04-13,29,2,51,80
"20159","2100-2159",2021-04-14,26,3,50,76
"20160","2100-2159",2021-04-15,30,4,60,90
"20161","2100-2159",2021-04-16,28,5,59,87
"20162","2100-2159",2021-04-17,23,6,56,79
"20163","2100-2159",2021-04-18,30,7,59,89
"20164","2100-2159",2021-04-19,29,1,58,87
"20165","2100-2159",2021-04-20,25,2,50,75
"20166","2100-2159",2021-04-21,26,3,50,76
"20167","2100-2159",2021-04-22,30,4,60,90
"20168","2100-2159",2021-04-23,28,5,59,87
"20169","2100-2159",2021-04-24,23,6,56,79
"20170","2100-2159",2021-04-25,30,7,59,89
"20171","2100-2159",2021-04-26,29,1,58,87
"20172","2100-2159",2021-04-27,25,2,50,75
"20173","2100-2159",2021-04-28,26,3,50,76
"20174","2100-2159",2021-04-29,30,4,60,90
"20175","2100-2159",2021-04-30,28,5,57,85
"20176","2200-2259",2021-04-01,22,4,57,79
"20177","2200-2259",2021-04-02,22,5,57,79
"20178","2200-2259",2021-04-03,19,6,50,69
"20179","2200-2259",2021-04-04,22,7,57,79
"20180","2200-2259",2021-04-05,17,1,56,73
"20181","2200-2259",2021-04-06,15,2,48,63
"20182","2200-2259",2021-04-07,17,3,49,66
"20183","2200-2259",2021-04-08,22,4,57,79
"20184","2200-2259",2021-04-09,21,5,55,76
"20185","2200-2259",2021-04-10,19,6,50,69
"20186","2200-2259",2021-04-11,21,7,58,79
"20187","2200-2259",2021-04-12,18,1,57,75
"20188","2200-2259",2021-04-13,15,2,43,58
"20189","2200-2259",2021-04-14,18,3,44,62
"20190","2200-2259",2021-04-15,22,4,59,81
"20191","2200-2259",2021-04-16,23,5,57,80
"20192","2200-2259",2021-04-17,19,6,44,63
"20193","2200-2259",2021-04-18,22,7,59,81
"20194","2200-2259",2021-04-19,18,1,58,76
"20195","2200-2259",2021-04-20,16,2,42,58
"20196","2200-2259",2021-04-21,18,3,44,62
"20197","2200-2259",2021-04-22,23,4,59,82
"20198","2200-2259",2021-04-23,23,5,57,80
"20199","2200-2259",2021-04-24,19,6,44,63
"20200","2200-2259",2021-04-25,22,7,59,81
"20201","2200-2259",2021-04-26,18,1,58,76
"20202","2200-2259",2021-04-27,16,2,42,58
"20203","2200-2259",2021-04-28,18,3,44,62
"20204","2200-2259",2021-04-29,22,4,59,81
"20205","2200-2259",2021-04-30,22,5,54,76
"20206","2300-2359",2021-04-01,15,4,35,50
"20207","2300-2359",2021-04-02,21,5,34,55
"20208","2300-2359",2021-04-03,20,6,23,43
"20209","2300-2359",2021-04-04,18,7,37,55
"20210","2300-2359",2021-04-05,18,1,36,54
"20211","2300-2359",2021-04-06,18,2,30,48
"20212","2300-2359",2021-04-07,18,3,31,49
"20213","2300-2359",2021-04-08,19,4,39,58
"20214","2300-2359",2021-04-09,19,5,36,55
"20215","2300-2359",2021-04-10,20,6,24,44
"20216","2300-2359",2021-04-11,19,7,39,58
"20217","2300-2359",2021-04-12,19,1,37,56
"20218","2300-2359",2021-04-13,17,2,25,42
"20219","2300-2359",2021-04-14,16,3,28,44
"20220","2300-2359",2021-04-15,18,4,40,58
"20221","2300-2359",2021-04-16,17,5,38,55
"20222","2300-2359",2021-04-17,17,6,25,42
"20223","2300-2359",2021-04-18,17,7,40,57
"20224","2300-2359",2021-04-19,17,1,40,57
"20225","2300-2359",2021-04-20,16,2,26,42
"20226","2300-2359",2021-04-21,16,3,28,44
"20227","2300-2359",2021-04-22,18,4,40,58
"20228","2300-2359",2021-04-23,17,5,38,55
"20229","2300-2359",2021-04-24,17,6,25,42
"20230","2300-2359",2021-04-25,17,7,40,57
"20231","2300-2359",2021-04-26,17,1,40,57
"20232","2300-2359",2021-04-27,16,2,26,42
"20233","2300-2359",2021-04-28,16,3,28,44
"20234","2300-2359",2021-04-29,18,4,40,58
"20235","2300-2359",2021-04-30,17,5,34,51
"20236","0001-0559",2021-05-01,7,6,18,25
"20237","0001-0559",2021-05-02,4,7,19,23
"20238","0001-0559",2021-05-03,7,1,19,26
"20239","0001-0559",2021-05-04,7,2,18,25
"20240","0001-0559",2021-05-05,8,3,24,32
"20241","0001-0559",2021-05-06,11,4,33,44
"20242","0001-0559",2021-05-07,11,5,31,42
"20243","0001-0559",2021-05-08,11,6,26,37
"20244","0001-0559",2021-05-09,17,7,36,53
"20245","0001-0559",2021-05-10,18,1,32,50
"20246","0001-0559",2021-05-11,11,2,22,33
"20247","0001-0559",2021-05-12,11,3,23,34
"20248","0001-0559",2021-05-13,19,4,35,54
"20249","0001-0559",2021-05-14,18,5,33,51
"20250","0001-0559",2021-05-15,11,6,25,36
"20251","0001-0559",2021-05-16,17,7,35,52
"20252","0001-0559",2021-05-17,19,1,31,50
"20253","0001-0559",2021-05-18,11,2,20,31
"20254","0001-0559",2021-05-19,11,3,23,34
"20255","0001-0559",2021-05-20,19,4,38,57
"20256","0001-0559",2021-05-21,18,5,37,55
"20257","0001-0559",2021-05-22,11,6,29,40
"20258","0001-0559",2021-05-23,17,7,38,55
"20259","0001-0559",2021-05-24,18,1,34,52
"20260","0001-0559",2021-05-25,11,2,24,35
"20261","0001-0559",2021-05-26,11,3,26,37
"20262","0001-0559",2021-05-27,19,4,38,57
"20263","0001-0559",2021-05-28,18,5,38,56
"20264","0001-0559",2021-05-29,11,6,27,38
"20265","0001-0559",2021-05-30,17,7,35,52
"20266","0001-0559",2021-05-31,17,1,34,51
"20267","0600-0659",2021-05-01,51,6,16,67
"20268","0600-0659",2021-05-02,48,7,14,62
"20269","0600-0659",2021-05-03,51,1,13,64
"20270","0600-0659",2021-05-04,46,2,12,58
"20271","0600-0659",2021-05-05,46,3,17,63
"20272","0600-0659",2021-05-06,57,4,25,82
"20273","0600-0659",2021-05-07,58,5,25,83
"20274","0600-0659",2021-05-08,59,6,22,81
"20275","0600-0659",2021-05-09,58,7,22,80
"20276","0600-0659",2021-05-10,64,1,25,89
"20277","0600-0659",2021-05-11,52,2,23,75
"20278","0600-0659",2021-05-12,51,3,22,73
"20279","0600-0659",2021-05-13,63,4,26,89
"20280","0600-0659",2021-05-14,63,5,26,89
"20281","0600-0659",2021-05-15,58,6,22,80
"20282","0600-0659",2021-05-16,57,7,22,79
"20283","0600-0659",2021-05-17,62,1,25,87
"20284","0600-0659",2021-05-18,52,2,23,75
"20285","0600-0659",2021-05-19,52,3,22,74
"20286","0600-0659",2021-05-20,67,4,26,93
"20287","0600-0659",2021-05-21,69,5,26,95
"20288","0600-0659",2021-05-22,62,6,22,84
"20289","0600-0659",2021-05-23,64,7,23,87
"20290","0600-0659",2021-05-24,68,1,25,93
"20291","0600-0659",2021-05-25,56,2,23,79
"20292","0600-0659",2021-05-26,56,3,22,78
"20293","0600-0659",2021-05-27,69,4,28,97
"20294","0600-0659",2021-05-28,71,5,27,98
"20295","0600-0659",2021-05-29,64,6,25,89
"20296","0600-0659",2021-05-30,64,7,26,90
"20297","0600-0659",2021-05-31,70,1,25,95
"20298","0700-0759",2021-05-01,67,6,35,102
"20299","0700-0759",2021-05-02,74,7,32,106
"20300","0700-0759",2021-05-03,78,1,34,112
"20301","0700-0759",2021-05-04,59,2,33,92
"20302","0700-0759",2021-05-05,62,3,33,95
"20303","0700-0759",2021-05-06,76,4,41,117
"20304","0700-0759",2021-05-07,81,5,42,123
"20305","0700-0759",2021-05-08,67,6,38,105
"20306","0700-0759",2021-05-09,72,7,53,125
"20307","0700-0759",2021-05-10,77,1,51,128
"20308","0700-0759",2021-05-11,72,2,36,108
"20309","0700-0759",2021-05-12,72,3,36,108
"20310","0700-0759",2021-05-13,73,4,53,126
"20311","0700-0759",2021-05-14,77,5,51,128
"20312","0700-0759",2021-05-15,67,6,37,104
"20313","0700-0759",2021-05-16,72,7,52,124
"20314","0700-0759",2021-05-17,78,1,50,128
"20315","0700-0759",2021-05-18,71,2,35,106
"20316","0700-0759",2021-05-19,71,3,36,107
"20317","0700-0759",2021-05-20,73,4,55,128
"20318","0700-0759",2021-05-21,78,5,53,131
"20319","0700-0759",2021-05-22,68,6,39,107
"20320","0700-0759",2021-05-23,72,7,54,126
"20321","0700-0759",2021-05-24,78,1,52,130
"20322","0700-0759",2021-05-25,72,2,37,109
"20323","0700-0759",2021-05-26,72,3,39,111
"20324","0700-0759",2021-05-27,72,4,57,129
"20325","0700-0759",2021-05-28,78,5,56,134
"20326","0700-0759",2021-05-29,68,6,40,108
"20327","0700-0759",2021-05-30,70,7,55,125
"20328","0700-0759",2021-05-31,75,1,54,129
"20329","0800-0859",2021-05-01,65,6,41,106
"20330","0800-0859",2021-05-02,70,7,40,110
"20331","0800-0859",2021-05-03,67,1,44,111
"20332","0800-0859",2021-05-04,60,2,32,92
"20333","0800-0859",2021-05-05,62,3,33,95
"20334","0800-0859",2021-05-06,76,4,42,118
"20335","0800-0859",2021-05-07,76,5,45,121
"20336","0800-0859",2021-05-08,74,6,42,116
"20337","0800-0859",2021-05-09,77,7,35,112
"20338","0800-0859",2021-05-10,77,1,41,118
"20339","0800-0859",2021-05-11,73,2,44,117
"20340","0800-0859",2021-05-12,75,3,44,119
"20341","0800-0859",2021-05-13,80,4,40,120
"20342","0800-0859",2021-05-14,79,5,41,120
"20343","0800-0859",2021-05-15,75,6,42,117
"20344","0800-0859",2021-05-16,78,7,35,113
"20345","0800-0859",2021-05-17,78,1,41,119
"20346","0800-0859",2021-05-18,74,2,44,118
"20347","0800-0859",2021-05-19,75,3,44,119
"20348","0800-0859",2021-05-20,79,4,41,120
"20349","0800-0859",2021-05-21,78,5,44,122
"20350","0800-0859",2021-05-22,72,6,43,115
"20351","0800-0859",2021-05-23,78,7,39,117
"20352","0800-0859",2021-05-24,77,1,43,120
"20353","0800-0859",2021-05-25,72,2,46,118
"20354","0800-0859",2021-05-26,75,3,46,121
"20355","0800-0859",2021-05-27,79,4,43,122
"20356","0800-0859",2021-05-28,77,5,43,120
"20357","0800-0859",2021-05-29,72,6,46,118
"20358","0800-0859",2021-05-30,76,7,41,117
"20359","0800-0859",2021-05-31,76,1,42,118
"20360","0900-0959",2021-05-01,53,6,46,99
"20361","0900-0959",2021-05-02,56,7,47,103
"20362","0900-0959",2021-05-03,59,1,47,106
"20363","0900-0959",2021-05-04,52,2,42,94
"20364","0900-0959",2021-05-05,54,3,40,94
"20365","0900-0959",2021-05-06,59,4,50,109
"20366","0900-0959",2021-05-07,60,5,48,108
"20367","0900-0959",2021-05-08,58,6,45,103
"20368","0900-0959",2021-05-09,56,7,47,103
"20369","0900-0959",2021-05-10,57,1,46,103
"20370","0900-0959",2021-05-11,59,2,42,101
"20371","0900-0959",2021-05-12,59,3,39,98
"20372","0900-0959",2021-05-13,57,4,48,105
"20373","0900-0959",2021-05-14,56,5,47,103
"20374","0900-0959",2021-05-15,58,6,45,103
"20375","0900-0959",2021-05-16,56,7,47,103
"20376","0900-0959",2021-05-17,57,1,47,104
"20377","0900-0959",2021-05-18,59,2,42,101
"20378","0900-0959",2021-05-19,61,3,39,100
"20379","0900-0959",2021-05-20,62,4,48,110
"20380","0900-0959",2021-05-21,60,5,47,107
"20381","0900-0959",2021-05-22,60,6,44,104
"20382","0900-0959",2021-05-23,61,7,47,108
"20383","0900-0959",2021-05-24,61,1,47,108
"20384","0900-0959",2021-05-25,63,2,42,105
"20385","0900-0959",2021-05-26,62,3,41,103
"20386","0900-0959",2021-05-27,62,4,46,108
"20387","0900-0959",2021-05-28,62,5,48,110
"20388","0900-0959",2021-05-29,59,6,42,101
"20389","0900-0959",2021-05-30,62,7,45,107
"20390","0900-0959",2021-05-31,64,1,46,110
"20391","1000-1059",2021-05-01,52,6,30,82
"20392","1000-1059",2021-05-02,55,7,33,88
"20393","1000-1059",2021-05-03,54,1,36,90
"20394","1000-1059",2021-05-04,47,2,29,76
"20395","1000-1059",2021-05-05,47,3,34,81
"20396","1000-1059",2021-05-06,57,4,40,97
"20397","1000-1059",2021-05-07,58,5,41,99
"20398","1000-1059",2021-05-08,54,6,36,90
"20399","1000-1059",2021-05-09,57,7,39,96
"20400","1000-1059",2021-05-10,56,1,41,97
"20401","1000-1059",2021-05-11,53,2,37,90
"20402","1000-1059",2021-05-12,52,3,40,92
"20403","1000-1059",2021-05-13,57,4,40,97
"20404","1000-1059",2021-05-14,58,5,41,99
"20405","1000-1059",2021-05-15,55,6,37,92
"20406","1000-1059",2021-05-16,58,7,39,97
"20407","1000-1059",2021-05-17,57,1,42,99
"20408","1000-1059",2021-05-18,55,2,37,92
"20409","1000-1059",2021-05-19,53,3,39,92
"20410","1000-1059",2021-05-20,53,4,40,93
"20411","1000-1059",2021-05-21,54,5,41,95
"20412","1000-1059",2021-05-22,50,6,36,86
"20413","1000-1059",2021-05-23,54,7,39,93
"20414","1000-1059",2021-05-24,54,1,42,96
"20415","1000-1059",2021-05-25,51,2,37,88
"20416","1000-1059",2021-05-26,49,3,38,87
"20417","1000-1059",2021-05-27,53,4,37,90
"20418","1000-1059",2021-05-28,54,5,38,92
"20419","1000-1059",2021-05-29,48,6,32,80
"20420","1000-1059",2021-05-30,53,7,33,86
"20421","1000-1059",2021-05-31,52,1,39,91
"20422","1100-1159",2021-05-01,37,6,55,92
"20423","1100-1159",2021-05-02,42,7,52,94
"20424","1100-1159",2021-05-03,41,1,52,93
"20425","1100-1159",2021-05-04,36,2,51,87
"20426","1100-1159",2021-05-05,41,3,49,90
"20427","1100-1159",2021-05-06,45,4,55,100
"20428","1100-1159",2021-05-07,47,5,54,101
"20429","1100-1159",2021-05-08,42,6,58,100
"20430","1100-1159",2021-05-09,46,7,58,104
"20431","1100-1159",2021-05-10,47,1,58,105
"20432","1100-1159",2021-05-11,43,2,53,96
"20433","1100-1159",2021-05-12,42,3,53,95
"20434","1100-1159",2021-05-13,45,4,60,105
"20435","1100-1159",2021-05-14,46,5,57,103
"20436","1100-1159",2021-05-15,42,6,58,100
"20437","1100-1159",2021-05-16,46,7,58,104
"20438","1100-1159",2021-05-17,47,1,58,105
"20439","1100-1159",2021-05-18,44,2,53,97
"20440","1100-1159",2021-05-19,43,3,54,97
"20441","1100-1159",2021-05-20,47,4,56,103
"20442","1100-1159",2021-05-21,46,5,54,100
"20443","1100-1159",2021-05-22,44,6,53,97
"20444","1100-1159",2021-05-23,47,7,53,100
"20445","1100-1159",2021-05-24,48,1,54,102
"20446","1100-1159",2021-05-25,44,2,49,93
"20447","1100-1159",2021-05-26,43,3,48,91
"20448","1100-1159",2021-05-27,46,4,54,100
"20449","1100-1159",2021-05-28,46,5,56,102
"20450","1100-1159",2021-05-29,44,6,54,98
"20451","1100-1159",2021-05-30,45,7,53,98
"20452","1100-1159",2021-05-31,49,1,56,105
"20453","1200-1259",2021-05-01,42,6,42,84
"20454","1200-1259",2021-05-02,48,7,44,92
"20455","1200-1259",2021-05-03,49,1,46,95
"20456","1200-1259",2021-05-04,39,2,37,76
"20457","1200-1259",2021-05-05,44,3,39,83
"20458","1200-1259",2021-05-06,52,4,44,96
"20459","1200-1259",2021-05-07,53,5,47,100
"20460","1200-1259",2021-05-08,50,6,46,96
"20461","1200-1259",2021-05-09,56,7,44,100
"20462","1200-1259",2021-05-10,56,1,46,102
"20463","1200-1259",2021-05-11,46,2,45,91
"20464","1200-1259",2021-05-12,47,3,42,89
"20465","1200-1259",2021-05-13,56,4,46,102
"20466","1200-1259",2021-05-14,56,5,48,104
"20467","1200-1259",2021-05-15,50,6,46,96
"20468","1200-1259",2021-05-16,56,7,46,102
"20469","1200-1259",2021-05-17,56,1,46,102
"20470","1200-1259",2021-05-18,47,2,47,94
"20471","1200-1259",2021-05-19,47,3,43,90
"20472","1200-1259",2021-05-20,55,4,51,106
"20473","1200-1259",2021-05-21,55,5,51,106
"20474","1200-1259",2021-05-22,50,6,48,98
"20475","1200-1259",2021-05-23,54,7,51,105
"20476","1200-1259",2021-05-24,55,1,51,106
"20477","1200-1259",2021-05-25,46,2,51,97
"20478","1200-1259",2021-05-26,47,3,46,93
"20479","1200-1259",2021-05-27,56,4,55,111
"20480","1200-1259",2021-05-28,58,5,54,112
"20481","1200-1259",2021-05-29,51,6,52,103
"20482","1200-1259",2021-05-30,52,7,56,108
"20483","1200-1259",2021-05-31,57,1,54,111
"20484","1300-1359",2021-05-01,48,6,45,93
"20485","1300-1359",2021-05-02,49,7,50,99
"20486","1300-1359",2021-05-03,50,1,50,100
"20487","1300-1359",2021-05-04,42,2,36,78
"20488","1300-1359",2021-05-05,44,3,41,85
"20489","1300-1359",2021-05-06,54,4,50,104
"20490","1300-1359",2021-05-07,56,5,51,107
"20491","1300-1359",2021-05-08,54,6,43,97
"20492","1300-1359",2021-05-09,59,7,49,108
"20493","1300-1359",2021-05-10,60,1,52,112
"20494","1300-1359",2021-05-11,51,2,47,98
"20495","1300-1359",2021-05-12,51,3,47,98
"20496","1300-1359",2021-05-13,62,4,52,114
"20497","1300-1359",2021-05-14,61,5,52,113
"20498","1300-1359",2021-05-15,54,6,43,97
"20499","1300-1359",2021-05-16,61,7,49,110
"20500","1300-1359",2021-05-17,60,1,52,112
"20501","1300-1359",2021-05-18,53,2,49,102
"20502","1300-1359",2021-05-19,54,3,49,103
"20503","1300-1359",2021-05-20,63,4,51,114
"20504","1300-1359",2021-05-21,61,5,51,112
"20505","1300-1359",2021-05-22,52,6,42,94
"20506","1300-1359",2021-05-23,62,7,48,110
"20507","1300-1359",2021-05-24,61,1,52,113
"20508","1300-1359",2021-05-25,54,2,48,102
"20509","1300-1359",2021-05-26,52,3,49,101
"20510","1300-1359",2021-05-27,64,4,50,114
"20511","1300-1359",2021-05-28,64,5,50,114
"20512","1300-1359",2021-05-29,57,6,43,100
"20513","1300-1359",2021-05-30,68,7,47,115
"20514","1300-1359",2021-05-31,65,1,49,114
"20515","1400-1459",2021-05-01,42,6,38,80
"20516","1400-1459",2021-05-02,49,7,40,89
"20517","1400-1459",2021-05-03,49,1,39,88
"20518","1400-1459",2021-05-04,42,2,37,79
"20519","1400-1459",2021-05-05,49,3,40,89
"20520","1400-1459",2021-05-06,54,4,48,102
"20521","1400-1459",2021-05-07,50,5,49,99
"20522","1400-1459",2021-05-08,42,6,49,91
"20523","1400-1459",2021-05-09,48,7,55,103
"20524","1400-1459",2021-05-10,49,1,52,101
"20525","1400-1459",2021-05-11,48,2,45,93
"20526","1400-1459",2021-05-12,48,3,45,93
"20527","1400-1459",2021-05-13,52,4,50,102
"20528","1400-1459",2021-05-14,49,5,53,102
"20529","1400-1459",2021-05-15,42,6,49,91
"20530","1400-1459",2021-05-16,49,7,54,103
"20531","1400-1459",2021-05-17,49,1,52,101
"20532","1400-1459",2021-05-18,48,2,44,92
"20533","1400-1459",2021-05-19,46,3,45,91
"20534","1400-1459",2021-05-20,51,4,56,107
"20535","1400-1459",2021-05-21,48,5,57,105
"20536","1400-1459",2021-05-22,42,6,55,97
"20537","1400-1459",2021-05-23,47,7,60,107
"20538","1400-1459",2021-05-24,47,1,56,103
"20539","1400-1459",2021-05-25,45,2,48,93
"20540","1400-1459",2021-05-26,46,3,48,94
"20541","1400-1459",2021-05-27,50,4,58,108
"20542","1400-1459",2021-05-28,47,5,61,108
"20543","1400-1459",2021-05-29,42,6,56,98
"20544","1400-1459",2021-05-30,43,7,61,104
"20545","1400-1459",2021-05-31,47,1,64,111
"20546","1500-1559",2021-05-01,34,6,33,67
"20547","1500-1559",2021-05-02,40,7,42,82
"20548","1500-1559",2021-05-03,38,1,39,77
"20549","1500-1559",2021-05-04,30,2,32,62
"20550","1500-1559",2021-05-05,32,3,36,68
"20551","1500-1559",2021-05-06,50,4,45,95
"20552","1500-1559",2021-05-07,50,5,45,95
"20553","1500-1559",2021-05-08,46,6,36,82
"20554","1500-1559",2021-05-09,51,7,48,99
"20555","1500-1559",2021-05-10,49,1,48,97
"20556","1500-1559",2021-05-11,46,2,39,85
"20557","1500-1559",2021-05-12,45,3,39,84
"20558","1500-1559",2021-05-13,47,4,49,96
"20559","1500-1559",2021-05-14,48,5,47,95
"20560","1500-1559",2021-05-15,46,6,36,82
"20561","1500-1559",2021-05-16,49,7,49,98
"20562","1500-1559",2021-05-17,49,1,48,97
"20563","1500-1559",2021-05-18,43,2,40,83
"20564","1500-1559",2021-05-19,43,3,40,83
"20565","1500-1559",2021-05-20,49,4,47,96
"20566","1500-1559",2021-05-21,50,5,45,95
"20567","1500-1559",2021-05-22,50,6,34,84
"20568","1500-1559",2021-05-23,52,7,46,98
"20569","1500-1559",2021-05-24,51,1,46,97
"20570","1500-1559",2021-05-25,45,2,38,83
"20571","1500-1559",2021-05-26,47,3,37,84
"20572","1500-1559",2021-05-27,50,4,45,95
"20573","1500-1559",2021-05-28,54,5,43,97
"20574","1500-1559",2021-05-29,49,6,31,80
"20575","1500-1559",2021-05-30,51,7,41,92
"20576","1500-1559",2021-05-31,54,1,42,96
"20577","1600-1659",2021-05-01,39,6,57,96
"20578","1600-1659",2021-05-02,48,7,60,108
"20579","1600-1659",2021-05-03,45,1,60,105
"20580","1600-1659",2021-05-04,40,2,60,100
"20581","1600-1659",2021-05-05,45,3,61,106
"20582","1600-1659",2021-05-06,49,4,69,118
"20583","1600-1659",2021-05-07,48,5,69,117
"20584","1600-1659",2021-05-08,43,6,65,108
"20585","1600-1659",2021-05-09,54,7,65,119
"20586","1600-1659",2021-05-10,53,1,65,118
"20587","1600-1659",2021-05-11,39,2,65,104
"20588","1600-1659",2021-05-12,41,3,65,106
"20589","1600-1659",2021-05-13,56,4,65,121
"20590","1600-1659",2021-05-14,55,5,65,120
"20591","1600-1659",2021-05-15,44,6,65,109
"20592","1600-1659",2021-05-16,57,7,65,122
"20593","1600-1659",2021-05-17,54,1,65,119
"20594","1600-1659",2021-05-18,43,2,65,108
"20595","1600-1659",2021-05-19,43,3,65,108
"20596","1600-1659",2021-05-20,55,4,63,118
"20597","1600-1659",2021-05-21,55,5,63,118
"20598","1600-1659",2021-05-22,43,6,64,107
"20599","1600-1659",2021-05-23,57,7,63,120
"20600","1600-1659",2021-05-24,54,1,63,117
"20601","1600-1659",2021-05-25,42,2,62,104
"20602","1600-1659",2021-05-26,43,3,65,108
"20603","1600-1659",2021-05-27,54,4,66,120
"20604","1600-1659",2021-05-28,55,5,68,123
"20605","1600-1659",2021-05-29,43,6,67,110
"20606","1600-1659",2021-05-30,54,7,65,119
"20607","1600-1659",2021-05-31,53,1,68,121
"20608","1700-1759",2021-05-01,37,6,44,81
"20609","1700-1759",2021-05-02,47,7,59,106
"20610","1700-1759",2021-05-03,44,1,56,100
"20611","1700-1759",2021-05-04,35,2,44,79
"20612","1700-1759",2021-05-05,42,3,49,91
"20613","1700-1759",2021-05-06,55,4,63,118
"20614","1700-1759",2021-05-07,54,5,62,116
"20615","1700-1759",2021-05-08,47,6,56,103
"20616","1700-1759",2021-05-09,50,7,65,115
"20617","1700-1759",2021-05-10,51,1,65,116
"20618","1700-1759",2021-05-11,51,2,51,102
"20619","1700-1759",2021-05-12,49,3,51,100
"20620","1700-1759",2021-05-13,51,4,66,117
"20621","1700-1759",2021-05-14,49,5,67,116
"20622","1700-1759",2021-05-15,46,6,57,103
"20623","1700-1759",2021-05-16,48,7,65,113
"20624","1700-1759",2021-05-17,49,1,66,115
"20625","1700-1759",2021-05-18,50,2,50,100
"20626","1700-1759",2021-05-19,49,3,51,100
"20627","1700-1759",2021-05-20,53,4,69,122
"20628","1700-1759",2021-05-21,51,5,70,121
"20629","1700-1759",2021-05-22,49,6,61,110
"20630","1700-1759",2021-05-23,51,7,71,122
"20631","1700-1759",2021-05-24,51,1,69,120
"20632","1700-1759",2021-05-25,52,2,52,104
"20633","1700-1759",2021-05-26,51,3,53,104
"20634","1700-1759",2021-05-27,52,4,68,120
"20635","1700-1759",2021-05-28,55,5,69,124
"20636","1700-1759",2021-05-29,53,6,61,114
"20637","1700-1759",2021-05-30,50,7,67,117
"20638","1700-1759",2021-05-31,54,1,67,121
"20639","1800-1859",2021-05-01,51,6,35,86
"20640","1800-1859",2021-05-02,57,7,43,100
"20641","1800-1859",2021-05-03,56,1,42,98
"20642","1800-1859",2021-05-04,49,2,37,86
"20643","1800-1859",2021-05-05,53,3,39,92
"20644","1800-1859",2021-05-06,66,4,43,109
"20645","1800-1859",2021-05-07,65,5,44,109
"20646","1800-1859",2021-05-08,67,6,43,110
"20647","1800-1859",2021-05-09,70,7,43,113
"20648","1800-1859",2021-05-10,67,1,46,113
"20649","1800-1859",2021-05-11,57,2,41,98
"20650","1800-1859",2021-05-12,58,3,43,101
"20651","1800-1859",2021-05-13,69,4,46,115
"20652","1800-1859",2021-05-14,69,5,46,115
"20653","1800-1859",2021-05-15,68,6,44,112
"20654","1800-1859",2021-05-16,70,7,45,115
"20655","1800-1859",2021-05-17,68,1,47,115
"20656","1800-1859",2021-05-18,57,2,43,100
"20657","1800-1859",2021-05-19,57,3,43,100
"20658","1800-1859",2021-05-20,70,4,44,114
"20659","1800-1859",2021-05-21,70,5,43,113
"20660","1800-1859",2021-05-22,68,6,42,110
"20661","1800-1859",2021-05-23,70,7,42,112
"20662","1800-1859",2021-05-24,68,1,45,113
"20663","1800-1859",2021-05-25,57,2,41,98
"20664","1800-1859",2021-05-26,58,3,44,102
"20665","1800-1859",2021-05-27,73,4,47,120
"20666","1800-1859",2021-05-28,71,5,47,118
"20667","1800-1859",2021-05-29,68,6,43,111
"20668","1800-1859",2021-05-30,69,7,48,117
"20669","1800-1859",2021-05-31,68,1,48,116
"20670","1900-1959",2021-05-01,41,6,40,81
"20671","1900-1959",2021-05-02,48,7,46,94
"20672","1900-1959",2021-05-03,48,1,45,93
"20673","1900-1959",2021-05-04,36,2,34,70
"20674","1900-1959",2021-05-05,38,3,44,82
"20675","1900-1959",2021-05-06,48,4,48,96
"20676","1900-1959",2021-05-07,47,5,48,95
"20677","1900-1959",2021-05-08,40,6,42,82
"20678","1900-1959",2021-05-09,49,7,51,100
"20679","1900-1959",2021-05-10,48,1,48,96
"20680","1900-1959",2021-05-11,38,2,45,83
"20681","1900-1959",2021-05-12,38,3,46,84
"20682","1900-1959",2021-05-13,48,4,49,97
"20683","1900-1959",2021-05-14,47,5,49,96
"20684","1900-1959",2021-05-15,41,6,43,84
"20685","1900-1959",2021-05-16,50,7,50,100
"20686","1900-1959",2021-05-17,48,1,48,96
"20687","1900-1959",2021-05-18,39,2,45,84
"20688","1900-1959",2021-05-19,39,3,46,85
"20689","1900-1959",2021-05-20,51,4,49,100
"20690","1900-1959",2021-05-21,50,5,51,101
"20691","1900-1959",2021-05-22,43,6,43,86
"20692","1900-1959",2021-05-23,52,7,51,103
"20693","1900-1959",2021-05-24,51,1,49,100
"20694","1900-1959",2021-05-25,41,2,46,87
"20695","1900-1959",2021-05-26,43,3,47,90
"20696","1900-1959",2021-05-27,49,4,48,97
"20697","1900-1959",2021-05-28,51,5,52,103
"20698","1900-1959",2021-05-29,44,6,46,90
"20699","1900-1959",2021-05-30,46,7,47,93
"20700","1900-1959",2021-05-31,51,1,50,101
"20701","2000-2059",2021-05-01,28,6,52,80
"20702","2000-2059",2021-05-02,38,7,61,99
"20703","2000-2059",2021-05-03,39,1,60,99
"20704","2000-2059",2021-05-04,28,2,55,83
"20705","2000-2059",2021-05-05,35,3,58,93
"20706","2000-2059",2021-05-06,43,4,68,111
"20707","2000-2059",2021-05-07,42,5,66,108
"20708","2000-2059",2021-05-08,34,6,61,95
"20709","2000-2059",2021-05-09,41,7,65,106
"20710","2000-2059",2021-05-10,40,1,66,106
"20711","2000-2059",2021-05-11,39,2,60,99
"20712","2000-2059",2021-05-12,41,3,59,100
"20713","2000-2059",2021-05-13,42,4,68,110
"20714","2000-2059",2021-05-14,40,5,66,106
"20715","2000-2059",2021-05-15,34,6,61,95
"20716","2000-2059",2021-05-16,41,7,67,108
"20717","2000-2059",2021-05-17,40,1,66,106
"20718","2000-2059",2021-05-18,39,2,60,99
"20719","2000-2059",2021-05-19,42,3,60,102
"20720","2000-2059",2021-05-20,42,4,72,114
"20721","2000-2059",2021-05-21,40,5,69,109
"20722","2000-2059",2021-05-22,35,6,65,100
"20723","2000-2059",2021-05-23,42,7,70,112
"20724","2000-2059",2021-05-24,39,1,67,106
"20725","2000-2059",2021-05-25,38,2,61,99
"20726","2000-2059",2021-05-26,38,3,61,99
"20727","2000-2059",2021-05-27,43,4,70,113
"20728","2000-2059",2021-05-28,42,5,68,110
"20729","2000-2059",2021-05-29,36,6,61,97
"20730","2000-2059",2021-05-30,39,7,65,104
"20731","2000-2059",2021-05-31,42,1,67,109
"20732","2100-2159",2021-05-01,23,6,57,80
"20733","2100-2159",2021-05-02,29,7,59,88
"20734","2100-2159",2021-05-03,29,1,58,87
"20735","2100-2159",2021-05-04,28,2,50,78
"20736","2100-2159",2021-05-05,30,3,49,79
"20737","2100-2159",2021-05-06,41,4,65,106
"20738","2100-2159",2021-05-07,37,5,65,102
"20739","2100-2159",2021-05-08,29,6,63,92
"20740","2100-2159",2021-05-09,46,7,62,108
"20741","2100-2159",2021-05-10,45,1,60,105
"20742","2100-2159",2021-05-11,33,2,61,94
"20743","2100-2159",2021-05-12,33,3,62,95
"20744","2100-2159",2021-05-13,47,4,61,108
"20745","2100-2159",2021-05-14,43,5,59,102
"20746","2100-2159",2021-05-15,29,6,63,92
"20747","2100-2159",2021-05-16,46,7,62,108
"20748","2100-2159",2021-05-17,45,1,59,104
"20749","2100-2159",2021-05-18,33,2,63,96
"20750","2100-2159",2021-05-19,33,3,61,94
"20751","2100-2159",2021-05-20,48,4,61,109
"20752","2100-2159",2021-05-21,45,5,59,104
"20753","2100-2159",2021-05-22,30,6,62,92
"20754","2100-2159",2021-05-23,47,7,62,109
"20755","2100-2159",2021-05-24,46,1,60,106
"20756","2100-2159",2021-05-25,34,2,62,96
"20757","2100-2159",2021-05-26,34,3,61,95
"20758","2100-2159",2021-05-27,48,4,62,110
"20759","2100-2159",2021-05-28,46,5,60,106
"20760","2100-2159",2021-05-29,28,6,64,92
"20761","2100-2159",2021-05-30,44,7,61,105
"20762","2100-2159",2021-05-31,47,1,60,107
"20763","2200-2259",2021-05-01,19,6,43,62
"20764","2200-2259",2021-05-02,22,7,60,82
"20765","2200-2259",2021-05-03,18,1,60,78
"20766","2200-2259",2021-05-04,16,2,41,57
"20767","2200-2259",2021-05-05,20,3,50,70
"20768","2200-2259",2021-05-06,29,4,62,91
"20769","2200-2259",2021-05-07,28,5,59,87
"20770","2200-2259",2021-05-08,22,6,45,67
"20771","2200-2259",2021-05-09,30,7,68,98
"20772","2200-2259",2021-05-10,27,1,67,94
"20773","2200-2259",2021-05-11,25,2,53,78
"20774","2200-2259",2021-05-12,26,3,53,79
"20775","2200-2259",2021-05-13,30,4,68,98
"20776","2200-2259",2021-05-14,29,5,64,93
"20777","2200-2259",2021-05-15,22,6,45,67
"20778","2200-2259",2021-05-16,30,7,68,98
"20779","2200-2259",2021-05-17,27,1,67,94
"20780","2200-2259",2021-05-18,25,2,55,80
"20781","2200-2259",2021-05-19,26,3,55,81
"20782","2200-2259",2021-05-20,32,4,68,100
"20783","2200-2259",2021-05-21,31,5,65,96
"20784","2200-2259",2021-05-22,24,6,46,70
"20785","2200-2259",2021-05-23,31,7,68,99
"20786","2200-2259",2021-05-24,29,1,66,95
"20787","2200-2259",2021-05-25,27,2,54,81
"20788","2200-2259",2021-05-26,28,3,53,81
"20789","2200-2259",2021-05-27,34,4,68,102
"20790","2200-2259",2021-05-28,34,5,70,104
"20791","2200-2259",2021-05-29,25,6,48,73
"20792","2200-2259",2021-05-30,31,7,61,92
"20793","2200-2259",2021-05-31,30,1,71,101
"20794","2300-2359",2021-05-01,17,6,26,43
"20795","2300-2359",2021-05-02,17,7,40,57
"20796","2300-2359",2021-05-03,17,1,39,56
"20797","2300-2359",2021-05-04,16,2,28,44
"20798","2300-2359",2021-05-05,18,3,34,52
"20799","2300-2359",2021-05-06,22,4,53,75
"20800","2300-2359",2021-05-07,20,5,50,70
"20801","2300-2359",2021-05-08,14,6,37,51
"20802","2300-2359",2021-05-09,21,7,53,74
"20803","2300-2359",2021-05-10,19,1,51,70
"20804","2300-2359",2021-05-11,17,2,44,61
"20805","2300-2359",2021-05-12,15,3,45,60
"20806","2300-2359",2021-05-13,21,4,53,74
"20807","2300-2359",2021-05-14,19,5,50,69
"20808","2300-2359",2021-05-15,13,6,37,50
"20809","2300-2359",2021-05-16,20,7,53,73
"20810","2300-2359",2021-05-17,18,1,51,69
"20811","2300-2359",2021-05-18,16,2,44,60
"20812","2300-2359",2021-05-19,15,3,45,60
"20813","2300-2359",2021-05-20,21,4,55,76
"20814","2300-2359",2021-05-21,20,5,53,73
"20815","2300-2359",2021-05-22,13,6,38,51
"20816","2300-2359",2021-05-23,21,7,54,75
"20817","2300-2359",2021-05-24,18,1,53,71
"20818","2300-2359",2021-05-25,16,2,45,61
"20819","2300-2359",2021-05-26,16,3,47,63
"20820","2300-2359",2021-05-27,22,4,55,77
"20821","2300-2359",2021-05-28,20,5,55,75
"20822","2300-2359",2021-05-29,13,6,37,50
"20823","2300-2359",2021-05-30,20,7,47,67
"20824","2300-2359",2021-05-31,19,1,54,73
"20825","0001-0559",2021-06-01,18,2,27,45
"20826","0001-0559",2021-06-02,18,3,29,47
"20827","0001-0559",2021-06-03,15,4,32,47
"20828","0001-0559",2021-06-04,14,5,37,51
"20829","0001-0559",2021-06-05,8,6,30,38
"20830","0001-0559",2021-06-06,10,7,40,50
"20831","0001-0559",2021-06-07,14,1,36,50
"20832","0001-0559",2021-06-08,12,2,25,37
"20833","0001-0559",2021-06-09,12,3,30,42
"20834","0001-0559",2021-06-10,15,4,46,61
"20835","0001-0559",2021-06-11,16,5,46,62
"20836","0001-0559",2021-06-12,16,6,32,48
"20837","0001-0559",2021-06-13,10,7,44,54
"20838","0001-0559",2021-06-14,16,1,42,58
"20839","0001-0559",2021-06-15,14,2,31,45
"20840","0001-0559",2021-06-16,13,3,32,45
"20841","0001-0559",2021-06-17,15,4,45,60
"20842","0001-0559",2021-06-18,16,5,46,62
"20843","0001-0559",2021-06-19,17,6,31,48
"20844","0001-0559",2021-06-20,11,7,43,54
"20845","0001-0559",2021-06-21,17,1,42,59
"20846","0001-0559",2021-06-22,14,2,31,45
"20847","0001-0559",2021-06-23,13,3,32,45
"20848","0001-0559",2021-06-24,15,4,46,61
"20849","0001-0559",2021-06-25,17,5,46,63
"20850","0001-0559",2021-06-26,17,6,31,48
"20851","0001-0559",2021-06-27,12,7,43,55
"20852","0001-0559",2021-06-28,17,1,42,59
"20853","0001-0559",2021-06-29,14,2,30,44
"20854","0001-0559",2021-06-30,13,3,32,45
"20855","0600-0659",2021-06-01,64,2,25,89
"20856","0600-0659",2021-06-02,64,3,24,88
"20857","0600-0659",2021-06-03,70,4,34,104
"20858","0600-0659",2021-06-04,76,5,33,109
"20859","0600-0659",2021-06-05,69,6,28,97
"20860","0600-0659",2021-06-06,71,7,33,104
"20861","0600-0659",2021-06-07,74,1,33,107
"20862","0600-0659",2021-06-08,66,2,24,90
"20863","0600-0659",2021-06-09,66,3,25,91
"20864","0600-0659",2021-06-10,73,4,33,106
"20865","0600-0659",2021-06-11,72,5,35,107
"20866","0600-0659",2021-06-12,67,6,30,97
"20867","0600-0659",2021-06-13,72,7,32,104
"20868","0600-0659",2021-06-14,72,1,34,106
"20869","0600-0659",2021-06-15,70,2,26,96
"20870","0600-0659",2021-06-16,70,3,28,98
"20871","0600-0659",2021-06-17,74,4,33,107
"20872","0600-0659",2021-06-18,74,5,35,109
"20873","0600-0659",2021-06-19,68,6,31,99
"20874","0600-0659",2021-06-20,73,7,32,105
"20875","0600-0659",2021-06-21,73,1,35,108
"20876","0600-0659",2021-06-22,72,2,26,98
"20877","0600-0659",2021-06-23,71,3,28,99
"20878","0600-0659",2021-06-24,74,4,33,107
"20879","0600-0659",2021-06-25,75,5,36,111
"20880","0600-0659",2021-06-26,69,6,31,100
"20881","0600-0659",2021-06-27,74,7,33,107
"20882","0600-0659",2021-06-28,74,1,35,109
"20883","0600-0659",2021-06-29,73,2,26,99
"20884","0600-0659",2021-06-30,71,3,27,98
"20885","0700-0759",2021-06-01,69,2,49,118
"20886","0700-0759",2021-06-02,69,3,49,118
"20887","0700-0759",2021-06-03,82,4,56,138
"20888","0700-0759",2021-06-04,90,5,57,147
"20889","0700-0759",2021-06-05,87,6,43,130
"20890","0700-0759",2021-06-06,90,7,48,138
"20891","0700-0759",2021-06-07,97,1,48,145
"20892","0700-0759",2021-06-08,91,2,49,140
"20893","0700-0759",2021-06-09,91,3,48,139
"20894","0700-0759",2021-06-10,96,4,52,148
"20895","0700-0759",2021-06-11,96,5,48,144
"20896","0700-0759",2021-06-12,87,6,49,136
"20897","0700-0759",2021-06-13,90,7,48,138
"20898","0700-0759",2021-06-14,96,1,47,143
"20899","0700-0759",2021-06-15,90,2,50,140
"20900","0700-0759",2021-06-16,89,3,49,138
"20901","0700-0759",2021-06-17,94,4,53,147
"20902","0700-0759",2021-06-18,93,5,49,142
"20903","0700-0759",2021-06-19,87,6,50,137
"20904","0700-0759",2021-06-20,90,7,49,139
"20905","0700-0759",2021-06-21,94,1,48,142
"20906","0700-0759",2021-06-22,87,2,50,137
"20907","0700-0759",2021-06-23,86,3,49,135
"20908","0700-0759",2021-06-24,94,4,53,147
"20909","0700-0759",2021-06-25,94,5,49,143
"20910","0700-0759",2021-06-26,87,6,50,137
"20911","0700-0759",2021-06-27,89,7,50,139
"20912","0700-0759",2021-06-28,95,1,48,143
"20913","0700-0759",2021-06-29,89,2,50,139
"20914","0700-0759",2021-06-30,87,3,50,137
"20915","0800-0859",2021-06-01,73,2,41,114
"20916","0800-0859",2021-06-02,77,3,40,117
"20917","0800-0859",2021-06-03,81,4,45,126
"20918","0800-0859",2021-06-04,82,5,48,130
"20919","0800-0859",2021-06-05,69,6,52,121
"20920","0800-0859",2021-06-06,76,7,49,125
"20921","0800-0859",2021-06-07,79,1,55,134
"20922","0800-0859",2021-06-08,79,2,53,132
"20923","0800-0859",2021-06-09,81,3,53,134
"20924","0800-0859",2021-06-10,80,4,59,139
"20925","0800-0859",2021-06-11,79,5,60,139
"20926","0800-0859",2021-06-12,69,6,50,119
"20927","0800-0859",2021-06-13,79,7,53,132
"20928","0800-0859",2021-06-14,80,1,59,139
"20929","0800-0859",2021-06-15,80,2,58,138
"20930","0800-0859",2021-06-16,82,3,56,138
"20931","0800-0859",2021-06-17,80,4,56,136
"20932","0800-0859",2021-06-18,82,5,58,140
"20933","0800-0859",2021-06-19,69,6,48,117
"20934","0800-0859",2021-06-20,82,7,51,133
"20935","0800-0859",2021-06-21,81,1,56,137
"20936","0800-0859",2021-06-22,81,2,56,137
"20937","0800-0859",2021-06-23,83,3,54,137
"20938","0800-0859",2021-06-24,82,4,56,138
"20939","0800-0859",2021-06-25,82,5,60,142
"20940","0800-0859",2021-06-26,70,6,49,119
"20941","0800-0859",2021-06-27,84,7,49,133
"20942","0800-0859",2021-06-28,84,1,57,141
"20943","0800-0859",2021-06-29,84,2,57,141
"20944","0800-0859",2021-06-30,86,3,54,140
"20945","0900-0959",2021-06-01,63,2,44,107
"20946","0900-0959",2021-06-02,60,3,40,100
"20947","0900-0959",2021-06-03,62,4,55,117
"20948","0900-0959",2021-06-04,67,5,56,123
"20949","0900-0959",2021-06-05,70,6,56,126
"20950","0900-0959",2021-06-06,70,7,61,131
"20951","0900-0959",2021-06-07,78,1,59,137
"20952","0900-0959",2021-06-08,79,2,56,135
"20953","0900-0959",2021-06-09,77,3,55,132
"20954","0900-0959",2021-06-10,80,4,59,139
"20955","0900-0959",2021-06-11,82,5,59,141
"20956","0900-0959",2021-06-12,73,6,57,130
"20957","0900-0959",2021-06-13,72,7,62,134
"20958","0900-0959",2021-06-14,82,1,59,141
"20959","0900-0959",2021-06-15,81,2,58,139
"20960","0900-0959",2021-06-16,79,3,56,135
"20961","0900-0959",2021-06-17,81,4,58,139
"20962","0900-0959",2021-06-18,83,5,59,142
"20963","0900-0959",2021-06-19,78,6,58,136
"20964","0900-0959",2021-06-20,75,7,63,138
"20965","0900-0959",2021-06-21,84,1,59,143
"20966","0900-0959",2021-06-22,82,2,57,139
"20967","0900-0959",2021-06-23,80,3,54,134
"20968","0900-0959",2021-06-24,82,4,58,140
"20969","0900-0959",2021-06-25,85,5,59,144
"20970","0900-0959",2021-06-26,79,6,58,137
"20971","0900-0959",2021-06-27,72,7,63,135
"20972","0900-0959",2021-06-28,85,1,60,145
"20973","0900-0959",2021-06-29,83,2,59,142
"20974","0900-0959",2021-06-30,80,3,55,135
"20975","1000-1059",2021-06-01,51,2,33,84
"20976","1000-1059",2021-06-02,50,3,36,86
"20977","1000-1059",2021-06-03,66,4,36,102
"20978","1000-1059",2021-06-04,68,5,41,109
"20979","1000-1059",2021-06-05,58,6,36,94
"20980","1000-1059",2021-06-06,68,7,41,109
"20981","1000-1059",2021-06-07,71,1,47,118
"20982","1000-1059",2021-06-08,64,2,43,107
"20983","1000-1059",2021-06-09,63,3,43,106
"20984","1000-1059",2021-06-10,66,4,44,110
"20985","1000-1059",2021-06-11,66,5,46,112
"20986","1000-1059",2021-06-12,52,6,42,94
"20987","1000-1059",2021-06-13,64,7,41,105
"20988","1000-1059",2021-06-14,67,1,47,114
"20989","1000-1059",2021-06-15,60,2,45,105
"20990","1000-1059",2021-06-16,60,3,44,104
"20991","1000-1059",2021-06-17,64,4,48,112
"20992","1000-1059",2021-06-18,64,5,49,113
"20993","1000-1059",2021-06-19,50,6,46,96
"20994","1000-1059",2021-06-20,62,7,46,108
"20995","1000-1059",2021-06-21,64,1,50,114
"20996","1000-1059",2021-06-22,58,2,49,107
"20997","1000-1059",2021-06-23,56,3,48,104
"20998","1000-1059",2021-06-24,64,4,49,113
"20999","1000-1059",2021-06-25,64,5,50,114
"21000","1000-1059",2021-06-26,50,6,46,96
"21001","1000-1059",2021-06-27,62,7,46,108
"21002","1000-1059",2021-06-28,64,1,51,115
"21003","1000-1059",2021-06-29,59,2,50,109
"21004","1000-1059",2021-06-30,56,3,49,105
"21005","1100-1159",2021-06-01,44,2,57,101
"21006","1100-1159",2021-06-02,43,3,57,100
"21007","1100-1159",2021-06-03,47,4,52,99
"21008","1100-1159",2021-06-04,48,5,59,107
"21009","1100-1159",2021-06-05,50,6,57,107
"21010","1100-1159",2021-06-06,56,7,50,106
"21011","1100-1159",2021-06-07,57,1,59,116
"21012","1100-1159",2021-06-08,57,2,57,114
"21013","1100-1159",2021-06-09,56,3,57,113
"21014","1100-1159",2021-06-10,57,4,56,113
"21015","1100-1159",2021-06-11,60,5,58,118
"21016","1100-1159",2021-06-12,51,6,51,102
"21017","1100-1159",2021-06-13,56,7,48,104
"21018","1100-1159",2021-06-14,58,1,58,116
"21019","1100-1159",2021-06-15,59,2,55,114
"21020","1100-1159",2021-06-16,59,3,57,116
"21021","1100-1159",2021-06-17,59,4,58,117
"21022","1100-1159",2021-06-18,63,5,61,124
"21023","1100-1159",2021-06-19,50,6,54,104
"21024","1100-1159",2021-06-20,56,7,51,107
"21025","1100-1159",2021-06-21,60,1,60,120
"21026","1100-1159",2021-06-22,62,2,57,119
"21027","1100-1159",2021-06-23,60,3,56,116
"21028","1100-1159",2021-06-24,59,4,58,117
"21029","1100-1159",2021-06-25,62,5,60,122
"21030","1100-1159",2021-06-26,50,6,54,104
"21031","1100-1159",2021-06-27,58,7,51,109
"21032","1100-1159",2021-06-28,62,1,61,123
"21033","1100-1159",2021-06-29,65,2,58,123
"21034","1100-1159",2021-06-30,62,3,57,119
"21035","1200-1259",2021-06-01,50,2,52,102
"21036","1200-1259",2021-06-02,53,3,49,102
"21037","1200-1259",2021-06-03,63,4,68,131
"21038","1200-1259",2021-06-04,66,5,64,130
"21039","1200-1259",2021-06-05,64,6,64,128
"21040","1200-1259",2021-06-06,60,7,72,132
"21041","1200-1259",2021-06-07,67,1,67,134
"21042","1200-1259",2021-06-08,59,2,65,124
"21043","1200-1259",2021-06-09,60,3,66,126
"21044","1200-1259",2021-06-10,62,4,67,129
"21045","1200-1259",2021-06-11,63,5,65,128
"21046","1200-1259",2021-06-12,60,6,58,118
"21047","1200-1259",2021-06-13,57,7,69,126
"21048","1200-1259",2021-06-14,64,1,66,130
"21049","1200-1259",2021-06-15,56,2,61,117
"21050","1200-1259",2021-06-16,61,3,63,124
"21051","1200-1259",2021-06-17,60,4,64,124
"21052","1200-1259",2021-06-18,61,5,63,124
"21053","1200-1259",2021-06-19,58,6,55,113
"21054","1200-1259",2021-06-20,56,7,66,122
"21055","1200-1259",2021-06-21,61,1,63,124
"21056","1200-1259",2021-06-22,54,2,58,112
"21057","1200-1259",2021-06-23,58,3,60,118
"21058","1200-1259",2021-06-24,60,4,65,125
"21059","1200-1259",2021-06-25,61,5,64,125
"21060","1200-1259",2021-06-26,59,6,56,115
"21061","1200-1259",2021-06-27,57,7,67,124
"21062","1200-1259",2021-06-28,61,1,64,125
"21063","1200-1259",2021-06-29,54,2,59,113
"21064","1200-1259",2021-06-30,58,3,60,118
"21065","1300-1359",2021-06-01,61,2,49,110
"21066","1300-1359",2021-06-02,59,3,52,111
"21067","1300-1359",2021-06-03,66,4,58,124
"21068","1300-1359",2021-06-04,63,5,63,126
"21069","1300-1359",2021-06-05,51,6,53,104
"21070","1300-1359",2021-06-06,63,7,52,115
"21071","1300-1359",2021-06-07,63,1,61,124
"21072","1300-1359",2021-06-08,63,2,60,123
"21073","1300-1359",2021-06-09,64,3,61,125
"21074","1300-1359",2021-06-10,67,4,63,130
"21075","1300-1359",2021-06-11,66,5,64,130
"21076","1300-1359",2021-06-12,53,6,51,104
"21077","1300-1359",2021-06-13,63,7,55,118
"21078","1300-1359",2021-06-14,66,1,64,130
"21079","1300-1359",2021-06-15,64,2,63,127
"21080","1300-1359",2021-06-16,65,3,64,129
"21081","1300-1359",2021-06-17,70,4,65,135
"21082","1300-1359",2021-06-18,69,5,66,135
"21083","1300-1359",2021-06-19,56,6,52,108
"21084","1300-1359",2021-06-20,66,7,57,123
"21085","1300-1359",2021-06-21,69,1,66,135
"21086","1300-1359",2021-06-22,67,2,66,133
"21087","1300-1359",2021-06-23,67,3,65,132
"21088","1300-1359",2021-06-24,71,4,66,137
"21089","1300-1359",2021-06-25,70,5,66,136
"21090","1300-1359",2021-06-26,57,6,52,109
"21091","1300-1359",2021-06-27,67,7,57,124
"21092","1300-1359",2021-06-28,70,1,65,135
"21093","1300-1359",2021-06-29,68,2,66,134
"21094","1300-1359",2021-06-30,68,3,64,132
"21095","1400-1459",2021-06-01,43,2,53,96
"21096","1400-1459",2021-06-02,48,3,55,103
"21097","1400-1459",2021-06-03,54,4,59,113
"21098","1400-1459",2021-06-04,55,5,61,116
"21099","1400-1459",2021-06-05,50,6,61,111
"21100","1400-1459",2021-06-06,52,7,67,119
"21101","1400-1459",2021-06-07,51,1,69,120
"21102","1400-1459",2021-06-08,50,2,67,117
"21103","1400-1459",2021-06-09,55,3,68,123
"21104","1400-1459",2021-06-10,53,4,68,121
"21105","1400-1459",2021-06-11,53,5,67,120
"21106","1400-1459",2021-06-12,49,6,62,111
"21107","1400-1459",2021-06-13,54,7,68,122
"21108","1400-1459",2021-06-14,51,1,67,118
"21109","1400-1459",2021-06-15,52,2,65,117
"21110","1400-1459",2021-06-16,54,3,68,122
"21111","1400-1459",2021-06-17,50,4,64,114
"21112","1400-1459",2021-06-18,49,5,63,112
"21113","1400-1459",2021-06-19,46,6,59,105
"21114","1400-1459",2021-06-20,50,7,62,112
"21115","1400-1459",2021-06-21,47,1,63,110
"21116","1400-1459",2021-06-22,48,2,61,109
"21117","1400-1459",2021-06-23,50,3,64,114
"21118","1400-1459",2021-06-24,50,4,64,114
"21119","1400-1459",2021-06-25,49,5,63,112
"21120","1400-1459",2021-06-26,47,6,60,107
"21121","1400-1459",2021-06-27,50,7,62,112
"21122","1400-1459",2021-06-28,46,1,63,109
"21123","1400-1459",2021-06-29,47,2,61,108
"21124","1400-1459",2021-06-30,49,3,64,113
"21125","1500-1559",2021-06-01,47,2,40,87
"21126","1500-1559",2021-06-02,49,3,39,88
"21127","1500-1559",2021-06-03,60,4,51,111
"21128","1500-1559",2021-06-04,62,5,49,111
"21129","1500-1559",2021-06-05,65,6,36,101
"21130","1500-1559",2021-06-06,67,7,49,116
"21131","1500-1559",2021-06-07,74,1,56,130
"21132","1500-1559",2021-06-08,63,2,50,113
"21133","1500-1559",2021-06-09,66,3,50,116
"21134","1500-1559",2021-06-10,72,4,57,129
"21135","1500-1559",2021-06-11,74,5,55,129
"21136","1500-1559",2021-06-12,62,6,38,100
"21137","1500-1559",2021-06-13,67,7,50,117
"21138","1500-1559",2021-06-14,72,1,55,127
"21139","1500-1559",2021-06-15,62,2,51,113
"21140","1500-1559",2021-06-16,66,3,48,114
"21141","1500-1559",2021-06-17,75,4,59,134
"21142","1500-1559",2021-06-18,77,5,57,134
"21143","1500-1559",2021-06-19,63,6,40,103
"21144","1500-1559",2021-06-20,69,7,53,122
"21145","1500-1559",2021-06-21,75,1,57,132
"21146","1500-1559",2021-06-22,66,2,52,118
"21147","1500-1559",2021-06-23,69,3,49,118
"21148","1500-1559",2021-06-24,75,4,59,134
"21149","1500-1559",2021-06-25,77,5,58,135
"21150","1500-1559",2021-06-26,63,6,41,104
"21151","1500-1559",2021-06-27,70,7,53,123
"21152","1500-1559",2021-06-28,75,1,58,133
"21153","1500-1559",2021-06-29,66,2,53,119
"21154","1500-1559",2021-06-30,69,3,50,119
"21155","1600-1659",2021-06-01,45,2,63,108
"21156","1600-1659",2021-06-02,48,3,66,114
"21157","1600-1659",2021-06-03,60,4,70,130
"21158","1600-1659",2021-06-04,60,5,73,133
"21159","1600-1659",2021-06-05,44,6,64,108
"21160","1600-1659",2021-06-06,59,7,67,126
"21161","1600-1659",2021-06-07,58,1,72,130
"21162","1600-1659",2021-06-08,60,2,68,128
"21163","1600-1659",2021-06-09,62,3,72,134
"21164","1600-1659",2021-06-10,60,4,70,130
"21165","1600-1659",2021-06-11,59,5,68,127
"21166","1600-1659",2021-06-12,49,6,65,114
"21167","1600-1659",2021-06-13,60,7,66,126
"21168","1600-1659",2021-06-14,63,1,68,131
"21169","1600-1659",2021-06-15,60,2,67,127
"21170","1600-1659",2021-06-16,62,3,71,133
"21171","1600-1659",2021-06-17,64,4,68,132
"21172","1600-1659",2021-06-18,62,5,66,128
"21173","1600-1659",2021-06-19,52,6,61,113
"21174","1600-1659",2021-06-20,63,7,65,128
"21175","1600-1659",2021-06-21,66,1,66,132
"21176","1600-1659",2021-06-22,62,2,65,127
"21177","1600-1659",2021-06-23,64,3,69,133
"21178","1600-1659",2021-06-24,64,4,68,132
"21179","1600-1659",2021-06-25,62,5,66,128
"21180","1600-1659",2021-06-26,52,6,61,113
"21181","1600-1659",2021-06-27,63,7,65,128
"21182","1600-1659",2021-06-28,66,1,66,132
"21183","1600-1659",2021-06-29,62,2,66,128
"21184","1600-1659",2021-06-30,64,3,69,133
"21185","1700-1759",2021-06-01,51,2,58,109
"21186","1700-1759",2021-06-02,50,3,59,109
"21187","1700-1759",2021-06-03,59,4,71,130
"21188","1700-1759",2021-06-04,59,5,72,131
"21189","1700-1759",2021-06-05,60,6,70,130
"21190","1700-1759",2021-06-06,59,7,71,130
"21191","1700-1759",2021-06-07,63,1,69,132
"21192","1700-1759",2021-06-08,59,2,71,130
"21193","1700-1759",2021-06-09,56,3,69,125
"21194","1700-1759",2021-06-10,59,4,68,127
"21195","1700-1759",2021-06-11,58,5,73,131
"21196","1700-1759",2021-06-12,54,6,66,120
"21197","1700-1759",2021-06-13,56,7,68,124
"21198","1700-1759",2021-06-14,57,1,71,128
"21199","1700-1759",2021-06-15,56,2,69,125
"21200","1700-1759",2021-06-16,55,3,71,126
"21201","1700-1759",2021-06-17,58,4,70,128
"21202","1700-1759",2021-06-18,58,5,75,133
"21203","1700-1759",2021-06-19,53,6,67,120
"21204","1700-1759",2021-06-20,57,7,69,126
"21205","1700-1759",2021-06-21,57,1,73,130
"21206","1700-1759",2021-06-22,55,2,72,127
"21207","1700-1759",2021-06-23,54,3,72,126
"21208","1700-1759",2021-06-24,58,4,70,128
"21209","1700-1759",2021-06-25,58,5,75,133
"21210","1700-1759",2021-06-26,53,6,68,121
"21211","1700-1759",2021-06-27,58,7,69,127
"21212","1700-1759",2021-06-28,58,1,73,131
"21213","1700-1759",2021-06-29,54,2,72,126
"21214","1700-1759",2021-06-30,54,3,72,126
"21215","1800-1859",2021-06-01,60,2,41,101
"21216","1800-1859",2021-06-02,59,3,43,102
"21217","1800-1859",2021-06-03,73,4,58,131
"21218","1800-1859",2021-06-04,74,5,55,129
"21219","1800-1859",2021-06-05,67,6,51,118
"21220","1800-1859",2021-06-06,76,7,64,140
"21221","1800-1859",2021-06-07,74,1,64,138
"21222","1800-1859",2021-06-08,64,2,56,120
"21223","1800-1859",2021-06-09,69,3,60,129
"21224","1800-1859",2021-06-10,72,4,62,134
"21225","1800-1859",2021-06-11,75,5,61,136
"21226","1800-1859",2021-06-12,63,6,53,116
"21227","1800-1859",2021-06-13,71,7,63,134
"21228","1800-1859",2021-06-14,74,1,61,135
"21229","1800-1859",2021-06-15,67,2,58,125
"21230","1800-1859",2021-06-16,70,3,59,129
"21231","1800-1859",2021-06-17,72,4,62,134
"21232","1800-1859",2021-06-18,75,5,61,136
"21233","1800-1859",2021-06-19,60,6,52,112
"21234","1800-1859",2021-06-20,70,7,62,132
"21235","1800-1859",2021-06-21,74,1,60,134
"21236","1800-1859",2021-06-22,63,2,57,120
"21237","1800-1859",2021-06-23,71,3,58,129
"21238","1800-1859",2021-06-24,72,4,62,134
"21239","1800-1859",2021-06-25,75,5,61,136
"21240","1800-1859",2021-06-26,61,6,52,113
"21241","1800-1859",2021-06-27,70,7,63,133
"21242","1800-1859",2021-06-28,74,1,61,135
"21243","1800-1859",2021-06-29,63,2,57,120
"21244","1800-1859",2021-06-30,70,3,58,128
"21245","1900-1959",2021-06-01,43,2,50,93
"21246","1900-1959",2021-06-02,45,3,51,96
"21247","1900-1959",2021-06-03,68,4,55,123
"21248","1900-1959",2021-06-04,66,5,60,126
"21249","1900-1959",2021-06-05,62,6,50,112
"21250","1900-1959",2021-06-06,67,7,53,120
"21251","1900-1959",2021-06-07,70,1,57,127
"21252","1900-1959",2021-06-08,62,2,50,112
"21253","1900-1959",2021-06-09,64,3,52,116
"21254","1900-1959",2021-06-10,71,4,58,129
"21255","1900-1959",2021-06-11,73,5,60,133
"21256","1900-1959",2021-06-12,60,6,46,106
"21257","1900-1959",2021-06-13,68,7,55,123
"21258","1900-1959",2021-06-14,71,1,60,131
"21259","1900-1959",2021-06-15,63,2,55,118
"21260","1900-1959",2021-06-16,65,3,56,121
"21261","1900-1959",2021-06-17,70,4,64,134
"21262","1900-1959",2021-06-18,72,5,67,139
"21263","1900-1959",2021-06-19,59,6,50,109
"21264","1900-1959",2021-06-20,68,7,62,130
"21265","1900-1959",2021-06-21,70,1,66,136
"21266","1900-1959",2021-06-22,62,2,60,122
"21267","1900-1959",2021-06-23,64,3,60,124
"21268","1900-1959",2021-06-24,70,4,64,134
"21269","1900-1959",2021-06-25,72,5,66,138
"21270","1900-1959",2021-06-26,59,6,50,109
"21271","1900-1959",2021-06-27,69,7,63,132
"21272","1900-1959",2021-06-28,70,1,66,136
"21273","1900-1959",2021-06-29,62,2,60,122
"21274","1900-1959",2021-06-30,64,3,60,124
"21275","2000-2059",2021-06-01,38,2,57,95
"21276","2000-2059",2021-06-02,38,3,62,100
"21277","2000-2059",2021-06-03,45,4,77,122
"21278","2000-2059",2021-06-04,49,5,76,125
"21279","2000-2059",2021-06-05,37,6,68,105
"21280","2000-2059",2021-06-06,42,7,78,120
"21281","2000-2059",2021-06-07,39,1,80,119
"21282","2000-2059",2021-06-08,31,2,70,101
"21283","2000-2059",2021-06-09,37,3,76,113
"21284","2000-2059",2021-06-10,42,4,77,119
"21285","2000-2059",2021-06-11,44,5,78,122
"21286","2000-2059",2021-06-12,42,6,69,111
"21287","2000-2059",2021-06-13,43,7,73,116
"21288","2000-2059",2021-06-14,42,1,77,119
"21289","2000-2059",2021-06-15,39,2,71,110
"21290","2000-2059",2021-06-16,41,3,74,115
"21291","2000-2059",2021-06-17,44,4,72,116
"21292","2000-2059",2021-06-18,46,5,73,119
"21293","2000-2059",2021-06-19,41,6,63,104
"21294","2000-2059",2021-06-20,45,7,70,115
"21295","2000-2059",2021-06-21,44,1,72,116
"21296","2000-2059",2021-06-22,40,2,64,104
"21297","2000-2059",2021-06-23,44,3,69,113
"21298","2000-2059",2021-06-24,45,4,72,117
"21299","2000-2059",2021-06-25,46,5,73,119
"21300","2000-2059",2021-06-26,41,6,64,105
"21301","2000-2059",2021-06-27,45,7,71,116
"21302","2000-2059",2021-06-28,44,1,73,117
"21303","2000-2059",2021-06-29,40,2,65,105
"21304","2000-2059",2021-06-30,44,3,70,114
"21305","2100-2159",2021-06-01,37,2,58,95
"21306","2100-2159",2021-06-02,40,3,56,96
"21307","2100-2159",2021-06-03,44,4,67,111
"21308","2100-2159",2021-06-04,45,5,64,109
"21309","2100-2159",2021-06-05,37,6,69,106
"21310","2100-2159",2021-06-06,48,7,70,118
"21311","2100-2159",2021-06-07,46,1,66,112
"21312","2100-2159",2021-06-08,39,2,67,106
"21313","2100-2159",2021-06-09,47,3,65,112
"21314","2100-2159",2021-06-10,49,4,70,119
"21315","2100-2159",2021-06-11,48,5,70,118
"21316","2100-2159",2021-06-12,44,6,66,110
"21317","2100-2159",2021-06-13,48,7,72,120
"21318","2100-2159",2021-06-14,47,1,70,117
"21319","2100-2159",2021-06-15,43,2,66,109
"21320","2100-2159",2021-06-16,45,3,70,115
"21321","2100-2159",2021-06-17,47,4,71,118
"21322","2100-2159",2021-06-18,47,5,70,117
"21323","2100-2159",2021-06-19,42,6,66,108
"21324","2100-2159",2021-06-20,47,7,72,119
"21325","2100-2159",2021-06-21,45,1,71,116
"21326","2100-2159",2021-06-22,40,2,64,104
"21327","2100-2159",2021-06-23,42,3,73,115
"21328","2100-2159",2021-06-24,47,4,72,119
"21329","2100-2159",2021-06-25,47,5,70,117
"21330","2100-2159",2021-06-26,42,6,66,108
"21331","2100-2159",2021-06-27,47,7,74,121
"21332","2100-2159",2021-06-28,45,1,72,117
"21333","2100-2159",2021-06-29,40,2,65,105
"21334","2100-2159",2021-06-30,42,3,73,115
"21335","2200-2259",2021-06-01,30,2,59,89
"21336","2200-2259",2021-06-02,32,3,60,92
"21337","2200-2259",2021-06-03,44,4,74,118
"21338","2200-2259",2021-06-04,44,5,78,122
"21339","2200-2259",2021-06-05,31,6,63,94
"21340","2200-2259",2021-06-06,44,7,70,114
"21341","2200-2259",2021-06-07,38,1,75,113
"21342","2200-2259",2021-06-08,29,2,65,94
"21343","2200-2259",2021-06-09,36,3,72,108
"21344","2200-2259",2021-06-10,49,4,75,124
"21345","2200-2259",2021-06-11,46,5,81,127
"21346","2200-2259",2021-06-12,33,6,70,103
"21347","2200-2259",2021-06-13,51,7,73,124
"21348","2200-2259",2021-06-14,43,1,78,121
"21349","2200-2259",2021-06-15,34,2,71,105
"21350","2200-2259",2021-06-16,37,3,72,109
"21351","2200-2259",2021-06-17,49,4,74,123
"21352","2200-2259",2021-06-18,45,5,80,125
"21353","2200-2259",2021-06-19,33,6,66,99
"21354","2200-2259",2021-06-20,50,7,72,122
"21355","2200-2259",2021-06-21,43,1,77,120
"21356","2200-2259",2021-06-22,32,2,69,101
"21357","2200-2259",2021-06-23,36,3,71,107
"21358","2200-2259",2021-06-24,49,4,74,123
"21359","2200-2259",2021-06-25,45,5,81,126
"21360","2200-2259",2021-06-26,33,6,67,100
"21361","2200-2259",2021-06-27,51,7,73,124
"21362","2200-2259",2021-06-28,43,1,78,121
"21363","2200-2259",2021-06-29,31,2,69,100
"21364","2200-2259",2021-06-30,37,3,72,109
"21365","2300-2359",2021-06-01,16,2,47,63
"21366","2300-2359",2021-06-02,15,3,50,65
"21367","2300-2359",2021-06-03,28,4,69,97
"21368","2300-2359",2021-06-04,25,5,67,92
"21369","2300-2359",2021-06-05,23,6,51,74
"21370","2300-2359",2021-06-06,28,7,71,99
"21371","2300-2359",2021-06-07,23,1,63,86
"21372","2300-2359",2021-06-08,20,2,51,71
"21373","2300-2359",2021-06-09,21,3,61,82
"21374","2300-2359",2021-06-10,28,4,67,95
"21375","2300-2359",2021-06-11,28,5,64,92
"21376","2300-2359",2021-06-12,25,6,54,79
"21377","2300-2359",2021-06-13,28,7,69,97
"21378","2300-2359",2021-06-14,26,1,64,90
"21379","2300-2359",2021-06-15,24,2,54,78
"21380","2300-2359",2021-06-16,23,3,58,81
"21381","2300-2359",2021-06-17,27,4,69,96
"21382","2300-2359",2021-06-18,29,5,67,96
"21383","2300-2359",2021-06-19,25,6,58,83
"21384","2300-2359",2021-06-20,28,7,73,101
"21385","2300-2359",2021-06-21,26,1,66,92
"21386","2300-2359",2021-06-22,25,2,56,81
"21387","2300-2359",2021-06-23,23,3,60,83
"21388","2300-2359",2021-06-24,28,4,70,98
"21389","2300-2359",2021-06-25,29,5,67,96
"21390","2300-2359",2021-06-26,25,6,58,83
"21391","2300-2359",2021-06-27,28,7,74,102
"21392","2300-2359",2021-06-28,26,1,66,92
"21393","2300-2359",2021-06-29,24,2,55,79
"21394","2300-2359",2021-06-30,23,3,61,84
"21395","0001-0559",2021-07-01,15,4,51,66
"21396","0001-0559",2021-07-02,17,5,46,63
"21397","0001-0559",2021-07-03,17,6,33,50
"21398","0001-0559",2021-07-04,12,7,35,47
"21399","0001-0559",2021-07-05,14,1,42,56
"21400","0001-0559",2021-07-06,15,2,37,52
"21401","0001-0559",2021-07-07,18,3,37,55
"21402","0001-0559",2021-07-08,20,4,52,72
"21403","0001-0559",2021-07-09,21,5,49,70
"21404","0001-0559",2021-07-10,21,6,38,59
"21405","0001-0559",2021-07-11,15,7,47,62
"21406","0001-0559",2021-07-12,21,1,47,68
"21407","0001-0559",2021-07-13,17,2,36,53
"21408","0001-0559",2021-07-14,18,3,36,54
"21409","0001-0559",2021-07-15,19,4,49,68
"21410","0001-0559",2021-07-16,21,5,49,70
"21411","0001-0559",2021-07-17,20,6,37,57
"21412","0001-0559",2021-07-18,14,7,46,60
"21413","0001-0559",2021-07-19,21,1,47,68
"21414","0001-0559",2021-07-20,16,2,35,51
"21415","0001-0559",2021-07-21,18,3,36,54
"21416","0001-0559",2021-07-22,19,4,49,68
"21417","0001-0559",2021-07-23,21,5,49,70
"21418","0001-0559",2021-07-24,20,6,37,57
"21419","0001-0559",2021-07-25,14,7,46,60
"21420","0001-0559",2021-07-26,21,1,47,68
"21421","0001-0559",2021-07-27,16,2,35,51
"21422","0001-0559",2021-07-28,18,3,36,54
"21423","0001-0559",2021-07-29,19,4,49,68
"21424","0001-0559",2021-07-30,21,5,49,70
"21425","0001-0559",2021-07-31,20,6,38,58
"21426","0600-0659",2021-07-01,80,4,33,113
"21427","0600-0659",2021-07-02,78,5,33,111
"21428","0600-0659",2021-07-03,67,6,29,96
"21429","0600-0659",2021-07-04,73,7,26,99
"21430","0600-0659",2021-07-05,74,1,33,107
"21431","0600-0659",2021-07-06,74,2,28,102
"21432","0600-0659",2021-07-07,72,3,30,102
"21433","0600-0659",2021-07-08,77,4,35,112
"21434","0600-0659",2021-07-09,76,5,36,112
"21435","0600-0659",2021-07-10,71,6,35,106
"21436","0600-0659",2021-07-11,74,7,32,106
"21437","0600-0659",2021-07-12,75,1,32,107
"21438","0600-0659",2021-07-13,72,2,28,100
"21439","0600-0659",2021-07-14,72,3,30,102
"21440","0600-0659",2021-07-15,77,4,35,112
"21441","0600-0659",2021-07-16,77,5,36,113
"21442","0600-0659",2021-07-17,71,6,35,106
"21443","0600-0659",2021-07-18,75,7,32,107
"21444","0600-0659",2021-07-19,76,1,32,108
"21445","0600-0659",2021-07-20,73,2,28,101
"21446","0600-0659",2021-07-21,73,3,30,103
"21447","0600-0659",2021-07-22,78,4,35,113
"21448","0600-0659",2021-07-23,77,5,36,113
"21449","0600-0659",2021-07-24,71,6,35,106
"21450","0600-0659",2021-07-25,76,7,32,108
"21451","0600-0659",2021-07-26,76,1,32,108
"21452","0600-0659",2021-07-27,73,2,28,101
"21453","0600-0659",2021-07-28,73,3,29,102
"21454","0600-0659",2021-07-29,78,4,34,112
"21455","0600-0659",2021-07-30,77,5,35,112
"21456","0600-0659",2021-07-31,71,6,33,104
"21457","0700-0759",2021-07-01,94,4,55,149
"21458","0700-0759",2021-07-02,97,5,52,149
"21459","0700-0759",2021-07-03,86,6,47,133
"21460","0700-0759",2021-07-04,88,7,47,135
"21461","0700-0759",2021-07-05,94,1,51,145
"21462","0700-0759",2021-07-06,92,2,52,144
"21463","0700-0759",2021-07-07,94,3,54,148
"21464","0700-0759",2021-07-08,100,4,58,158
"21465","0700-0759",2021-07-09,101,5,56,157
"21466","0700-0759",2021-07-10,93,6,54,147
"21467","0700-0759",2021-07-11,95,7,53,148
"21468","0700-0759",2021-07-12,101,1,57,158
"21469","0700-0759",2021-07-13,97,2,53,150
"21470","0700-0759",2021-07-14,94,3,54,148
"21471","0700-0759",2021-07-15,99,4,58,157
"21472","0700-0759",2021-07-16,99,5,56,155
"21473","0700-0759",2021-07-17,93,6,54,147
"21474","0700-0759",2021-07-18,94,7,53,147
"21475","0700-0759",2021-07-19,99,1,57,156
"21476","0700-0759",2021-07-20,96,2,53,149
"21477","0700-0759",2021-07-21,94,3,54,148
"21478","0700-0759",2021-07-22,100,4,58,158
"21479","0700-0759",2021-07-23,100,5,56,156
"21480","0700-0759",2021-07-24,93,6,54,147
"21481","0700-0759",2021-07-25,95,7,53,148
"21482","0700-0759",2021-07-26,100,1,57,157
"21483","0700-0759",2021-07-27,97,2,53,150
"21484","0700-0759",2021-07-28,95,3,54,149
"21485","0700-0759",2021-07-29,101,4,58,159
"21486","0700-0759",2021-07-30,101,5,56,157
"21487","0700-0759",2021-07-31,94,6,54,148
"21488","0800-0859",2021-07-01,81,4,58,139
"21489","0800-0859",2021-07-02,84,5,60,144
"21490","0800-0859",2021-07-03,71,6,48,119
"21491","0800-0859",2021-07-04,79,7,47,126
"21492","0800-0859",2021-07-05,82,1,54,136
"21493","0800-0859",2021-07-06,83,2,57,140
"21494","0800-0859",2021-07-07,86,3,54,140
"21495","0800-0859",2021-07-08,85,4,57,142
"21496","0800-0859",2021-07-09,86,5,57,143
"21497","0800-0859",2021-07-10,73,6,52,125
"21498","0800-0859",2021-07-11,82,7,51,133
"21499","0800-0859",2021-07-12,86,1,55,141
"21500","0800-0859",2021-07-13,84,2,55,139
"21501","0800-0859",2021-07-14,86,3,53,139
"21502","0800-0859",2021-07-15,86,4,56,142
"21503","0800-0859",2021-07-16,87,5,56,143
"21504","0800-0859",2021-07-17,74,6,51,125
"21505","0800-0859",2021-07-18,84,7,51,135
"21506","0800-0859",2021-07-19,87,1,54,141
"21507","0800-0859",2021-07-20,85,2,55,140
"21508","0800-0859",2021-07-21,87,3,53,140
"21509","0800-0859",2021-07-22,86,4,56,142
"21510","0800-0859",2021-07-23,87,5,56,143
"21511","0800-0859",2021-07-24,75,6,51,126
"21512","0800-0859",2021-07-25,84,7,51,135
"21513","0800-0859",2021-07-26,87,1,54,141
"21514","0800-0859",2021-07-27,85,2,55,140
"21515","0800-0859",2021-07-28,87,3,53,140
"21516","0800-0859",2021-07-29,86,4,56,142
"21517","0800-0859",2021-07-30,87,5,56,143
"21518","0800-0859",2021-07-31,75,6,51,126
"21519","0900-0959",2021-07-01,82,4,58,140
"21520","0900-0959",2021-07-02,83,5,57,140
"21521","0900-0959",2021-07-03,78,6,53,131
"21522","0900-0959",2021-07-04,75,7,53,128
"21523","0900-0959",2021-07-05,83,1,54,137
"21524","0900-0959",2021-07-06,81,2,55,136
"21525","0900-0959",2021-07-07,79,3,53,132
"21526","0900-0959",2021-07-08,78,4,58,136
"21527","0900-0959",2021-07-09,80,5,58,138
"21528","0900-0959",2021-07-10,74,6,55,129
"21529","0900-0959",2021-07-11,73,7,56,129
"21530","0900-0959",2021-07-12,80,1,58,138
"21531","0900-0959",2021-07-13,80,2,58,138
"21532","0900-0959",2021-07-14,78,3,54,132
"21533","0900-0959",2021-07-15,77,4,58,135
"21534","0900-0959",2021-07-16,78,5,58,136
"21535","0900-0959",2021-07-17,74,6,56,130
"21536","0900-0959",2021-07-18,72,7,56,128
"21537","0900-0959",2021-07-19,78,1,58,136
"21538","0900-0959",2021-07-20,79,2,58,137
"21539","0900-0959",2021-07-21,78,3,55,133
"21540","0900-0959",2021-07-22,77,4,59,136
"21541","0900-0959",2021-07-23,78,5,58,136
"21542","0900-0959",2021-07-24,74,6,56,130
"21543","0900-0959",2021-07-25,72,7,57,129
"21544","0900-0959",2021-07-26,77,1,58,135
"21545","0900-0959",2021-07-27,80,2,59,139
"21546","0900-0959",2021-07-28,78,3,56,134
"21547","0900-0959",2021-07-29,77,4,60,137
"21548","0900-0959",2021-07-30,78,5,59,137
"21549","0900-0959",2021-07-31,74,6,57,131
"21550","1000-1059",2021-07-01,66,4,53,119
"21551","1000-1059",2021-07-02,63,5,55,118
"21552","1000-1059",2021-07-03,51,6,50,101
"21553","1000-1059",2021-07-04,59,7,50,109
"21554","1000-1059",2021-07-05,64,1,54,118
"21555","1000-1059",2021-07-06,60,2,54,114
"21556","1000-1059",2021-07-07,55,3,53,108
"21557","1000-1059",2021-07-08,66,4,51,117
"21558","1000-1059",2021-07-09,65,5,54,119
"21559","1000-1059",2021-07-10,53,6,49,102
"21560","1000-1059",2021-07-11,62,7,48,110
"21561","1000-1059",2021-07-12,64,1,54,118
"21562","1000-1059",2021-07-13,59,2,52,111
"21563","1000-1059",2021-07-14,55,3,53,108
"21564","1000-1059",2021-07-15,66,4,51,117
"21565","1000-1059",2021-07-16,65,5,53,118
"21566","1000-1059",2021-07-17,52,6,49,101
"21567","1000-1059",2021-07-18,62,7,48,110
"21568","1000-1059",2021-07-19,64,1,53,117
"21569","1000-1059",2021-07-20,59,2,52,111
"21570","1000-1059",2021-07-21,55,3,53,108
"21571","1000-1059",2021-07-22,66,4,52,118
"21572","1000-1059",2021-07-23,65,5,54,119
"21573","1000-1059",2021-07-24,52,6,50,102
"21574","1000-1059",2021-07-25,63,7,48,111
"21575","1000-1059",2021-07-26,65,1,53,118
"21576","1000-1059",2021-07-27,59,2,52,111
"21577","1000-1059",2021-07-28,57,3,53,110
"21578","1000-1059",2021-07-29,67,4,52,119
"21579","1000-1059",2021-07-30,66,5,54,120
"21580","1000-1059",2021-07-31,53,6,50,103
"21581","1100-1159",2021-07-01,64,4,55,119
"21582","1100-1159",2021-07-02,69,5,57,126
"21583","1100-1159",2021-07-03,53,6,53,106
"21584","1100-1159",2021-07-04,61,7,49,110
"21585","1100-1159",2021-07-05,67,1,56,123
"21586","1100-1159",2021-07-06,68,2,55,123
"21587","1100-1159",2021-07-07,68,3,59,127
"21588","1100-1159",2021-07-08,60,4,63,123
"21589","1100-1159",2021-07-09,63,5,62,125
"21590","1100-1159",2021-07-10,52,6,56,108
"21591","1100-1159",2021-07-11,57,7,55,112
"21592","1100-1159",2021-07-12,64,1,62,126
"21593","1100-1159",2021-07-13,67,2,59,126
"21594","1100-1159",2021-07-14,68,3,58,126
"21595","1100-1159",2021-07-15,61,4,63,124
"21596","1100-1159",2021-07-16,63,5,62,125
"21597","1100-1159",2021-07-17,51,6,56,107
"21598","1100-1159",2021-07-18,57,7,56,113
"21599","1100-1159",2021-07-19,64,1,62,126
"21600","1100-1159",2021-07-20,66,2,59,125
"21601","1100-1159",2021-07-21,68,3,58,126
"21602","1100-1159",2021-07-22,62,4,63,125
"21603","1100-1159",2021-07-23,64,5,62,126
"21604","1100-1159",2021-07-24,52,6,56,108
"21605","1100-1159",2021-07-25,56,7,56,112
"21606","1100-1159",2021-07-26,63,1,62,125
"21607","1100-1159",2021-07-27,66,2,59,125
"21608","1100-1159",2021-07-28,68,3,59,127
"21609","1100-1159",2021-07-29,62,4,63,125
"21610","1100-1159",2021-07-30,65,5,62,127
"21611","1100-1159",2021-07-31,52,6,56,108
"21612","1200-1259",2021-07-01,60,4,68,128
"21613","1200-1259",2021-07-02,62,5,67,129
"21614","1200-1259",2021-07-03,63,6,57,120
"21615","1200-1259",2021-07-04,52,7,71,123
"21616","1200-1259",2021-07-05,61,1,67,128
"21617","1200-1259",2021-07-06,56,2,63,119
"21618","1200-1259",2021-07-07,62,3,61,123
"21619","1200-1259",2021-07-08,68,4,64,132
"21620","1200-1259",2021-07-09,67,5,65,132
"21621","1200-1259",2021-07-10,62,6,54,116
"21622","1200-1259",2021-07-11,62,7,67,129
"21623","1200-1259",2021-07-12,67,1,65,132
"21624","1200-1259",2021-07-13,60,2,60,120
"21625","1200-1259",2021-07-14,62,3,61,123
"21626","1200-1259",2021-07-15,66,4,64,130
"21627","1200-1259",2021-07-16,65,5,64,129
"21628","1200-1259",2021-07-17,61,6,53,114
"21629","1200-1259",2021-07-18,61,7,66,127
"21630","1200-1259",2021-07-19,65,1,64,129
"21631","1200-1259",2021-07-20,59,2,59,118
"21632","1200-1259",2021-07-21,60,3,60,120
"21633","1200-1259",2021-07-22,66,4,64,130
"21634","1200-1259",2021-07-23,65,5,64,129
"21635","1200-1259",2021-07-24,61,6,53,114
"21636","1200-1259",2021-07-25,61,7,67,128
"21637","1200-1259",2021-07-26,65,1,64,129
"21638","1200-1259",2021-07-27,59,2,59,118
"21639","1200-1259",2021-07-28,60,3,61,121
"21640","1200-1259",2021-07-29,66,4,65,131
"21641","1200-1259",2021-07-30,65,5,65,130
"21642","1200-1259",2021-07-31,60,6,53,113
"21643","1300-1359",2021-07-01,68,4,65,133
"21644","1300-1359",2021-07-02,66,5,68,134
"21645","1300-1359",2021-07-03,55,6,55,110
"21646","1300-1359",2021-07-04,64,7,57,121
"21647","1300-1359",2021-07-05,67,1,68,135
"21648","1300-1359",2021-07-06,65,2,68,133
"21649","1300-1359",2021-07-07,68,3,67,135
"21650","1300-1359",2021-07-08,69,4,69,138
"21651","1300-1359",2021-07-09,69,5,68,137
"21652","1300-1359",2021-07-10,62,6,56,118
"21653","1300-1359",2021-07-11,69,7,61,130
"21654","1300-1359",2021-07-12,69,1,68,137
"21655","1300-1359",2021-07-13,68,2,69,137
"21656","1300-1359",2021-07-14,67,3,67,134
"21657","1300-1359",2021-07-15,69,4,69,138
"21658","1300-1359",2021-07-16,67,5,68,135
"21659","1300-1359",2021-07-17,59,6,56,115
"21660","1300-1359",2021-07-18,68,7,62,130
"21661","1300-1359",2021-07-19,68,1,69,137
"21662","1300-1359",2021-07-20,65,2,70,135
"21663","1300-1359",2021-07-21,65,3,68,133
"21664","1300-1359",2021-07-22,69,4,70,139
"21665","1300-1359",2021-07-23,67,5,69,136
"21666","1300-1359",2021-07-24,59,6,56,115
"21667","1300-1359",2021-07-25,68,7,61,129
"21668","1300-1359",2021-07-26,68,1,68,136
"21669","1300-1359",2021-07-27,65,2,70,135
"21670","1300-1359",2021-07-28,65,3,68,133
"21671","1300-1359",2021-07-29,70,4,70,140
"21672","1300-1359",2021-07-30,68,5,69,137
"21673","1300-1359",2021-07-31,60,6,57,117
"21674","1400-1459",2021-07-01,54,4,65,119
"21675","1400-1459",2021-07-02,52,5,64,116
"21676","1400-1459",2021-07-03,49,6,60,109
"21677","1400-1459",2021-07-04,48,7,60,108
"21678","1400-1459",2021-07-05,50,1,65,115
"21679","1400-1459",2021-07-06,51,2,62,113
"21680","1400-1459",2021-07-07,50,3,67,117
"21681","1400-1459",2021-07-08,51,4,65,116
"21682","1400-1459",2021-07-09,50,5,67,117
"21683","1400-1459",2021-07-10,45,6,62,107
"21684","1400-1459",2021-07-11,48,7,63,111
"21685","1400-1459",2021-07-12,49,1,66,115
"21686","1400-1459",2021-07-13,48,2,65,113
"21687","1400-1459",2021-07-14,51,3,67,118
"21688","1400-1459",2021-07-15,50,4,65,115
"21689","1400-1459",2021-07-16,50,5,66,116
"21690","1400-1459",2021-07-17,45,6,61,106
"21691","1400-1459",2021-07-18,47,7,61,108
"21692","1400-1459",2021-07-19,49,1,65,114
"21693","1400-1459",2021-07-20,48,2,62,110
"21694","1400-1459",2021-07-21,51,3,65,116
"21695","1400-1459",2021-07-22,50,4,64,114
"21696","1400-1459",2021-07-23,50,5,65,115
"21697","1400-1459",2021-07-24,46,6,61,107
"21698","1400-1459",2021-07-25,47,7,61,108
"21699","1400-1459",2021-07-26,49,1,65,114
"21700","1400-1459",2021-07-27,48,2,62,110
"21701","1400-1459",2021-07-28,51,3,66,117
"21702","1400-1459",2021-07-29,50,4,65,115
"21703","1400-1459",2021-07-30,50,5,66,116
"21704","1400-1459",2021-07-31,46,6,62,108
"21705","1500-1559",2021-07-01,78,4,58,136
"21706","1500-1559",2021-07-02,79,5,57,136
"21707","1500-1559",2021-07-03,67,6,40,107
"21708","1500-1559",2021-07-04,71,7,48,119
"21709","1500-1559",2021-07-05,77,1,55,132
"21710","1500-1559",2021-07-06,69,2,51,120
"21711","1500-1559",2021-07-07,76,3,48,124
"21712","1500-1559",2021-07-08,83,4,53,136
"21713","1500-1559",2021-07-09,85,5,53,138
"21714","1500-1559",2021-07-10,69,6,40,109
"21715","1500-1559",2021-07-11,80,7,48,128
"21716","1500-1559",2021-07-12,80,1,52,132
"21717","1500-1559",2021-07-13,73,2,48,121
"21718","1500-1559",2021-07-14,76,3,48,124
"21719","1500-1559",2021-07-15,84,4,52,136
"21720","1500-1559",2021-07-16,85,5,53,138
"21721","1500-1559",2021-07-17,69,6,39,108
"21722","1500-1559",2021-07-18,81,7,47,128
"21723","1500-1559",2021-07-19,81,1,52,133
"21724","1500-1559",2021-07-20,73,2,47,120
"21725","1500-1559",2021-07-21,76,3,48,124
"21726","1500-1559",2021-07-22,84,4,52,136
"21727","1500-1559",2021-07-23,85,5,53,138
"21728","1500-1559",2021-07-24,69,6,39,108
"21729","1500-1559",2021-07-25,81,7,47,128
"21730","1500-1559",2021-07-26,81,1,52,133
"21731","1500-1559",2021-07-27,73,2,47,120
"21732","1500-1559",2021-07-28,76,3,47,123
"21733","1500-1559",2021-07-29,84,4,52,136
"21734","1500-1559",2021-07-30,85,5,53,138
"21735","1500-1559",2021-07-31,69,6,38,107
"21736","1600-1659",2021-07-01,60,4,65,125
"21737","1600-1659",2021-07-02,61,5,66,127
"21738","1600-1659",2021-07-03,53,6,56,109
"21739","1600-1659",2021-07-04,53,7,67,120
"21740","1600-1659",2021-07-05,62,1,66,128
"21741","1600-1659",2021-07-06,63,2,65,128
"21742","1600-1659",2021-07-07,60,3,75,135
"21743","1600-1659",2021-07-08,60,4,71,131
"21744","1600-1659",2021-07-09,61,5,72,133
"21745","1600-1659",2021-07-10,55,6,61,116
"21746","1600-1659",2021-07-11,61,7,69,130
"21747","1600-1659",2021-07-12,61,1,72,133
"21748","1600-1659",2021-07-13,59,2,70,129
"21749","1600-1659",2021-07-14,60,3,75,135
"21750","1600-1659",2021-07-15,60,4,70,130
"21751","1600-1659",2021-07-16,61,5,71,132
"21752","1600-1659",2021-07-17,54,6,60,114
"21753","1600-1659",2021-07-18,61,7,68,129
"21754","1600-1659",2021-07-19,61,1,71,132
"21755","1600-1659",2021-07-20,59,2,70,129
"21756","1600-1659",2021-07-21,60,3,75,135
"21757","1600-1659",2021-07-22,60,4,70,130
"21758","1600-1659",2021-07-23,61,5,71,132
"21759","1600-1659",2021-07-24,53,6,60,113
"21760","1600-1659",2021-07-25,61,7,68,129
"21761","1600-1659",2021-07-26,61,1,71,132
"21762","1600-1659",2021-07-27,59,2,71,130
"21763","1600-1659",2021-07-28,61,3,75,136
"21764","1600-1659",2021-07-29,61,4,70,131
"21765","1600-1659",2021-07-30,62,5,71,133
"21766","1600-1659",2021-07-31,54,6,60,114
"21767","1700-1759",2021-07-01,64,4,75,139
"21768","1700-1759",2021-07-02,59,5,79,138
"21769","1700-1759",2021-07-03,48,6,77,125
"21770","1700-1759",2021-07-04,51,7,72,123
"21771","1700-1759",2021-07-05,59,1,77,136
"21772","1700-1759",2021-07-06,57,2,77,134
"21773","1700-1759",2021-07-07,56,3,72,128
"21774","1700-1759",2021-07-08,58,4,73,131
"21775","1700-1759",2021-07-09,57,5,75,132
"21776","1700-1759",2021-07-10,48,6,71,119
"21777","1700-1759",2021-07-11,58,7,74,132
"21778","1700-1759",2021-07-12,57,1,74,131
"21779","1700-1759",2021-07-13,55,2,73,128
"21780","1700-1759",2021-07-14,56,3,72,128
"21781","1700-1759",2021-07-15,57,4,73,130
"21782","1700-1759",2021-07-16,57,5,74,131
"21783","1700-1759",2021-07-17,48,6,70,118
"21784","1700-1759",2021-07-18,57,7,74,131
"21785","1700-1759",2021-07-19,57,1,74,131
"21786","1700-1759",2021-07-20,55,2,72,127
"21787","1700-1759",2021-07-21,56,3,71,127
"21788","1700-1759",2021-07-22,57,4,74,131
"21789","1700-1759",2021-07-23,57,5,75,132
"21790","1700-1759",2021-07-24,48,6,71,119
"21791","1700-1759",2021-07-25,57,7,75,132
"21792","1700-1759",2021-07-26,57,1,75,132
"21793","1700-1759",2021-07-27,55,2,72,127
"21794","1700-1759",2021-07-28,56,3,71,127
"21795","1700-1759",2021-07-29,57,4,74,131
"21796","1700-1759",2021-07-30,57,5,75,132
"21797","1700-1759",2021-07-31,48,6,70,118
"21798","1800-1859",2021-07-01,70,4,64,134
"21799","1800-1859",2021-07-02,70,5,60,130
"21800","1800-1859",2021-07-03,61,6,51,112
"21801","1800-1859",2021-07-04,55,7,57,112
"21802","1800-1859",2021-07-05,68,1,60,128
"21803","1800-1859",2021-07-06,66,2,56,122
"21804","1800-1859",2021-07-07,71,3,56,127
"21805","1800-1859",2021-07-08,73,4,66,139
"21806","1800-1859",2021-07-09,76,5,63,139
"21807","1800-1859",2021-07-10,69,6,57,126
"21808","1800-1859",2021-07-11,72,7,65,137
"21809","1800-1859",2021-07-12,74,1,62,136
"21810","1800-1859",2021-07-13,66,2,57,123
"21811","1800-1859",2021-07-14,71,3,56,127
"21812","1800-1859",2021-07-15,73,4,65,138
"21813","1800-1859",2021-07-16,75,5,63,138
"21814","1800-1859",2021-07-17,68,6,56,124
"21815","1800-1859",2021-07-18,72,7,64,136
"21816","1800-1859",2021-07-19,74,1,62,136
"21817","1800-1859",2021-07-20,65,2,56,121
"21818","1800-1859",2021-07-21,70,3,56,126
"21819","1800-1859",2021-07-22,73,4,65,138
"21820","1800-1859",2021-07-23,75,5,63,138
"21821","1800-1859",2021-07-24,68,6,56,124
"21822","1800-1859",2021-07-25,72,7,64,136
"21823","1800-1859",2021-07-26,74,1,62,136
"21824","1800-1859",2021-07-27,65,2,56,121
"21825","1800-1859",2021-07-28,69,3,56,125
"21826","1800-1859",2021-07-29,72,4,65,137
"21827","1800-1859",2021-07-30,74,5,64,138
"21828","1800-1859",2021-07-31,67,6,57,124
"21829","1900-1959",2021-07-01,72,4,67,139
"21830","1900-1959",2021-07-02,68,5,67,135
"21831","1900-1959",2021-07-03,57,6,53,110
"21832","1900-1959",2021-07-04,58,7,55,113
"21833","1900-1959",2021-07-05,67,1,67,134
"21834","1900-1959",2021-07-06,60,2,64,124
"21835","1900-1959",2021-07-07,63,3,68,131
"21836","1900-1959",2021-07-08,73,4,68,141
"21837","1900-1959",2021-07-09,72,5,71,143
"21838","1900-1959",2021-07-10,61,6,64,125
"21839","1900-1959",2021-07-11,70,7,68,138
"21840","1900-1959",2021-07-12,71,1,69,140
"21841","1900-1959",2021-07-13,62,2,66,128
"21842","1900-1959",2021-07-14,62,3,67,129
"21843","1900-1959",2021-07-15,72,4,69,141
"21844","1900-1959",2021-07-16,72,5,71,143
"21845","1900-1959",2021-07-17,61,6,63,124
"21846","1900-1959",2021-07-18,69,7,69,138
"21847","1900-1959",2021-07-19,70,1,70,140
"21848","1900-1959",2021-07-20,62,2,66,128
"21849","1900-1959",2021-07-21,62,3,67,129
"21850","1900-1959",2021-07-22,72,4,69,141
"21851","1900-1959",2021-07-23,72,5,71,143
"21852","1900-1959",2021-07-24,61,6,64,125
"21853","1900-1959",2021-07-25,69,7,69,138
"21854","1900-1959",2021-07-26,70,1,70,140
"21855","1900-1959",2021-07-27,62,2,66,128
"21856","1900-1959",2021-07-28,63,3,67,130
"21857","1900-1959",2021-07-29,72,4,69,141
"21858","1900-1959",2021-07-30,72,5,71,143
"21859","1900-1959",2021-07-31,63,6,64,127
"21860","2000-2059",2021-07-01,47,4,76,123
"21861","2000-2059",2021-07-02,53,5,75,128
"21862","2000-2059",2021-07-03,42,6,63,105
"21863","2000-2059",2021-07-04,41,7,61,102
"21864","2000-2059",2021-07-05,55,1,73,128
"21865","2000-2059",2021-07-06,50,2,65,115
"21866","2000-2059",2021-07-07,49,3,70,119
"21867","2000-2059",2021-07-08,51,4,74,125
"21868","2000-2059",2021-07-09,52,5,74,126
"21869","2000-2059",2021-07-10,45,6,63,108
"21870","2000-2059",2021-07-11,48,7,71,119
"21871","2000-2059",2021-07-12,51,1,75,126
"21872","2000-2059",2021-07-13,49,2,67,116
"21873","2000-2059",2021-07-14,50,3,69,119
"21874","2000-2059",2021-07-15,51,4,73,124
"21875","2000-2059",2021-07-16,51,5,73,124
"21876","2000-2059",2021-07-17,44,6,62,106
"21877","2000-2059",2021-07-18,48,7,71,119
"21878","2000-2059",2021-07-19,52,1,74,126
"21879","2000-2059",2021-07-20,48,2,66,114
"21880","2000-2059",2021-07-21,49,3,68,117
"21881","2000-2059",2021-07-22,51,4,73,124
"21882","2000-2059",2021-07-23,51,5,73,124
"21883","2000-2059",2021-07-24,45,6,62,107
"21884","2000-2059",2021-07-25,48,7,71,119
"21885","2000-2059",2021-07-26,52,1,74,126
"21886","2000-2059",2021-07-27,48,2,66,114
"21887","2000-2059",2021-07-28,49,3,68,117
"21888","2000-2059",2021-07-29,51,4,72,123
"21889","2000-2059",2021-07-30,51,5,72,123
"21890","2000-2059",2021-07-31,47,6,63,110
"21891","2100-2159",2021-07-01,51,4,72,123
"21892","2100-2159",2021-07-02,49,5,67,116
"21893","2100-2159",2021-07-03,44,6,69,113
"21894","2100-2159",2021-07-04,42,7,64,106
"21895","2100-2159",2021-07-05,48,1,70,118
"21896","2100-2159",2021-07-06,43,2,69,112
"21897","2100-2159",2021-07-07,47,3,76,123
"21898","2100-2159",2021-07-08,51,4,78,129
"21899","2100-2159",2021-07-09,48,5,75,123
"21900","2100-2159",2021-07-10,46,6,72,118
"21901","2100-2159",2021-07-11,52,7,80,132
"21902","2100-2159",2021-07-12,47,1,76,123
"21903","2100-2159",2021-07-13,45,2,69,114
"21904","2100-2159",2021-07-14,48,3,77,125
"21905","2100-2159",2021-07-15,51,4,77,128
"21906","2100-2159",2021-07-16,48,5,74,122
"21907","2100-2159",2021-07-17,45,6,72,117
"21908","2100-2159",2021-07-18,52,7,78,130
"21909","2100-2159",2021-07-19,47,1,75,122
"21910","2100-2159",2021-07-20,45,2,69,114
"21911","2100-2159",2021-07-21,48,3,76,124
"21912","2100-2159",2021-07-22,51,4,77,128
"21913","2100-2159",2021-07-23,48,5,74,122
"21914","2100-2159",2021-07-24,44,6,72,116
"21915","2100-2159",2021-07-25,52,7,78,130
"21916","2100-2159",2021-07-26,47,1,75,122
"21917","2100-2159",2021-07-27,45,2,69,114
"21918","2100-2159",2021-07-28,48,3,76,124
"21919","2100-2159",2021-07-29,51,4,77,128
"21920","2100-2159",2021-07-30,48,5,74,122
"21921","2100-2159",2021-07-31,45,6,73,118
"21922","2200-2259",2021-07-01,52,4,78,130
"21923","2200-2259",2021-07-02,45,5,83,128
"21924","2200-2259",2021-07-03,31,6,69,100
"21925","2200-2259",2021-07-04,37,7,61,98
"21926","2200-2259",2021-07-05,45,1,82,127
"21927","2200-2259",2021-07-06,35,2,76,111
"21928","2200-2259",2021-07-07,40,3,71,111
"21929","2200-2259",2021-07-08,49,4,72,121
"21930","2200-2259",2021-07-09,45,5,74,119
"21931","2200-2259",2021-07-10,37,6,66,103
"21932","2200-2259",2021-07-11,50,7,66,116
"21933","2200-2259",2021-07-12,44,1,72,116
"21934","2200-2259",2021-07-13,35,2,70,105
"21935","2200-2259",2021-07-14,39,3,71,110
"21936","2200-2259",2021-07-15,49,4,72,121
"21937","2200-2259",2021-07-16,44,5,73,117
"21938","2200-2259",2021-07-17,37,6,65,102
"21939","2200-2259",2021-07-18,49,7,67,116
"21940","2200-2259",2021-07-19,43,1,71,114
"21941","2200-2259",2021-07-20,35,2,69,104
"21942","2200-2259",2021-07-21,39,3,70,109
"21943","2200-2259",2021-07-22,49,4,72,121
"21944","2200-2259",2021-07-23,44,5,73,117
"21945","2200-2259",2021-07-24,37,6,65,102
"21946","2200-2259",2021-07-25,49,7,67,116
"21947","2200-2259",2021-07-26,43,1,71,114
"21948","2200-2259",2021-07-27,35,2,69,104
"21949","2200-2259",2021-07-28,38,3,70,108
"21950","2200-2259",2021-07-29,48,4,72,120
"21951","2200-2259",2021-07-30,43,5,73,116
"21952","2200-2259",2021-07-31,35,6,66,101
"21953","2300-2359",2021-07-01,26,4,68,94
"21954","2300-2359",2021-07-02,26,5,68,94
"21955","2300-2359",2021-07-03,22,6,52,74
"21956","2300-2359",2021-07-04,20,7,59,79
"21957","2300-2359",2021-07-05,25,1,68,93
"21958","2300-2359",2021-07-06,21,2,55,76
"21959","2300-2359",2021-07-07,22,3,65,87
"21960","2300-2359",2021-07-08,28,4,73,101
"21961","2300-2359",2021-07-09,28,5,73,101
"21962","2300-2359",2021-07-10,25,6,56,81
"21963","2300-2359",2021-07-11,26,7,80,106
"21964","2300-2359",2021-07-12,26,1,71,97
"21965","2300-2359",2021-07-13,21,2,62,83
"21966","2300-2359",2021-07-14,22,3,67,89
"21967","2300-2359",2021-07-15,27,4,75,102
"21968","2300-2359",2021-07-16,28,5,73,101
"21969","2300-2359",2021-07-17,25,6,56,81
"21970","2300-2359",2021-07-18,26,7,80,106
"21971","2300-2359",2021-07-19,26,1,72,98
"21972","2300-2359",2021-07-20,21,2,63,84
"21973","2300-2359",2021-07-21,22,3,68,90
"21974","2300-2359",2021-07-22,27,4,75,102
"21975","2300-2359",2021-07-23,28,5,73,101
"21976","2300-2359",2021-07-24,25,6,55,80
"21977","2300-2359",2021-07-25,26,7,80,106
"21978","2300-2359",2021-07-26,26,1,72,98
"21979","2300-2359",2021-07-27,21,2,63,84
"21980","2300-2359",2021-07-28,22,3,69,91
"21981","2300-2359",2021-07-29,27,4,76,103
"21982","2300-2359",2021-07-30,28,5,74,102
"21983","2300-2359",2021-07-31,25,6,56,81
"21984","0001-0559",2021-08-01,14,7,46,60
"21985","0001-0559",2021-08-02,21,1,47,68
"21986","0001-0559",2021-08-03,16,2,35,51
"21987","0001-0559",2021-08-04,18,3,35,53
"21988","0001-0559",2021-08-05,19,4,48,67
"21989","0001-0559",2021-08-06,21,5,49,70
"21990","0001-0559",2021-08-07,20,6,39,59
"21991","0001-0559",2021-08-08,14,7,45,59
"21992","0001-0559",2021-08-09,21,1,47,68
"21993","0001-0559",2021-08-10,16,2,35,51
"21994","0001-0559",2021-08-11,18,3,37,55
"21995","0001-0559",2021-08-12,19,4,48,67
"21996","0001-0559",2021-08-13,21,5,49,70
"21997","0001-0559",2021-08-14,20,6,39,59
"21998","0001-0559",2021-08-15,14,7,46,60
"21999","0001-0559",2021-08-16,21,1,47,68
"22000","0001-0559",2021-08-17,16,2,35,51
"22001","0001-0559",2021-08-18,18,3,37,55
"22002","0001-0559",2021-08-19,20,4,49,69
"22003","0001-0559",2021-08-20,22,5,50,72
"22004","0001-0559",2021-08-21,20,6,39,59
"22005","0001-0559",2021-08-22,13,7,44,57
"22006","0001-0559",2021-08-23,23,1,46,69
"22007","0001-0559",2021-08-24,16,2,33,49
"22008","0001-0559",2021-08-25,18,3,37,55
"22009","0001-0559",2021-08-26,20,4,49,69
"22010","0001-0559",2021-08-27,22,5,50,72
"22011","0001-0559",2021-08-28,20,6,39,59
"22012","0001-0559",2021-08-29,13,7,44,57
"22013","0001-0559",2021-08-30,23,1,47,70
"22014","0001-0559",2021-08-31,15,2,32,47
"22015","0600-0659",2021-08-01,75,7,31,106
"22016","0600-0659",2021-08-02,76,1,30,106
"22017","0600-0659",2021-08-03,73,2,27,100
"22018","0600-0659",2021-08-04,73,3,28,101
"22019","0600-0659",2021-08-05,80,4,29,109
"22020","0600-0659",2021-08-06,80,5,31,111
"22021","0600-0659",2021-08-07,74,6,30,104
"22022","0600-0659",2021-08-08,78,7,28,106
"22023","0600-0659",2021-08-09,80,1,31,111
"22024","0600-0659",2021-08-10,75,2,26,101
"22025","0600-0659",2021-08-11,75,3,26,101
"22026","0600-0659",2021-08-12,81,4,30,111
"22027","0600-0659",2021-08-13,80,5,31,111
"22028","0600-0659",2021-08-14,74,6,30,104
"22029","0600-0659",2021-08-15,78,7,28,106
"22030","0600-0659",2021-08-16,79,1,31,110
"22031","0600-0659",2021-08-17,77,2,22,99
"22032","0600-0659",2021-08-18,79,3,25,104
"22033","0600-0659",2021-08-19,86,4,29,115
"22034","0600-0659",2021-08-20,88,5,29,117
"22035","0600-0659",2021-08-21,71,6,29,100
"22036","0600-0659",2021-08-22,84,7,27,111
"22037","0600-0659",2021-08-23,88,1,28,116
"22038","0600-0659",2021-08-24,81,2,24,105
"22039","0600-0659",2021-08-25,79,3,25,104
"22040","0600-0659",2021-08-26,86,4,29,115
"22041","0600-0659",2021-08-27,88,5,29,117
"22042","0600-0659",2021-08-28,71,6,29,100
"22043","0600-0659",2021-08-29,84,7,27,111
"22044","0600-0659",2021-08-30,88,1,28,116
"22045","0600-0659",2021-08-31,81,2,24,105
"22046","0700-0759",2021-08-01,99,7,54,153
"22047","0700-0759",2021-08-02,102,1,59,161
"22048","0700-0759",2021-08-03,99,2,54,153
"22049","0700-0759",2021-08-04,96,3,56,152
"22050","0700-0759",2021-08-05,100,4,61,161
"22051","0700-0759",2021-08-06,101,5,59,160
"22052","0700-0759",2021-08-07,92,6,55,147
"22053","0700-0759",2021-08-08,99,7,54,153
"22054","0700-0759",2021-08-09,101,1,59,160
"22055","0700-0759",2021-08-10,99,2,54,153
"22056","0700-0759",2021-08-11,95,3,56,151
"22057","0700-0759",2021-08-12,101,4,61,162
"22058","0700-0759",2021-08-13,101,5,59,160
"22059","0700-0759",2021-08-14,92,6,55,147
"22060","0700-0759",2021-08-15,98,7,55,153
"22061","0700-0759",2021-08-16,101,1,57,158
"22062","0700-0759",2021-08-17,92,2,52,144
"22063","0700-0759",2021-08-18,88,3,55,143
"22064","0700-0759",2021-08-19,98,4,59,157
"22065","0700-0759",2021-08-20,94,5,59,153
"22066","0700-0759",2021-08-21,86,6,46,132
"22067","0700-0759",2021-08-22,96,7,54,150
"22068","0700-0759",2021-08-23,94,1,59,153
"22069","0700-0759",2021-08-24,93,2,51,144
"22070","0700-0759",2021-08-25,87,3,55,142
"22071","0700-0759",2021-08-26,98,4,59,157
"22072","0700-0759",2021-08-27,95,5,60,155
"22073","0700-0759",2021-08-28,86,6,47,133
"22074","0700-0759",2021-08-29,96,7,54,150
"22075","0700-0759",2021-08-30,95,1,59,154
"22076","0700-0759",2021-08-31,92,2,51,143
"22077","0800-0859",2021-08-01,88,7,49,137
"22078","0800-0859",2021-08-02,89,1,52,141
"22079","0800-0859",2021-08-03,86,2,53,139
"22080","0800-0859",2021-08-04,89,3,51,140
"22081","0800-0859",2021-08-05,88,4,57,145
"22082","0800-0859",2021-08-06,88,5,56,144
"22083","0800-0859",2021-08-07,78,6,51,129
"22084","0800-0859",2021-08-08,85,7,53,138
"22085","0800-0859",2021-08-09,88,1,55,143
"22086","0800-0859",2021-08-10,85,2,55,140
"22087","0800-0859",2021-08-11,88,3,53,141
"22088","0800-0859",2021-08-12,87,4,57,144
"22089","0800-0859",2021-08-13,88,5,56,144
"22090","0800-0859",2021-08-14,79,6,51,130
"22091","0800-0859",2021-08-15,85,7,53,138
"22092","0800-0859",2021-08-16,88,1,55,143
"22093","0800-0859",2021-08-17,85,2,50,135
"22094","0800-0859",2021-08-18,89,3,51,140
"22095","0800-0859",2021-08-19,91,4,58,149
"22096","0800-0859",2021-08-20,91,5,57,148
"22097","0800-0859",2021-08-21,86,6,51,137
"22098","0800-0859",2021-08-22,85,7,55,140
"22099","0800-0859",2021-08-23,91,1,56,147
"22100","0800-0859",2021-08-24,89,2,55,144
"22101","0800-0859",2021-08-25,89,3,51,140
"22102","0800-0859",2021-08-26,91,4,58,149
"22103","0800-0859",2021-08-27,91,5,57,148
"22104","0800-0859",2021-08-28,86,6,50,136
"22105","0800-0859",2021-08-29,85,7,55,140
"22106","0800-0859",2021-08-30,91,1,56,147
"22107","0800-0859",2021-08-31,89,2,55,144
"22108","0900-0959",2021-08-01,72,7,62,134
"22109","0900-0959",2021-08-02,77,1,62,139
"22110","0900-0959",2021-08-03,79,2,63,142
"22111","0900-0959",2021-08-04,79,3,59,138
"22112","0900-0959",2021-08-05,78,4,59,137
"22113","0900-0959",2021-08-06,79,5,59,138
"22114","0900-0959",2021-08-07,73,6,60,133
"22115","0900-0959",2021-08-08,75,7,57,132
"22116","0900-0959",2021-08-09,79,1,59,138
"22117","0900-0959",2021-08-10,81,2,61,142
"22118","0900-0959",2021-08-11,80,3,56,136
"22119","0900-0959",2021-08-12,78,4,59,137
"22120","0900-0959",2021-08-13,79,5,59,138
"22121","0900-0959",2021-08-14,73,6,60,133
"22122","0900-0959",2021-08-15,75,7,56,131
"22123","0900-0959",2021-08-16,79,1,59,138
"22124","0900-0959",2021-08-17,77,2,58,135
"22125","0900-0959",2021-08-18,77,3,53,130
"22126","0900-0959",2021-08-19,79,4,57,136
"22127","0900-0959",2021-08-20,78,5,55,133
"22128","0900-0959",2021-08-21,65,6,55,120
"22129","0900-0959",2021-08-22,76,7,54,130
"22130","0900-0959",2021-08-23,77,1,55,132
"22131","0900-0959",2021-08-24,79,2,56,135
"22132","0900-0959",2021-08-25,77,3,53,130
"22133","0900-0959",2021-08-26,79,4,57,136
"22134","0900-0959",2021-08-27,78,5,56,134
"22135","0900-0959",2021-08-28,65,6,56,121
"22136","0900-0959",2021-08-29,76,7,54,130
"22137","0900-0959",2021-08-30,77,1,56,133
"22138","0900-0959",2021-08-31,79,2,54,133
"22139","1000-1059",2021-08-01,66,7,48,114
"22140","1000-1059",2021-08-02,68,1,54,122
"22141","1000-1059",2021-08-03,62,2,51,113
"22142","1000-1059",2021-08-04,56,3,53,109
"22143","1000-1059",2021-08-05,68,4,56,124
"22144","1000-1059",2021-08-06,67,5,57,124
"22145","1000-1059",2021-08-07,56,6,51,107
"22146","1000-1059",2021-08-08,67,7,54,121
"22147","1000-1059",2021-08-09,68,1,57,125
"22148","1000-1059",2021-08-10,61,2,54,115
"22149","1000-1059",2021-08-11,57,3,56,113
"22150","1000-1059",2021-08-12,68,4,56,124
"22151","1000-1059",2021-08-13,67,5,57,124
"22152","1000-1059",2021-08-14,56,6,51,107
"22153","1000-1059",2021-08-15,65,7,54,119
"22154","1000-1059",2021-08-16,68,1,57,125
"22155","1000-1059",2021-08-17,64,2,55,119
"22156","1000-1059",2021-08-18,64,3,58,122
"22157","1000-1059",2021-08-19,73,4,61,134
"22158","1000-1059",2021-08-20,73,5,62,135
"22159","1000-1059",2021-08-21,65,6,55,120
"22160","1000-1059",2021-08-22,71,7,58,129
"22161","1000-1059",2021-08-23,72,1,62,134
"22162","1000-1059",2021-08-24,65,2,60,125
"22163","1000-1059",2021-08-25,64,3,57,121
"22164","1000-1059",2021-08-26,73,4,61,134
"22165","1000-1059",2021-08-27,73,5,62,135
"22166","1000-1059",2021-08-28,65,6,55,120
"22167","1000-1059",2021-08-29,71,7,58,129
"22168","1000-1059",2021-08-30,73,1,62,135
"22169","1000-1059",2021-08-31,64,2,60,124
"22170","1100-1159",2021-08-01,55,7,59,114
"22171","1100-1159",2021-08-02,62,1,64,126
"22172","1100-1159",2021-08-03,64,2,61,125
"22173","1100-1159",2021-08-04,66,3,61,127
"22174","1100-1159",2021-08-05,63,4,64,127
"22175","1100-1159",2021-08-06,65,5,62,127
"22176","1100-1159",2021-08-07,52,6,57,109
"22177","1100-1159",2021-08-08,56,7,56,112
"22178","1100-1159",2021-08-09,64,1,62,126
"22179","1100-1159",2021-08-10,67,2,59,126
"22180","1100-1159",2021-08-11,68,3,58,126
"22181","1100-1159",2021-08-12,63,4,63,126
"22182","1100-1159",2021-08-13,65,5,62,127
"22183","1100-1159",2021-08-14,52,6,57,109
"22184","1100-1159",2021-08-15,56,7,56,112
"22185","1100-1159",2021-08-16,64,1,62,126
"22186","1100-1159",2021-08-17,65,2,59,124
"22187","1100-1159",2021-08-18,63,3,58,121
"22188","1100-1159",2021-08-19,63,4,61,124
"22189","1100-1159",2021-08-20,64,5,62,126
"22190","1100-1159",2021-08-21,52,6,54,106
"22191","1100-1159",2021-08-22,58,7,53,111
"22192","1100-1159",2021-08-23,64,1,61,125
"22193","1100-1159",2021-08-24,66,2,57,123
"22194","1100-1159",2021-08-25,63,3,58,121
"22195","1100-1159",2021-08-26,63,4,61,124
"22196","1100-1159",2021-08-27,63,5,62,125
"22197","1100-1159",2021-08-28,52,6,54,106
"22198","1100-1159",2021-08-29,58,7,53,111
"22199","1100-1159",2021-08-30,64,1,61,125
"22200","1100-1159",2021-08-31,66,2,57,123
"22201","1200-1259",2021-08-01,62,7,65,127
"22202","1200-1259",2021-08-02,66,1,62,128
"22203","1200-1259",2021-08-03,61,2,57,118
"22204","1200-1259",2021-08-04,61,3,57,118
"22205","1200-1259",2021-08-05,63,4,64,127
"22206","1200-1259",2021-08-06,63,5,65,128
"22207","1200-1259",2021-08-07,61,6,57,118
"22208","1200-1259",2021-08-08,59,7,69,128
"22209","1200-1259",2021-08-09,63,1,65,128
"22210","1200-1259",2021-08-10,57,2,60,117
"22211","1200-1259",2021-08-11,58,3,61,119
"22212","1200-1259",2021-08-12,62,4,66,128
"22213","1200-1259",2021-08-13,63,5,65,128
"22214","1200-1259",2021-08-14,60,6,57,117
"22215","1200-1259",2021-08-15,58,7,70,128
"22216","1200-1259",2021-08-16,62,1,66,128
"22217","1200-1259",2021-08-17,54,2,60,114
"22218","1200-1259",2021-08-18,59,3,63,122
"22219","1200-1259",2021-08-19,60,4,69,129
"22220","1200-1259",2021-08-20,61,5,68,129
"22221","1200-1259",2021-08-21,52,6,60,112
"22222","1200-1259",2021-08-22,57,7,71,128
"22223","1200-1259",2021-08-23,59,1,68,127
"22224","1200-1259",2021-08-24,54,2,64,118
"22225","1200-1259",2021-08-25,59,3,63,122
"22226","1200-1259",2021-08-26,60,4,69,129
"22227","1200-1259",2021-08-27,61,5,68,129
"22228","1200-1259",2021-08-28,52,6,60,112
"22229","1200-1259",2021-08-29,57,7,71,128
"22230","1200-1259",2021-08-30,59,1,68,127
"22231","1200-1259",2021-08-31,54,2,64,118
"22232","1300-1359",2021-08-01,72,7,64,136
"22233","1300-1359",2021-08-02,72,1,71,143
"22234","1300-1359",2021-08-03,70,2,72,142
"22235","1300-1359",2021-08-04,69,3,70,139
"22236","1300-1359",2021-08-05,77,4,70,147
"22237","1300-1359",2021-08-06,75,5,69,144
"22238","1300-1359",2021-08-07,64,6,56,120
"22239","1300-1359",2021-08-08,75,7,63,138
"22240","1300-1359",2021-08-09,75,1,69,144
"22241","1300-1359",2021-08-10,73,2,70,143
"22242","1300-1359",2021-08-11,71,3,68,139
"22243","1300-1359",2021-08-12,77,4,69,146
"22244","1300-1359",2021-08-13,74,5,69,143
"22245","1300-1359",2021-08-14,64,6,56,120
"22246","1300-1359",2021-08-15,75,7,60,135
"22247","1300-1359",2021-08-16,75,1,68,143
"22248","1300-1359",2021-08-17,65,2,58,123
"22249","1300-1359",2021-08-18,65,3,59,124
"22250","1300-1359",2021-08-19,71,4,60,131
"22251","1300-1359",2021-08-20,69,5,60,129
"22252","1300-1359",2021-08-21,62,6,50,112
"22253","1300-1359",2021-08-22,68,7,57,125
"22254","1300-1359",2021-08-23,70,1,59,129
"22255","1300-1359",2021-08-24,66,2,61,127
"22256","1300-1359",2021-08-25,65,3,59,124
"22257","1300-1359",2021-08-26,71,4,60,131
"22258","1300-1359",2021-08-27,69,5,60,129
"22259","1300-1359",2021-08-28,62,6,50,112
"22260","1300-1359",2021-08-29,68,7,57,125
"22261","1300-1359",2021-08-30,70,1,60,130
"22262","1300-1359",2021-08-31,65,2,60,125
"22263","1400-1459",2021-08-01,46,7,63,109
"22264","1400-1459",2021-08-02,48,1,66,114
"22265","1400-1459",2021-08-03,47,2,63,110
"22266","1400-1459",2021-08-04,51,3,66,117
"22267","1400-1459",2021-08-05,48,4,65,113
"22268","1400-1459",2021-08-06,48,5,66,114
"22269","1400-1459",2021-08-07,44,6,60,104
"22270","1400-1459",2021-08-08,48,7,62,110
"22271","1400-1459",2021-08-09,48,1,67,115
"22272","1400-1459",2021-08-10,47,2,63,110
"22273","1400-1459",2021-08-11,51,3,67,118
"22274","1400-1459",2021-08-12,48,4,64,112
"22275","1400-1459",2021-08-13,48,5,65,113
"22276","1400-1459",2021-08-14,44,6,59,103
"22277","1400-1459",2021-08-15,47,7,61,108
"22278","1400-1459",2021-08-16,48,1,66,114
"22279","1400-1459",2021-08-17,53,2,70,123
"22280","1400-1459",2021-08-18,53,3,73,126
"22281","1400-1459",2021-08-19,53,4,71,124
"22282","1400-1459",2021-08-20,54,5,72,126
"22283","1400-1459",2021-08-21,46,6,65,111
"22284","1400-1459",2021-08-22,55,7,66,121
"22285","1400-1459",2021-08-23,53,1,74,127
"22286","1400-1459",2021-08-24,54,2,69,123
"22287","1400-1459",2021-08-25,53,3,73,126
"22288","1400-1459",2021-08-26,53,4,71,124
"22289","1400-1459",2021-08-27,54,5,72,126
"22290","1400-1459",2021-08-28,46,6,65,111
"22291","1400-1459",2021-08-29,55,7,66,121
"22292","1400-1459",2021-08-30,54,1,74,128
"22293","1400-1459",2021-08-31,53,2,69,122
"22294","1500-1559",2021-08-01,81,7,49,130
"22295","1500-1559",2021-08-02,82,1,54,136
"22296","1500-1559",2021-08-03,74,2,49,123
"22297","1500-1559",2021-08-04,77,3,50,127
"22298","1500-1559",2021-08-05,84,4,56,140
"22299","1500-1559",2021-08-06,84,5,56,140
"22300","1500-1559",2021-08-07,71,6,40,111
"22301","1500-1559",2021-08-08,79,7,52,131
"22302","1500-1559",2021-08-09,82,1,55,137
"22303","1500-1559",2021-08-10,70,2,51,121
"22304","1500-1559",2021-08-11,74,3,50,124
"22305","1500-1559",2021-08-12,82,4,56,138
"22306","1500-1559",2021-08-13,82,5,56,138
"22307","1500-1559",2021-08-14,70,6,40,110
"22308","1500-1559",2021-08-15,78,7,52,130
"22309","1500-1559",2021-08-16,81,1,55,136
"22310","1500-1559",2021-08-17,67,2,52,119
"22311","1500-1559",2021-08-18,68,3,51,119
"22312","1500-1559",2021-08-19,78,4,63,141
"22313","1500-1559",2021-08-20,75,5,61,136
"22314","1500-1559",2021-08-21,63,6,48,111
"22315","1500-1559",2021-08-22,73,7,60,133
"22316","1500-1559",2021-08-23,73,1,59,132
"22317","1500-1559",2021-08-24,67,2,54,121
"22318","1500-1559",2021-08-25,68,3,51,119
"22319","1500-1559",2021-08-26,78,4,63,141
"22320","1500-1559",2021-08-27,75,5,61,136
"22321","1500-1559",2021-08-28,63,6,48,111
"22322","1500-1559",2021-08-29,73,7,60,133
"22323","1500-1559",2021-08-30,73,1,59,132
"22324","1500-1559",2021-08-31,67,2,54,121
"22325","1600-1659",2021-08-01,62,7,67,129
"22326","1600-1659",2021-08-02,62,1,71,133
"22327","1600-1659",2021-08-03,59,2,72,131
"22328","1600-1659",2021-08-04,60,3,75,135
"22329","1600-1659",2021-08-05,61,4,69,130
"22330","1600-1659",2021-08-06,63,5,71,134
"22331","1600-1659",2021-08-07,54,6,57,111
"22332","1600-1659",2021-08-08,64,7,67,131
"22333","1600-1659",2021-08-09,63,1,69,132
"22334","1600-1659",2021-08-10,61,2,71,132
"22335","1600-1659",2021-08-11,61,3,73,134
"22336","1600-1659",2021-08-12,61,4,68,129
"22337","1600-1659",2021-08-13,63,5,70,133
"22338","1600-1659",2021-08-14,54,6,58,112
"22339","1600-1659",2021-08-15,64,7,66,130
"22340","1600-1659",2021-08-16,63,1,69,132
"22341","1600-1659",2021-08-17,64,2,64,128
"22342","1600-1659",2021-08-18,68,3,61,129
"22343","1600-1659",2021-08-19,68,4,60,128
"22344","1600-1659",2021-08-20,69,5,62,131
"22345","1600-1659",2021-08-21,62,6,52,114
"22346","1600-1659",2021-08-22,71,7,59,130
"22347","1600-1659",2021-08-23,68,1,60,128
"22348","1600-1659",2021-08-24,65,2,61,126
"22349","1600-1659",2021-08-25,68,3,61,129
"22350","1600-1659",2021-08-26,68,4,60,128
"22351","1600-1659",2021-08-27,69,5,62,131
"22352","1600-1659",2021-08-28,62,6,52,114
"22353","1600-1659",2021-08-29,71,7,59,130
"22354","1600-1659",2021-08-30,68,1,61,129
"22355","1600-1659",2021-08-31,65,2,60,125
"22356","1700-1759",2021-08-01,59,7,71,130
"22357","1700-1759",2021-08-02,59,1,71,130
"22358","1700-1759",2021-08-03,57,2,67,124
"22359","1700-1759",2021-08-04,58,3,67,125
"22360","1700-1759",2021-08-05,59,4,71,130
"22361","1700-1759",2021-08-06,59,5,72,131
"22362","1700-1759",2021-08-07,46,6,71,117
"22363","1700-1759",2021-08-08,57,7,71,128
"22364","1700-1759",2021-08-09,59,1,72,131
"22365","1700-1759",2021-08-10,57,2,67,124
"22366","1700-1759",2021-08-11,58,3,68,126
"22367","1700-1759",2021-08-12,59,4,72,131
"22368","1700-1759",2021-08-13,59,5,72,131
"22369","1700-1759",2021-08-14,47,6,71,118
"22370","1700-1759",2021-08-15,56,7,71,127
"22371","1700-1759",2021-08-16,59,1,72,131
"22372","1700-1759",2021-08-17,50,2,70,120
"22373","1700-1759",2021-08-18,54,3,79,133
"22374","1700-1759",2021-08-19,55,4,78,133
"22375","1700-1759",2021-08-20,55,5,76,131
"22376","1700-1759",2021-08-21,42,6,66,108
"22377","1700-1759",2021-08-22,51,7,77,128
"22378","1700-1759",2021-08-23,53,1,76,129
"22379","1700-1759",2021-08-24,48,2,75,123
"22380","1700-1759",2021-08-25,54,3,79,133
"22381","1700-1759",2021-08-26,55,4,78,133
"22382","1700-1759",2021-08-27,55,5,76,131
"22383","1700-1759",2021-08-28,42,6,66,108
"22384","1700-1759",2021-08-29,51,7,77,128
"22385","1700-1759",2021-08-30,54,1,76,130
"22386","1700-1759",2021-08-31,47,2,75,122
"22387","1800-1859",2021-08-01,66,7,68,134
"22388","1800-1859",2021-08-02,68,1,66,134
"22389","1800-1859",2021-08-03,60,2,61,121
"22390","1800-1859",2021-08-04,63,3,60,123
"22391","1800-1859",2021-08-05,68,4,68,136
"22392","1800-1859",2021-08-06,70,5,67,137
"22393","1800-1859",2021-08-07,64,6,59,123
"22394","1800-1859",2021-08-08,67,7,67,134
"22395","1800-1859",2021-08-09,71,1,67,138
"22396","1800-1859",2021-08-10,61,2,61,122
"22397","1800-1859",2021-08-11,65,3,61,126
"22398","1800-1859",2021-08-12,68,4,67,135
"22399","1800-1859",2021-08-13,70,5,67,137
"22400","1800-1859",2021-08-14,64,6,59,123
"22401","1800-1859",2021-08-15,67,7,67,134
"22402","1800-1859",2021-08-16,71,1,67,138
"22403","1800-1859",2021-08-17,56,2,61,117
"22404","1800-1859",2021-08-18,59,3,61,120
"22405","1800-1859",2021-08-19,63,4,65,128
"22406","1800-1859",2021-08-20,66,5,65,131
"22407","1800-1859",2021-08-21,57,6,58,115
"22408","1800-1859",2021-08-22,65,7,64,129
"22409","1800-1859",2021-08-23,65,1,63,128
"22410","1800-1859",2021-08-24,58,2,60,118
"22411","1800-1859",2021-08-25,59,3,61,120
"22412","1800-1859",2021-08-26,63,4,65,128
"22413","1800-1859",2021-08-27,66,5,65,131
"22414","1800-1859",2021-08-28,57,6,58,115
"22415","1800-1859",2021-08-29,65,7,64,129
"22416","1800-1859",2021-08-30,65,1,63,128
"22417","1800-1859",2021-08-31,58,2,59,117
"22418","1900-1959",2021-08-01,73,7,70,143
"22419","1900-1959",2021-08-02,74,1,71,145
"22420","1900-1959",2021-08-03,66,2,67,133
"22421","1900-1959",2021-08-04,67,3,68,135
"22422","1900-1959",2021-08-05,77,4,67,144
"22423","1900-1959",2021-08-06,77,5,70,147
"22424","1900-1959",2021-08-07,67,6,59,126
"22425","1900-1959",2021-08-08,74,7,69,143
"22426","1900-1959",2021-08-09,76,1,69,145
"22427","1900-1959",2021-08-10,67,2,64,131
"22428","1900-1959",2021-08-11,69,3,66,135
"22429","1900-1959",2021-08-12,76,4,67,143
"22430","1900-1959",2021-08-13,77,5,70,147
"22431","1900-1959",2021-08-14,67,6,60,127
"22432","1900-1959",2021-08-15,74,7,69,143
"22433","1900-1959",2021-08-16,76,1,69,145
"22434","1900-1959",2021-08-17,69,2,62,131
"22435","1900-1959",2021-08-18,73,3,63,136
"22436","1900-1959",2021-08-19,81,4,65,146
"22437","1900-1959",2021-08-20,80,5,67,147
"22438","1900-1959",2021-08-21,68,6,57,125
"22439","1900-1959",2021-08-22,76,7,66,142
"22440","1900-1959",2021-08-23,76,1,66,142
"22441","1900-1959",2021-08-24,70,2,64,134
"22442","1900-1959",2021-08-25,73,3,63,136
"22443","1900-1959",2021-08-26,81,4,65,146
"22444","1900-1959",2021-08-27,80,5,66,146
"22445","1900-1959",2021-08-28,68,6,57,125
"22446","1900-1959",2021-08-29,77,7,66,143
"22447","1900-1959",2021-08-30,77,1,66,143
"22448","1900-1959",2021-08-31,69,2,64,133
"22449","2000-2059",2021-08-01,45,7,69,114
"22450","2000-2059",2021-08-02,50,1,74,124
"22451","2000-2059",2021-08-03,46,2,67,113
"22452","2000-2059",2021-08-04,46,3,69,115
"22453","2000-2059",2021-08-05,49,4,77,126
"22454","2000-2059",2021-08-06,48,5,76,124
"22455","2000-2059",2021-08-07,42,6,66,108
"22456","2000-2059",2021-08-08,45,7,73,118
"22457","2000-2059",2021-08-09,49,1,78,127
"22458","2000-2059",2021-08-10,45,2,69,114
"22459","2000-2059",2021-08-11,46,3,71,117
"22460","2000-2059",2021-08-12,49,4,76,125
"22461","2000-2059",2021-08-13,48,5,76,124
"22462","2000-2059",2021-08-14,42,6,66,108
"22463","2000-2059",2021-08-15,45,7,72,117
"22464","2000-2059",2021-08-16,49,1,78,127
"22465","2000-2059",2021-08-17,44,2,66,110
"22466","2000-2059",2021-08-18,43,3,66,109
"22467","2000-2059",2021-08-19,45,4,74,119
"22468","2000-2059",2021-08-20,47,5,72,119
"22469","2000-2059",2021-08-21,36,6,63,99
"22470","2000-2059",2021-08-22,42,7,70,112
"22471","2000-2059",2021-08-23,48,1,71,119
"22472","2000-2059",2021-08-24,44,2,65,109
"22473","2000-2059",2021-08-25,43,3,66,109
"22474","2000-2059",2021-08-26,46,4,74,120
"22475","2000-2059",2021-08-27,48,5,72,120
"22476","2000-2059",2021-08-28,37,6,63,100
"22477","2000-2059",2021-08-29,42,7,70,112
"22478","2000-2059",2021-08-30,48,1,72,120
"22479","2000-2059",2021-08-31,44,2,63,107
"22480","2100-2159",2021-08-01,55,7,77,132
"22481","2100-2159",2021-08-02,50,1,73,123
"22482","2100-2159",2021-08-03,48,2,67,115
"22483","2100-2159",2021-08-04,51,3,74,125
"22484","2100-2159",2021-08-05,52,4,78,130
"22485","2100-2159",2021-08-06,51,5,75,126
"22486","2100-2159",2021-08-07,48,6,75,123
"22487","2100-2159",2021-08-08,53,7,79,132
"22488","2100-2159",2021-08-09,49,1,76,125
"22489","2100-2159",2021-08-10,46,2,69,115
"22490","2100-2159",2021-08-11,50,3,76,126
"22491","2100-2159",2021-08-12,52,4,78,130
"22492","2100-2159",2021-08-13,51,5,75,126
"22493","2100-2159",2021-08-14,48,6,75,123
"22494","2100-2159",2021-08-15,53,7,79,132
"22495","2100-2159",2021-08-16,48,1,76,124
"22496","2100-2159",2021-08-17,46,2,65,111
"22497","2100-2159",2021-08-18,44,3,71,115
"22498","2100-2159",2021-08-19,46,4,74,120
"22499","2100-2159",2021-08-20,44,5,74,118
"22500","2100-2159",2021-08-21,37,6,71,108
"22501","2100-2159",2021-08-22,47,7,74,121
"22502","2100-2159",2021-08-23,40,1,72,112
"22503","2100-2159",2021-08-24,42,2,65,107
"22504","2100-2159",2021-08-25,44,3,72,116
"22505","2100-2159",2021-08-26,46,4,74,120
"22506","2100-2159",2021-08-27,44,5,74,118
"22507","2100-2159",2021-08-28,37,6,71,108
"22508","2100-2159",2021-08-29,48,7,75,123
"22509","2100-2159",2021-08-30,41,1,73,114
"22510","2100-2159",2021-08-31,41,2,65,106
"22511","2200-2259",2021-08-01,46,7,70,116
"22512","2200-2259",2021-08-02,40,1,73,113
"22513","2200-2259",2021-08-03,33,2,71,104
"22514","2200-2259",2021-08-04,36,3,73,109
"22515","2200-2259",2021-08-05,45,4,71,116
"22516","2200-2259",2021-08-06,39,5,73,112
"22517","2200-2259",2021-08-07,32,6,60,92
"22518","2200-2259",2021-08-08,45,7,66,111
"22519","2200-2259",2021-08-09,39,1,72,111
"22520","2200-2259",2021-08-10,32,2,68,100
"22521","2200-2259",2021-08-11,35,3,70,105
"22522","2200-2259",2021-08-12,45,4,71,116
"22523","2200-2259",2021-08-13,39,5,73,112
"22524","2200-2259",2021-08-14,32,6,60,92
"22525","2200-2259",2021-08-15,45,7,66,111
"22526","2200-2259",2021-08-16,38,1,72,110
"22527","2200-2259",2021-08-17,28,2,70,98
"22528","2200-2259",2021-08-18,35,3,71,106
"22529","2200-2259",2021-08-19,43,4,74,117
"22530","2200-2259",2021-08-20,40,5,77,117
"22531","2200-2259",2021-08-21,32,6,57,89
"22532","2200-2259",2021-08-22,43,7,70,113
"22533","2200-2259",2021-08-23,38,1,74,112
"22534","2200-2259",2021-08-24,30,2,70,100
"22535","2200-2259",2021-08-25,35,3,70,105
"22536","2200-2259",2021-08-26,43,4,75,118
"22537","2200-2259",2021-08-27,40,5,77,117
"22538","2200-2259",2021-08-28,32,6,58,90
"22539","2200-2259",2021-08-29,43,7,70,113
"22540","2200-2259",2021-08-30,39,1,74,113
"22541","2200-2259",2021-08-31,30,2,70,100
"22542","2300-2359",2021-08-01,27,7,81,108
"22543","2300-2359",2021-08-02,28,1,74,102
"22544","2300-2359",2021-08-03,22,2,65,87
"22545","2300-2359",2021-08-04,24,3,68,92
"22546","2300-2359",2021-08-05,29,4,78,107
"22547","2300-2359",2021-08-06,30,5,75,105
"22548","2300-2359",2021-08-07,26,6,61,87
"22549","2300-2359",2021-08-08,27,7,82,109
"22550","2300-2359",2021-08-09,29,1,75,104
"22551","2300-2359",2021-08-10,22,2,65,87
"22552","2300-2359",2021-08-11,24,3,70,94
"22553","2300-2359",2021-08-12,29,4,77,106
"22554","2300-2359",2021-08-13,30,5,74,104
"22555","2300-2359",2021-08-14,26,6,60,86
"22556","2300-2359",2021-08-15,29,7,81,110
"22557","2300-2359",2021-08-16,28,1,72,100
"22558","2300-2359",2021-08-17,19,2,62,81
"22559","2300-2359",2021-08-18,22,3,66,88
"22560","2300-2359",2021-08-19,27,4,73,100
"22561","2300-2359",2021-08-20,28,5,70,98
"22562","2300-2359",2021-08-21,23,6,49,72
"22563","2300-2359",2021-08-22,26,7,78,104
"22564","2300-2359",2021-08-23,24,1,67,91
"22565","2300-2359",2021-08-24,19,2,62,81
"22566","2300-2359",2021-08-25,22,3,66,88
"22567","2300-2359",2021-08-26,27,4,73,100
"22568","2300-2359",2021-08-27,28,5,70,98
"22569","2300-2359",2021-08-28,24,6,49,73
"22570","2300-2359",2021-08-29,26,7,79,105
"22571","2300-2359",2021-08-30,24,1,68,92
"22572","2300-2359",2021-08-31,19,2,62,81
"22573","0001-0559",2021-09-01,18,3,37,55
"22574","0001-0559",2021-09-02,20,4,49,69
"22575","0001-0559",2021-09-03,22,5,50,72
"22576","0001-0559",2021-09-04,20,6,36,56
"22577","0001-0559",2021-09-05,12,7,40,52
"22578","0001-0559",2021-09-06,22,1,45,67
"22579","0001-0559",2021-09-07,12,2,33,45
"22580","0001-0559",2021-09-08,11,3,36,47
"22581","0001-0559",2021-09-09,13,4,49,62
"22582","0001-0559",2021-09-10,15,5,51,66
"22583","0001-0559",2021-09-11,13,6,36,49
"22584","0001-0559",2021-09-12,14,7,50,64
"22585","0001-0559",2021-09-13,16,1,45,61
"22586","0001-0559",2021-09-14,12,2,27,39
"22587","0001-0559",2021-09-15,13,3,33,46
"22588","0001-0559",2021-09-16,13,4,48,61
"22589","0001-0559",2021-09-17,16,5,49,65
"22590","0001-0559",2021-09-18,14,6,31,45
"22591","0001-0559",2021-09-19,13,7,52,65
"22592","0001-0559",2021-09-20,16,1,47,63
"22593","0001-0559",2021-09-21,12,2,27,39
"22594","0001-0559",2021-09-22,13,3,32,45
"22595","0001-0559",2021-09-23,13,4,49,62
"22596","0001-0559",2021-09-24,15,5,50,65
"22597","0001-0559",2021-09-25,14,6,31,45
"22598","0001-0559",2021-09-26,13,7,52,65
"22599","0001-0559",2021-09-27,16,1,47,63
"22600","0001-0559",2021-09-28,12,2,27,39
"22601","0001-0559",2021-09-29,13,3,32,45
"22602","0001-0559",2021-09-30,13,4,50,63
"22603","0600-0659",2021-09-01,79,3,25,104
"22604","0600-0659",2021-09-02,87,4,29,116
"22605","0600-0659",2021-09-03,88,5,29,117
"22606","0600-0659",2021-09-04,71,6,23,94
"22607","0600-0659",2021-09-05,71,7,25,96
"22608","0600-0659",2021-09-06,84,1,28,112
"22609","0600-0659",2021-09-07,83,2,25,108
"22610","0600-0659",2021-09-08,64,3,23,87
"22611","0600-0659",2021-09-09,76,4,25,101
"22612","0600-0659",2021-09-10,77,5,26,103
"22613","0600-0659",2021-09-11,67,6,27,94
"22614","0600-0659",2021-09-12,73,7,25,98
"22615","0600-0659",2021-09-13,79,1,23,102
"22616","0600-0659",2021-09-14,66,2,20,86
"22617","0600-0659",2021-09-15,66,3,25,91
"22618","0600-0659",2021-09-16,76,4,25,101
"22619","0600-0659",2021-09-17,78,5,26,104
"22620","0600-0659",2021-09-18,69,6,26,95
"22621","0600-0659",2021-09-19,76,7,26,102
"22622","0600-0659",2021-09-20,79,1,23,102
"22623","0600-0659",2021-09-21,66,2,20,86
"22624","0600-0659",2021-09-22,66,3,25,91
"22625","0600-0659",2021-09-23,76,4,25,101
"22626","0600-0659",2021-09-24,78,5,25,103
"22627","0600-0659",2021-09-25,69,6,26,95
"22628","0600-0659",2021-09-26,76,7,26,102
"22629","0600-0659",2021-09-27,79,1,23,102
"22630","0600-0659",2021-09-28,66,2,20,86
"22631","0600-0659",2021-09-29,66,3,25,91
"22632","0600-0659",2021-09-30,76,4,24,100
"22633","0700-0759",2021-09-01,87,3,55,142
"22634","0700-0759",2021-09-02,98,4,59,157
"22635","0700-0759",2021-09-03,95,5,60,155
"22636","0700-0759",2021-09-04,85,6,42,127
"22637","0700-0759",2021-09-05,91,7,48,139
"22638","0700-0759",2021-09-06,92,1,56,148
"22639","0700-0759",2021-09-07,90,2,50,140
"22640","0700-0759",2021-09-08,92,3,39,131
"22641","0700-0759",2021-09-09,103,4,49,152
"22642","0700-0759",2021-09-10,100,5,51,151
"22643","0700-0759",2021-09-11,97,6,47,144
"22644","0700-0759",2021-09-12,100,7,48,148
"22645","0700-0759",2021-09-13,99,1,56,155
"22646","0700-0759",2021-09-14,92,2,45,137
"22647","0700-0759",2021-09-15,92,3,44,136
"22648","0700-0759",2021-09-16,102,4,53,155
"22649","0700-0759",2021-09-17,99,5,55,154
"22650","0700-0759",2021-09-18,98,6,50,148
"22651","0700-0759",2021-09-19,100,7,53,153
"22652","0700-0759",2021-09-20,99,1,56,155
"22653","0700-0759",2021-09-21,92,2,45,137
"22654","0700-0759",2021-09-22,92,3,44,136
"22655","0700-0759",2021-09-23,103,4,53,156
"22656","0700-0759",2021-09-24,98,5,55,153
"22657","0700-0759",2021-09-25,97,6,50,147
"22658","0700-0759",2021-09-26,100,7,53,153
"22659","0700-0759",2021-09-27,99,1,56,155
"22660","0700-0759",2021-09-28,92,2,45,137
"22661","0700-0759",2021-09-29,92,3,44,136
"22662","0700-0759",2021-09-30,102,4,53,155
"22663","0800-0859",2021-09-01,89,3,51,140
"22664","0800-0859",2021-09-02,91,4,58,149
"22665","0800-0859",2021-09-03,92,5,57,149
"22666","0800-0859",2021-09-04,87,6,50,137
"22667","0800-0859",2021-09-05,86,7,49,135
"22668","0800-0859",2021-09-06,93,1,54,147
"22669","0800-0859",2021-09-07,93,2,52,145
"22670","0800-0859",2021-09-08,83,3,45,128
"22671","0800-0859",2021-09-09,89,4,52,141
"22672","0800-0859",2021-09-10,92,5,50,142
"22673","0800-0859",2021-09-11,84,6,45,129
"22674","0800-0859",2021-09-12,87,7,46,133
"22675","0800-0859",2021-09-13,92,1,47,139
"22676","0800-0859",2021-09-14,91,2,45,136
"22677","0800-0859",2021-09-15,86,3,43,129
"22678","0800-0859",2021-09-16,88,4,48,136
"22679","0800-0859",2021-09-17,91,5,48,139
"22680","0800-0859",2021-09-18,84,6,45,129
"22681","0800-0859",2021-09-19,88,7,45,133
"22682","0800-0859",2021-09-20,90,1,48,138
"22683","0800-0859",2021-09-21,90,2,45,135
"22684","0800-0859",2021-09-22,85,3,43,128
"22685","0800-0859",2021-09-23,88,4,49,137
"22686","0800-0859",2021-09-24,91,5,48,139
"22687","0800-0859",2021-09-25,84,6,44,128
"22688","0800-0859",2021-09-26,88,7,45,133
"22689","0800-0859",2021-09-27,90,1,48,138
"22690","0800-0859",2021-09-28,90,2,45,135
"22691","0800-0859",2021-09-29,85,3,43,128
"22692","0800-0859",2021-09-30,88,4,48,136
"22693","0900-0959",2021-09-01,77,3,53,130
"22694","0900-0959",2021-09-02,80,4,57,137
"22695","0900-0959",2021-09-03,80,5,56,136
"22696","0900-0959",2021-09-04,65,6,54,119
"22697","0900-0959",2021-09-05,71,7,54,125
"22698","0900-0959",2021-09-06,75,1,54,129
"22699","0900-0959",2021-09-07,76,2,57,133
"22700","0900-0959",2021-09-08,71,3,58,129
"22701","0900-0959",2021-09-09,79,4,69,148
"22702","0900-0959",2021-09-10,81,5,67,148
"22703","0900-0959",2021-09-11,69,6,61,130
"22704","0900-0959",2021-09-12,75,7,65,140
"22705","0900-0959",2021-09-13,79,1,68,147
"22706","0900-0959",2021-09-14,71,2,56,127
"22707","0900-0959",2021-09-15,74,3,56,130
"22708","0900-0959",2021-09-16,77,4,66,143
"22709","0900-0959",2021-09-17,79,5,66,145
"22710","0900-0959",2021-09-18,67,6,61,128
"22711","0900-0959",2021-09-19,72,7,66,138
"22712","0900-0959",2021-09-20,78,1,67,145
"22713","0900-0959",2021-09-21,71,2,56,127
"22714","0900-0959",2021-09-22,74,3,56,130
"22715","0900-0959",2021-09-23,77,4,66,143
"22716","0900-0959",2021-09-24,79,5,65,144
"22717","0900-0959",2021-09-25,68,6,61,129
"22718","0900-0959",2021-09-26,72,7,66,138
"22719","0900-0959",2021-09-27,78,1,67,145
"22720","0900-0959",2021-09-28,71,2,56,127
"22721","0900-0959",2021-09-29,74,3,56,130
"22722","0900-0959",2021-09-30,77,4,66,143
"22723","1000-1059",2021-09-01,63,3,57,120
"22724","1000-1059",2021-09-02,73,4,61,134
"22725","1000-1059",2021-09-03,73,5,63,136
"22726","1000-1059",2021-09-04,62,6,56,118
"22727","1000-1059",2021-09-05,70,7,52,122
"22728","1000-1059",2021-09-06,74,1,62,136
"22729","1000-1059",2021-09-07,69,2,60,129
"22730","1000-1059",2021-09-08,59,3,44,103
"22731","1000-1059",2021-09-09,73,4,46,119
"22732","1000-1059",2021-09-10,75,5,50,125
"22733","1000-1059",2021-09-11,59,6,50,109
"22734","1000-1059",2021-09-12,70,7,45,115
"22735","1000-1059",2021-09-13,77,1,50,127
"22736","1000-1059",2021-09-14,66,2,49,115
"22737","1000-1059",2021-09-15,65,3,51,116
"22738","1000-1059",2021-09-16,75,4,48,123
"22739","1000-1059",2021-09-17,76,5,51,127
"22740","1000-1059",2021-09-18,63,6,49,112
"22741","1000-1059",2021-09-19,73,7,44,117
"22742","1000-1059",2021-09-20,76,1,50,126
"22743","1000-1059",2021-09-21,66,2,49,115
"22744","1000-1059",2021-09-22,65,3,51,116
"22745","1000-1059",2021-09-23,75,4,48,123
"22746","1000-1059",2021-09-24,76,5,52,128
"22747","1000-1059",2021-09-25,63,6,49,112
"22748","1000-1059",2021-09-26,74,7,44,118
"22749","1000-1059",2021-09-27,76,1,50,126
"22750","1000-1059",2021-09-28,66,2,49,115
"22751","1000-1059",2021-09-29,65,3,51,116
"22752","1000-1059",2021-09-30,75,4,48,123
"22753","1100-1159",2021-09-01,63,3,58,121
"22754","1100-1159",2021-09-02,63,4,61,124
"22755","1100-1159",2021-09-03,64,5,62,126
"22756","1100-1159",2021-09-04,49,6,52,101
"22757","1100-1159",2021-09-05,54,7,49,103
"22758","1100-1159",2021-09-06,59,1,58,117
"22759","1100-1159",2021-09-07,60,2,51,111
"22760","1100-1159",2021-09-08,60,3,49,109
"22761","1100-1159",2021-09-09,57,4,61,118
"22762","1100-1159",2021-09-10,56,5,62,118
"22763","1100-1159",2021-09-11,53,6,49,102
"22764","1100-1159",2021-09-12,58,7,63,121
"22765","1100-1159",2021-09-13,54,1,63,117
"22766","1100-1159",2021-09-14,57,2,59,116
"22767","1100-1159",2021-09-15,57,3,56,113
"22768","1100-1159",2021-09-16,53,4,62,115
"22769","1100-1159",2021-09-17,56,5,63,119
"22770","1100-1159",2021-09-18,55,6,51,106
"22771","1100-1159",2021-09-19,58,7,66,124
"22772","1100-1159",2021-09-20,56,1,62,118
"22773","1100-1159",2021-09-21,58,2,59,117
"22774","1100-1159",2021-09-22,57,3,56,113
"22775","1100-1159",2021-09-23,54,4,62,116
"22776","1100-1159",2021-09-24,56,5,62,118
"22777","1100-1159",2021-09-25,55,6,51,106
"22778","1100-1159",2021-09-26,58,7,66,124
"22779","1100-1159",2021-09-27,56,1,62,118
"22780","1100-1159",2021-09-28,59,2,59,118
"22781","1100-1159",2021-09-29,58,3,56,114
"22782","1100-1159",2021-09-30,54,4,62,116
"22783","1200-1259",2021-09-01,59,3,63,122
"22784","1200-1259",2021-09-02,61,4,69,130
"22785","1200-1259",2021-09-03,61,5,68,129
"22786","1200-1259",2021-09-04,55,6,60,115
"22787","1200-1259",2021-09-05,52,7,70,122
"22788","1200-1259",2021-09-06,58,1,68,126
"22789","1200-1259",2021-09-07,56,2,68,124
"22790","1200-1259",2021-09-08,51,3,64,115
"22791","1200-1259",2021-09-09,59,4,70,129
"22792","1200-1259",2021-09-10,59,5,69,128
"22793","1200-1259",2021-09-11,44,6,70,114
"22794","1200-1259",2021-09-12,52,7,66,118
"22795","1200-1259",2021-09-13,59,1,72,131
"22796","1200-1259",2021-09-14,55,2,67,122
"22797","1200-1259",2021-09-15,56,3,68,124
"22798","1200-1259",2021-09-16,62,4,71,133
"22799","1200-1259",2021-09-17,60,5,70,130
"22800","1200-1259",2021-09-18,47,6,73,120
"22801","1200-1259",2021-09-19,57,7,69,126
"22802","1200-1259",2021-09-20,60,1,70,130
"22803","1200-1259",2021-09-21,55,2,67,122
"22804","1200-1259",2021-09-22,56,3,68,124
"22805","1200-1259",2021-09-23,63,4,71,134
"22806","1200-1259",2021-09-24,61,5,70,131
"22807","1200-1259",2021-09-25,47,6,74,121
"22808","1200-1259",2021-09-26,57,7,69,126
"22809","1200-1259",2021-09-27,60,1,70,130
"22810","1200-1259",2021-09-28,55,2,68,123
"22811","1200-1259",2021-09-29,56,3,69,125
"22812","1200-1259",2021-09-30,63,4,72,135
"22813","1300-1359",2021-09-01,65,3,59,124
"22814","1300-1359",2021-09-02,72,4,60,132
"22815","1300-1359",2021-09-03,69,5,60,129
"22816","1300-1359",2021-09-04,59,6,49,108
"22817","1300-1359",2021-09-05,67,7,56,123
"22818","1300-1359",2021-09-06,70,1,59,129
"22819","1300-1359",2021-09-07,58,2,56,114
"22820","1300-1359",2021-09-08,60,3,55,115
"22821","1300-1359",2021-09-09,72,4,60,132
"22822","1300-1359",2021-09-10,69,5,60,129
"22823","1300-1359",2021-09-11,65,6,47,112
"22824","1300-1359",2021-09-12,69,7,58,127
"22825","1300-1359",2021-09-13,73,1,63,136
"22826","1300-1359",2021-09-14,62,2,56,118
"22827","1300-1359",2021-09-15,63,3,57,120
"22828","1300-1359",2021-09-16,73,4,62,135
"22829","1300-1359",2021-09-17,73,5,64,137
"22830","1300-1359",2021-09-18,66,6,53,119
"22831","1300-1359",2021-09-19,70,7,59,129
"22832","1300-1359",2021-09-20,72,1,64,136
"22833","1300-1359",2021-09-21,61,2,56,117
"22834","1300-1359",2021-09-22,63,3,57,120
"22835","1300-1359",2021-09-23,72,4,63,135
"22836","1300-1359",2021-09-24,72,5,64,136
"22837","1300-1359",2021-09-25,65,6,52,117
"22838","1300-1359",2021-09-26,71,7,60,131
"22839","1300-1359",2021-09-27,72,1,64,136
"22840","1300-1359",2021-09-28,62,2,56,118
"22841","1300-1359",2021-09-29,63,3,57,120
"22842","1300-1359",2021-09-30,74,4,62,136
"22843","1400-1459",2021-09-01,53,3,73,126
"22844","1400-1459",2021-09-02,52,4,73,125
"22845","1400-1459",2021-09-03,54,5,72,126
"22846","1400-1459",2021-09-04,48,6,63,111
"22847","1400-1459",2021-09-05,51,7,63,114
"22848","1400-1459",2021-09-06,52,1,74,126
"22849","1400-1459",2021-09-07,57,2,69,126
"22850","1400-1459",2021-09-08,58,3,60,118
"22851","1400-1459",2021-09-09,59,4,63,122
"22852","1400-1459",2021-09-10,59,5,62,121
"22853","1400-1459",2021-09-11,49,6,58,107
"22854","1400-1459",2021-09-12,61,7,64,125
"22855","1400-1459",2021-09-13,59,1,63,122
"22856","1400-1459",2021-09-14,57,2,60,117
"22857","1400-1459",2021-09-15,62,3,61,123
"22858","1400-1459",2021-09-16,59,4,63,122
"22859","1400-1459",2021-09-17,60,5,63,123
"22860","1400-1459",2021-09-18,53,6,59,112
"22861","1400-1459",2021-09-19,63,7,66,129
"22862","1400-1459",2021-09-20,60,1,63,123
"22863","1400-1459",2021-09-21,58,2,60,118
"22864","1400-1459",2021-09-22,62,3,61,123
"22865","1400-1459",2021-09-23,60,4,63,123
"22866","1400-1459",2021-09-24,61,5,63,124
"22867","1400-1459",2021-09-25,53,6,60,113
"22868","1400-1459",2021-09-26,64,7,66,130
"22869","1400-1459",2021-09-27,60,1,63,123
"22870","1400-1459",2021-09-28,57,2,61,118
"22871","1400-1459",2021-09-29,61,3,62,123
"22872","1400-1459",2021-09-30,60,4,64,124
"22873","1500-1559",2021-09-01,68,3,51,119
"22874","1500-1559",2021-09-02,77,4,64,141
"22875","1500-1559",2021-09-03,74,5,62,136
"22876","1500-1559",2021-09-04,60,6,49,109
"22877","1500-1559",2021-09-05,67,7,55,122
"22878","1500-1559",2021-09-06,71,1,56,127
"22879","1500-1559",2021-09-07,61,2,53,114
"22880","1500-1559",2021-09-08,55,3,58,113
"22881","1500-1559",2021-09-09,66,4,72,138
"22882","1500-1559",2021-09-10,65,5,69,134
"22883","1500-1559",2021-09-11,51,6,52,103
"22884","1500-1559",2021-09-12,64,7,66,130
"22885","1500-1559",2021-09-13,62,1,68,130
"22886","1500-1559",2021-09-14,48,2,54,102
"22887","1500-1559",2021-09-15,52,3,57,109
"22888","1500-1559",2021-09-16,64,4,70,134
"22889","1500-1559",2021-09-17,63,5,68,131
"22890","1500-1559",2021-09-18,44,6,52,96
"22891","1500-1559",2021-09-19,60,7,63,123
"22892","1500-1559",2021-09-20,62,1,68,130
"22893","1500-1559",2021-09-21,49,2,54,103
"22894","1500-1559",2021-09-22,53,3,57,110
"22895","1500-1559",2021-09-23,64,4,70,134
"22896","1500-1559",2021-09-24,63,5,68,131
"22897","1500-1559",2021-09-25,45,6,50,95
"22898","1500-1559",2021-09-26,60,7,64,124
"22899","1500-1559",2021-09-27,62,1,68,130
"22900","1500-1559",2021-09-28,49,2,53,102
"22901","1500-1559",2021-09-29,53,3,55,108
"22902","1500-1559",2021-09-30,64,4,72,136
"22903","1600-1659",2021-09-01,68,3,61,129
"22904","1600-1659",2021-09-02,69,4,61,130
"22905","1600-1659",2021-09-03,69,5,61,130
"22906","1600-1659",2021-09-04,63,6,52,115
"22907","1600-1659",2021-09-05,68,7,57,125
"22908","1600-1659",2021-09-06,69,1,61,130
"22909","1600-1659",2021-09-07,64,2,60,124
"22910","1600-1659",2021-09-08,61,3,56,117
"22911","1600-1659",2021-09-09,67,4,57,124
"22912","1600-1659",2021-09-10,68,5,57,125
"22913","1600-1659",2021-09-11,57,6,54,111
"22914","1600-1659",2021-09-12,75,7,52,127
"22915","1600-1659",2021-09-13,67,1,54,121
"22916","1600-1659",2021-09-14,60,2,58,118
"22917","1600-1659",2021-09-15,59,3,56,115
"22918","1600-1659",2021-09-16,66,4,55,121
"22919","1600-1659",2021-09-17,67,5,55,122
"22920","1600-1659",2021-09-18,53,6,53,106
"22921","1600-1659",2021-09-19,72,7,54,126
"22922","1600-1659",2021-09-20,68,1,55,123
"22923","1600-1659",2021-09-21,61,2,59,120
"22924","1600-1659",2021-09-22,60,3,57,117
"22925","1600-1659",2021-09-23,67,4,56,123
"22926","1600-1659",2021-09-24,68,5,56,124
"22927","1600-1659",2021-09-25,52,6,54,106
"22928","1600-1659",2021-09-26,74,7,54,128
"22929","1600-1659",2021-09-27,68,1,55,123
"22930","1600-1659",2021-09-28,60,2,59,119
"22931","1600-1659",2021-09-29,58,3,57,115
"22932","1600-1659",2021-09-30,68,4,55,123
"22933","1700-1759",2021-09-01,54,3,79,133
"22934","1700-1759",2021-09-02,55,4,77,132
"22935","1700-1759",2021-09-03,56,5,77,133
"22936","1700-1759",2021-09-04,41,6,65,106
"22937","1700-1759",2021-09-05,45,7,79,124
"22938","1700-1759",2021-09-06,51,1,80,131
"22939","1700-1759",2021-09-07,51,2,76,127
"22940","1700-1759",2021-09-08,51,3,75,126
"22941","1700-1759",2021-09-09,60,4,77,137
"22942","1700-1759",2021-09-10,57,5,79,136
"22943","1700-1759",2021-09-11,48,6,67,115
"22944","1700-1759",2021-09-12,56,7,82,138
"22945","1700-1759",2021-09-13,62,1,77,139
"22946","1700-1759",2021-09-14,57,2,71,128
"22947","1700-1759",2021-09-15,59,3,77,136
"22948","1700-1759",2021-09-16,65,4,75,140
"22949","1700-1759",2021-09-17,63,5,76,139
"22950","1700-1759",2021-09-18,58,6,63,121
"22951","1700-1759",2021-09-19,63,7,82,145
"22952","1700-1759",2021-09-20,63,1,77,140
"22953","1700-1759",2021-09-21,57,2,72,129
"22954","1700-1759",2021-09-22,59,3,75,134
"22955","1700-1759",2021-09-23,65,4,75,140
"22956","1700-1759",2021-09-24,63,5,76,139
"22957","1700-1759",2021-09-25,57,6,64,121
"22958","1700-1759",2021-09-26,63,7,82,145
"22959","1700-1759",2021-09-27,63,1,77,140
"22960","1700-1759",2021-09-28,57,2,71,128
"22961","1700-1759",2021-09-29,59,3,74,133
"22962","1700-1759",2021-09-30,65,4,76,141
"22963","1800-1859",2021-09-01,59,3,60,119
"22964","1800-1859",2021-09-02,63,4,65,128
"22965","1800-1859",2021-09-03,66,5,65,131
"22966","1800-1859",2021-09-04,57,6,58,115
"22967","1800-1859",2021-09-05,63,7,58,121
"22968","1800-1859",2021-09-06,65,1,60,125
"22969","1800-1859",2021-09-07,58,2,58,116
"22970","1800-1859",2021-09-08,62,3,58,120
"22971","1800-1859",2021-09-09,66,4,60,126
"22972","1800-1859",2021-09-10,68,5,62,130
"22973","1800-1859",2021-09-11,54,6,54,108
"22974","1800-1859",2021-09-12,68,7,63,131
"22975","1800-1859",2021-09-13,61,1,65,126
"22976","1800-1859",2021-09-14,54,2,58,112
"22977","1800-1859",2021-09-15,56,3,60,116
"22978","1800-1859",2021-09-16,63,4,64,127
"22979","1800-1859",2021-09-17,62,5,65,127
"22980","1800-1859",2021-09-18,46,6,57,103
"22981","1800-1859",2021-09-19,65,7,64,129
"22982","1800-1859",2021-09-20,61,1,66,127
"22983","1800-1859",2021-09-21,54,2,58,112
"22984","1800-1859",2021-09-22,56,3,61,117
"22985","1800-1859",2021-09-23,63,4,64,127
"22986","1800-1859",2021-09-24,62,5,65,127
"22987","1800-1859",2021-09-25,47,6,57,104
"22988","1800-1859",2021-09-26,65,7,65,130
"22989","1800-1859",2021-09-27,61,1,66,127
"22990","1800-1859",2021-09-28,54,2,58,112
"22991","1800-1859",2021-09-29,56,3,61,117
"22992","1800-1859",2021-09-30,64,4,64,128
"22993","1900-1959",2021-09-01,73,3,63,136
"22994","1900-1959",2021-09-02,81,4,65,146
"22995","1900-1959",2021-09-03,78,5,68,146
"22996","1900-1959",2021-09-04,65,6,53,118
"22997","1900-1959",2021-09-05,75,7,61,136
"22998","1900-1959",2021-09-06,73,1,64,137
"22999","1900-1959",2021-09-07,68,2,62,130
"23000","1900-1959",2021-09-08,57,3,53,110
"23001","1900-1959",2021-09-09,64,4,61,125
"23002","1900-1959",2021-09-10,63,5,60,123
"23003","1900-1959",2021-09-11,59,6,48,107
"23004","1900-1959",2021-09-12,63,7,60,123
"23005","1900-1959",2021-09-13,66,1,58,124
"23006","1900-1959",2021-09-14,58,2,54,112
"23007","1900-1959",2021-09-15,57,3,53,110
"23008","1900-1959",2021-09-16,70,4,60,130
"23009","1900-1959",2021-09-17,66,5,60,126
"23010","1900-1959",2021-09-18,56,6,48,104
"23011","1900-1959",2021-09-19,69,7,58,127
"23012","1900-1959",2021-09-20,67,1,58,125
"23013","1900-1959",2021-09-21,58,2,54,112
"23014","1900-1959",2021-09-22,56,3,53,109
"23015","1900-1959",2021-09-23,69,4,60,129
"23016","1900-1959",2021-09-24,66,5,60,126
"23017","1900-1959",2021-09-25,56,6,48,104
"23018","1900-1959",2021-09-26,69,7,59,128
"23019","1900-1959",2021-09-27,67,1,58,125
"23020","1900-1959",2021-09-28,58,2,54,112
"23021","1900-1959",2021-09-29,56,3,53,109
"23022","1900-1959",2021-09-30,69,4,60,129
"23023","2000-2059",2021-09-01,42,3,66,108
"23024","2000-2059",2021-09-02,46,4,75,121
"23025","2000-2059",2021-09-03,49,5,72,121
"23026","2000-2059",2021-09-04,32,6,65,97
"23027","2000-2059",2021-09-05,39,7,69,108
"23028","2000-2059",2021-09-06,47,1,72,119
"23029","2000-2059",2021-09-07,43,2,66,109
"23030","2000-2059",2021-09-08,36,3,65,101
"23031","2000-2059",2021-09-09,47,4,71,118
"23032","2000-2059",2021-09-10,48,5,70,118
"23033","2000-2059",2021-09-11,35,6,59,94
"23034","2000-2059",2021-09-12,46,7,71,117
"23035","2000-2059",2021-09-13,46,1,72,118
"23036","2000-2059",2021-09-14,35,2,61,96
"23037","2000-2059",2021-09-15,35,3,62,97
"23038","2000-2059",2021-09-16,45,4,72,117
"23039","2000-2059",2021-09-17,47,5,70,117
"23040","2000-2059",2021-09-18,29,6,56,85
"23041","2000-2059",2021-09-19,43,7,72,115
"23042","2000-2059",2021-09-20,46,1,72,118
"23043","2000-2059",2021-09-21,35,2,61,96
"23044","2000-2059",2021-09-22,35,3,62,97
"23045","2000-2059",2021-09-23,46,4,72,118
"23046","2000-2059",2021-09-24,47,5,70,117
"23047","2000-2059",2021-09-25,29,6,57,86
"23048","2000-2059",2021-09-26,44,7,72,116
"23049","2000-2059",2021-09-27,46,1,72,118
"23050","2000-2059",2021-09-28,35,2,61,96
"23051","2000-2059",2021-09-29,35,3,62,97
"23052","2000-2059",2021-09-30,46,4,73,119
"23053","2100-2159",2021-09-01,44,3,71,115
"23054","2100-2159",2021-09-02,46,4,72,118
"23055","2100-2159",2021-09-03,44,5,74,118
"23056","2100-2159",2021-09-04,34,6,65,99
"23057","2100-2159",2021-09-05,48,7,68,116
"23058","2100-2159",2021-09-06,40,1,69,109
"23059","2100-2159",2021-09-07,32,2,63,95
"23060","2100-2159",2021-09-08,34,3,70,104
"23061","2100-2159",2021-09-09,44,4,79,123
"23062","2100-2159",2021-09-10,44,5,78,122
"23063","2100-2159",2021-09-11,33,6,72,105
"23064","2100-2159",2021-09-12,47,7,76,123
"23065","2100-2159",2021-09-13,44,1,78,122
"23066","2100-2159",2021-09-14,32,2,72,104
"23067","2100-2159",2021-09-15,33,3,72,105
"23068","2100-2159",2021-09-16,43,4,82,125
"23069","2100-2159",2021-09-17,43,5,79,122
"23070","2100-2159",2021-09-18,29,6,69,98
"23071","2100-2159",2021-09-19,47,7,78,125
"23072","2100-2159",2021-09-20,44,1,78,122
"23073","2100-2159",2021-09-21,32,2,72,104
"23074","2100-2159",2021-09-22,33,3,73,106
"23075","2100-2159",2021-09-23,43,4,82,125
"23076","2100-2159",2021-09-24,43,5,79,122
"23077","2100-2159",2021-09-25,29,6,68,97
"23078","2100-2159",2021-09-26,47,7,80,127
"23079","2100-2159",2021-09-27,44,1,78,122
"23080","2100-2159",2021-09-28,32,2,72,104
"23081","2100-2159",2021-09-29,33,3,72,105
"23082","2100-2159",2021-09-30,44,4,83,127
"23083","2200-2259",2021-09-01,35,3,70,105
"23084","2200-2259",2021-09-02,43,4,76,119
"23085","2200-2259",2021-09-03,40,5,77,117
"23086","2200-2259",2021-09-04,25,6,58,83
"23087","2200-2259",2021-09-05,37,7,66,103
"23088","2200-2259",2021-09-06,41,1,73,114
"23089","2200-2259",2021-09-07,28,2,64,92
"23090","2200-2259",2021-09-08,28,3,49,77
"23091","2200-2259",2021-09-09,37,4,59,96
"23092","2200-2259",2021-09-10,37,5,61,98
"23093","2200-2259",2021-09-11,26,6,43,69
"23094","2200-2259",2021-09-12,35,7,58,93
"23095","2200-2259",2021-09-13,29,1,60,89
"23096","2200-2259",2021-09-14,22,2,51,73
"23097","2200-2259",2021-09-15,29,3,52,81
"23098","2200-2259",2021-09-16,38,4,62,100
"23099","2200-2259",2021-09-17,37,5,63,100
"23100","2200-2259",2021-09-18,27,6,39,66
"23101","2200-2259",2021-09-19,37,7,59,96
"23102","2200-2259",2021-09-20,29,1,60,89
"23103","2200-2259",2021-09-21,22,2,51,73
"23104","2200-2259",2021-09-22,29,3,52,81
"23105","2200-2259",2021-09-23,38,4,62,100
"23106","2200-2259",2021-09-24,37,5,63,100
"23107","2200-2259",2021-09-25,27,6,39,66
"23108","2200-2259",2021-09-26,37,7,59,96
"23109","2200-2259",2021-09-27,29,1,60,89
"23110","2200-2259",2021-09-28,22,2,51,73
"23111","2200-2259",2021-09-29,29,3,52,81
"23112","2200-2259",2021-09-30,37,4,61,98
"23113","2300-2359",2021-09-01,22,3,66,88
"23114","2300-2359",2021-09-02,27,4,73,100
"23115","2300-2359",2021-09-03,29,5,70,99
"23116","2300-2359",2021-09-04,17,6,45,62
"23117","2300-2359",2021-09-05,24,7,72,96
"23118","2300-2359",2021-09-06,23,1,66,89
"23119","2300-2359",2021-09-07,20,2,56,76
"23120","2300-2359",2021-09-08,17,3,53,70
"23121","2300-2359",2021-09-09,18,4,69,87
"23122","2300-2359",2021-09-10,19,5,68,87
"23123","2300-2359",2021-09-11,18,6,42,60
"23124","2300-2359",2021-09-12,18,7,73,91
"23125","2300-2359",2021-09-13,20,1,62,82
"23126","2300-2359",2021-09-14,16,2,48,64
"23127","2300-2359",2021-09-15,18,3,49,67
"23128","2300-2359",2021-09-16,20,4,66,86
"23129","2300-2359",2021-09-17,20,5,65,85
"23130","2300-2359",2021-09-18,16,6,39,55
"23131","2300-2359",2021-09-19,20,7,70,90
"23132","2300-2359",2021-09-20,20,1,62,82
"23133","2300-2359",2021-09-21,16,2,48,64
"23134","2300-2359",2021-09-22,18,3,49,67
"23135","2300-2359",2021-09-23,20,4,66,86
"23136","2300-2359",2021-09-24,20,5,65,85
"23137","2300-2359",2021-09-25,16,6,38,54
"23138","2300-2359",2021-09-26,20,7,70,90
"23139","2300-2359",2021-09-27,20,1,62,82
"23140","2300-2359",2021-09-28,16,2,48,64
"23141","2300-2359",2021-09-29,18,3,49,67
"23142","2300-2359",2021-09-30,20,4,66,86
"23143","0001-0559",2021-10-01,16,5,53,69
"23144","0001-0559",2021-10-02,13,6,35,48
"23145","0001-0559",2021-10-03,13,7,54,67
"23146","0001-0559",2021-10-04,15,1,45,60
"23147","0001-0559",2021-10-05,14,2,32,46
"23148","0001-0559",2021-10-06,11,3,34,45
"23149","0001-0559",2021-10-07,16,4,53,69
"23150","0001-0559",2021-10-08,19,5,53,72
"23151","0001-0559",2021-10-09,22,6,39,61
"23152","0001-0559",2021-10-10,14,7,55,69
"23153","0001-0559",2021-10-11,20,1,53,73
"23154","0001-0559",2021-10-12,18,2,36,54
"23155","0001-0559",2021-10-13,17,3,41,58
"23156","0001-0559",2021-10-14,19,4,52,71
"23157","0001-0559",2021-10-15,20,5,52,72
"23158","0001-0559",2021-10-16,23,6,38,61
"23159","0001-0559",2021-10-17,15,7,54,69
"23160","0001-0559",2021-10-18,20,1,53,73
"23161","0001-0559",2021-10-19,18,2,35,53
"23162","0001-0559",2021-10-20,17,3,41,58
"23163","0001-0559",2021-10-21,19,4,51,70
"23164","0001-0559",2021-10-22,20,5,52,72
"23165","0001-0559",2021-10-23,23,6,40,63
"23166","0001-0559",2021-10-24,15,7,53,68
"23167","0001-0559",2021-10-25,20,1,52,72
"23168","0001-0559",2021-10-26,18,2,35,53
"23169","0001-0559",2021-10-27,17,3,41,58
"23170","0001-0559",2021-10-28,19,4,52,71
"23171","0001-0559",2021-10-29,20,5,52,72
"23172","0001-0559",2021-10-30,23,6,37,60
"23173","0001-0559",2021-10-31,11,7,43,54
"23174","0600-0659",2021-10-01,79,5,24,103
"23175","0600-0659",2021-10-02,69,6,24,93
"23176","0600-0659",2021-10-03,77,7,24,101
"23177","0600-0659",2021-10-04,80,1,22,102
"23178","0600-0659",2021-10-05,65,2,17,82
"23179","0600-0659",2021-10-06,61,3,22,83
"23180","0600-0659",2021-10-07,72,4,25,97
"23181","0600-0659",2021-10-08,78,5,25,103
"23182","0600-0659",2021-10-09,75,6,23,98
"23183","0600-0659",2021-10-10,79,7,25,104
"23184","0600-0659",2021-10-11,80,1,24,104
"23185","0600-0659",2021-10-12,72,2,18,90
"23186","0600-0659",2021-10-13,67,3,22,89
"23187","0600-0659",2021-10-14,76,4,26,102
"23188","0600-0659",2021-10-15,78,5,26,104
"23189","0600-0659",2021-10-16,75,6,22,97
"23190","0600-0659",2021-10-17,78,7,25,103
"23191","0600-0659",2021-10-18,78,1,24,102
"23192","0600-0659",2021-10-19,72,2,18,90
"23193","0600-0659",2021-10-20,67,3,22,89
"23194","0600-0659",2021-10-21,75,4,26,101
"23195","0600-0659",2021-10-22,78,5,26,104
"23196","0600-0659",2021-10-23,74,6,21,95
"23197","0600-0659",2021-10-24,77,7,25,102
"23198","0600-0659",2021-10-25,78,1,24,102
"23199","0600-0659",2021-10-26,72,2,18,90
"23200","0600-0659",2021-10-27,67,3,22,89
"23201","0600-0659",2021-10-28,76,4,26,102
"23202","0600-0659",2021-10-29,79,5,26,105
"23203","0600-0659",2021-10-30,75,6,19,94
"23204","0600-0659",2021-10-31,81,7,21,102
"23205","0700-0759",2021-10-01,98,5,55,153
"23206","0700-0759",2021-10-02,97,6,50,147
"23207","0700-0759",2021-10-03,99,7,53,152
"23208","0700-0759",2021-10-04,97,1,55,152
"23209","0700-0759",2021-10-05,90,2,48,138
"23210","0700-0759",2021-10-06,89,3,42,131
"23211","0700-0759",2021-10-07,92,4,48,140
"23212","0700-0759",2021-10-08,88,5,51,139
"23213","0700-0759",2021-10-09,83,6,51,134
"23214","0700-0759",2021-10-10,89,7,56,145
"23215","0700-0759",2021-10-11,88,1,54,142
"23216","0700-0759",2021-10-12,82,2,53,135
"23217","0700-0759",2021-10-13,85,3,48,133
"23218","0700-0759",2021-10-14,92,4,52,144
"23219","0700-0759",2021-10-15,89,5,53,142
"23220","0700-0759",2021-10-16,84,6,55,139
"23221","0700-0759",2021-10-17,90,7,56,146
"23222","0700-0759",2021-10-18,91,1,54,145
"23223","0700-0759",2021-10-19,82,2,53,135
"23224","0700-0759",2021-10-20,85,3,48,133
"23225","0700-0759",2021-10-21,93,4,51,144
"23226","0700-0759",2021-10-22,90,5,53,143
"23227","0700-0759",2021-10-23,84,6,54,138
"23228","0700-0759",2021-10-24,91,7,55,146
"23229","0700-0759",2021-10-25,91,1,54,145
"23230","0700-0759",2021-10-26,82,2,53,135
"23231","0700-0759",2021-10-27,85,3,48,133
"23232","0700-0759",2021-10-28,92,4,52,144
"23233","0700-0759",2021-10-29,90,5,54,144
"23234","0700-0759",2021-10-30,84,6,56,140
"23235","0700-0759",2021-10-31,89,7,52,141
"23236","0800-0859",2021-10-01,92,5,45,137
"23237","0800-0859",2021-10-02,85,6,43,128
"23238","0800-0859",2021-10-03,90,7,43,133
"23239","0800-0859",2021-10-04,91,1,45,136
"23240","0800-0859",2021-10-05,91,2,42,133
"23241","0800-0859",2021-10-06,88,3,38,126
"23242","0800-0859",2021-10-07,97,4,45,142
"23243","0800-0859",2021-10-08,102,5,48,150
"23244","0800-0859",2021-10-09,90,6,42,132
"23245","0800-0859",2021-10-10,102,7,40,142
"23246","0800-0859",2021-10-11,98,1,46,144
"23247","0800-0859",2021-10-12,96,2,37,133
"23248","0800-0859",2021-10-13,92,3,37,129
"23249","0800-0859",2021-10-14,100,4,46,146
"23250","0800-0859",2021-10-15,99,5,46,145
"23251","0800-0859",2021-10-16,88,6,40,128
"23252","0800-0859",2021-10-17,100,7,39,139
"23253","0800-0859",2021-10-18,97,1,45,142
"23254","0800-0859",2021-10-19,96,2,37,133
"23255","0800-0859",2021-10-20,92,3,37,129
"23256","0800-0859",2021-10-21,99,4,47,146
"23257","0800-0859",2021-10-22,100,5,46,146
"23258","0800-0859",2021-10-23,88,6,40,128
"23259","0800-0859",2021-10-24,98,7,40,138
"23260","0800-0859",2021-10-25,97,1,45,142
"23261","0800-0859",2021-10-26,96,2,37,133
"23262","0800-0859",2021-10-27,92,3,37,129
"23263","0800-0859",2021-10-28,100,4,46,146
"23264","0800-0859",2021-10-29,100,5,46,146
"23265","0800-0859",2021-10-30,86,6,39,125
"23266","0800-0859",2021-10-31,98,7,37,135
"23267","0900-0959",2021-10-01,77,5,68,145
"23268","0900-0959",2021-10-02,68,6,63,131
"23269","0900-0959",2021-10-03,71,7,69,140
"23270","0900-0959",2021-10-04,76,1,69,145
"23271","0900-0959",2021-10-05,71,2,57,128
"23272","0900-0959",2021-10-06,69,3,59,128
"23273","0900-0959",2021-10-07,66,4,65,131
"23274","0900-0959",2021-10-08,67,5,63,130
"23275","0900-0959",2021-10-09,61,6,60,121
"23276","0900-0959",2021-10-10,65,7,67,132
"23277","0900-0959",2021-10-11,68,1,63,131
"23278","0900-0959",2021-10-12,62,2,60,122
"23279","0900-0959",2021-10-13,62,3,60,122
"23280","0900-0959",2021-10-14,65,4,65,130
"23281","0900-0959",2021-10-15,67,5,64,131
"23282","0900-0959",2021-10-16,60,6,61,121
"23283","0900-0959",2021-10-17,64,7,68,132
"23284","0900-0959",2021-10-18,68,1,64,132
"23285","0900-0959",2021-10-19,61,2,60,121
"23286","0900-0959",2021-10-20,61,3,60,121
"23287","0900-0959",2021-10-21,66,4,65,131
"23288","0900-0959",2021-10-22,67,5,64,131
"23289","0900-0959",2021-10-23,62,6,61,123
"23290","0900-0959",2021-10-24,66,7,68,134
"23291","0900-0959",2021-10-25,68,1,64,132
"23292","0900-0959",2021-10-26,61,2,60,121
"23293","0900-0959",2021-10-27,61,3,60,121
"23294","0900-0959",2021-10-28,65,4,65,130
"23295","0900-0959",2021-10-29,67,5,64,131
"23296","0900-0959",2021-10-30,61,6,61,122
"23297","0900-0959",2021-10-31,56,7,70,126
"23298","1000-1059",2021-10-01,76,5,51,127
"23299","1000-1059",2021-10-02,64,6,49,113
"23300","1000-1059",2021-10-03,74,7,44,118
"23301","1000-1059",2021-10-04,76,1,50,126
"23302","1000-1059",2021-10-05,69,2,47,116
"23303","1000-1059",2021-10-06,67,3,46,113
"23304","1000-1059",2021-10-07,71,4,48,119
"23305","1000-1059",2021-10-08,69,5,53,122
"23306","1000-1059",2021-10-09,69,6,50,119
"23307","1000-1059",2021-10-10,73,7,46,119
"23308","1000-1059",2021-10-11,71,1,54,125
"23309","1000-1059",2021-10-12,70,2,47,117
"23310","1000-1059",2021-10-13,69,3,46,115
"23311","1000-1059",2021-10-14,74,4,51,125
"23312","1000-1059",2021-10-15,71,5,53,124
"23313","1000-1059",2021-10-16,70,6,50,120
"23314","1000-1059",2021-10-17,75,7,46,121
"23315","1000-1059",2021-10-18,71,1,54,125
"23316","1000-1059",2021-10-19,70,2,47,117
"23317","1000-1059",2021-10-20,69,3,46,115
"23318","1000-1059",2021-10-21,74,4,51,125
"23319","1000-1059",2021-10-22,70,5,53,123
"23320","1000-1059",2021-10-23,70,6,50,120
"23321","1000-1059",2021-10-24,76,7,46,122
"23322","1000-1059",2021-10-25,71,1,54,125
"23323","1000-1059",2021-10-26,70,2,47,117
"23324","1000-1059",2021-10-27,69,3,46,115
"23325","1000-1059",2021-10-28,74,4,51,125
"23326","1000-1059",2021-10-29,71,5,53,124
"23327","1000-1059",2021-10-30,69,6,50,119
"23328","1000-1059",2021-10-31,80,7,47,127
"23329","1100-1159",2021-10-01,56,5,64,120
"23330","1100-1159",2021-10-02,52,6,51,103
"23331","1100-1159",2021-10-03,58,7,66,124
"23332","1100-1159",2021-10-04,57,1,62,119
"23333","1100-1159",2021-10-05,55,2,60,115
"23334","1100-1159",2021-10-06,53,3,58,111
"23335","1100-1159",2021-10-07,59,4,57,116
"23336","1100-1159",2021-10-08,60,5,60,120
"23337","1100-1159",2021-10-09,53,6,62,115
"23338","1100-1159",2021-10-10,57,7,66,123
"23339","1100-1159",2021-10-11,60,1,58,118
"23340","1100-1159",2021-10-12,54,2,59,113
"23341","1100-1159",2021-10-13,54,3,57,111
"23342","1100-1159",2021-10-14,58,4,59,117
"23343","1100-1159",2021-10-15,60,5,60,120
"23344","1100-1159",2021-10-16,53,6,63,116
"23345","1100-1159",2021-10-17,57,7,66,123
"23346","1100-1159",2021-10-18,60,1,58,118
"23347","1100-1159",2021-10-19,54,2,59,113
"23348","1100-1159",2021-10-20,54,3,57,111
"23349","1100-1159",2021-10-21,58,4,59,117
"23350","1100-1159",2021-10-22,60,5,60,120
"23351","1100-1159",2021-10-23,52,6,61,113
"23352","1100-1159",2021-10-24,57,7,67,124
"23353","1100-1159",2021-10-25,60,1,58,118
"23354","1100-1159",2021-10-26,54,2,59,113
"23355","1100-1159",2021-10-27,54,3,57,111
"23356","1100-1159",2021-10-28,58,4,59,117
"23357","1100-1159",2021-10-29,59,5,60,119
"23358","1100-1159",2021-10-30,52,6,61,113
"23359","1100-1159",2021-10-31,58,7,65,123
"23360","1200-1259",2021-10-01,66,5,72,138
"23361","1200-1259",2021-10-02,49,6,75,124
"23362","1200-1259",2021-10-03,60,7,71,131
"23363","1200-1259",2021-10-04,65,1,73,138
"23364","1200-1259",2021-10-05,59,2,69,128
"23365","1200-1259",2021-10-06,60,3,67,127
"23366","1200-1259",2021-10-07,57,4,78,135
"23367","1200-1259",2021-10-08,56,5,75,131
"23368","1200-1259",2021-10-09,54,6,69,123
"23369","1200-1259",2021-10-10,56,7,73,129
"23370","1200-1259",2021-10-11,53,1,76,129
"23371","1200-1259",2021-10-12,50,2,68,118
"23372","1200-1259",2021-10-13,50,3,69,119
"23373","1200-1259",2021-10-14,55,4,77,132
"23374","1200-1259",2021-10-15,54,5,75,129
"23375","1200-1259",2021-10-16,53,6,69,122
"23376","1200-1259",2021-10-17,54,7,73,127
"23377","1200-1259",2021-10-18,53,1,76,129
"23378","1200-1259",2021-10-19,50,2,68,118
"23379","1200-1259",2021-10-20,50,3,69,119
"23380","1200-1259",2021-10-21,55,4,77,132
"23381","1200-1259",2021-10-22,55,5,75,130
"23382","1200-1259",2021-10-23,53,6,70,123
"23383","1200-1259",2021-10-24,54,7,72,126
"23384","1200-1259",2021-10-25,53,1,76,129
"23385","1200-1259",2021-10-26,50,2,68,118
"23386","1200-1259",2021-10-27,50,3,69,119
"23387","1200-1259",2021-10-28,55,4,77,132
"23388","1200-1259",2021-10-29,55,5,75,130
"23389","1200-1259",2021-10-30,53,6,67,120
"23390","1200-1259",2021-10-31,57,7,72,129
"23391","1300-1359",2021-10-01,73,5,64,137
"23392","1300-1359",2021-10-02,66,6,52,118
"23393","1300-1359",2021-10-03,73,7,60,133
"23394","1300-1359",2021-10-04,73,1,63,136
"23395","1300-1359",2021-10-05,64,2,55,119
"23396","1300-1359",2021-10-06,62,3,54,116
"23397","1300-1359",2021-10-07,78,4,56,134
"23398","1300-1359",2021-10-08,77,5,58,135
"23399","1300-1359",2021-10-09,71,6,56,127
"23400","1300-1359",2021-10-10,77,7,57,134
"23401","1300-1359",2021-10-11,78,1,58,136
"23402","1300-1359",2021-10-12,73,2,56,129
"23403","1300-1359",2021-10-13,73,3,56,129
"23404","1300-1359",2021-10-14,79,4,57,136
"23405","1300-1359",2021-10-15,77,5,58,135
"23406","1300-1359",2021-10-16,71,6,54,125
"23407","1300-1359",2021-10-17,78,7,57,135
"23408","1300-1359",2021-10-18,79,1,58,137
"23409","1300-1359",2021-10-19,73,2,56,129
"23410","1300-1359",2021-10-20,73,3,56,129
"23411","1300-1359",2021-10-21,79,4,57,136
"23412","1300-1359",2021-10-22,78,5,58,136
"23413","1300-1359",2021-10-23,71,6,53,124
"23414","1300-1359",2021-10-24,78,7,57,135
"23415","1300-1359",2021-10-25,80,1,58,138
"23416","1300-1359",2021-10-26,73,2,56,129
"23417","1300-1359",2021-10-27,73,3,56,129
"23418","1300-1359",2021-10-28,79,4,57,136
"23419","1300-1359",2021-10-29,78,5,59,137
"23420","1300-1359",2021-10-30,69,6,53,122
"23421","1300-1359",2021-10-31,68,7,53,121
"23422","1400-1459",2021-10-01,63,5,65,128
"23423","1400-1459",2021-10-02,53,6,59,112
"23424","1400-1459",2021-10-03,64,7,67,131
"23425","1400-1459",2021-10-04,62,1,65,127
"23426","1400-1459",2021-10-05,58,2,62,120
"23427","1400-1459",2021-10-06,61,3,62,123
"23428","1400-1459",2021-10-07,59,4,64,123
"23429","1400-1459",2021-10-08,60,5,65,125
"23430","1400-1459",2021-10-09,50,6,60,110
"23431","1400-1459",2021-10-10,62,7,68,130
"23432","1400-1459",2021-10-11,62,1,63,125
"23433","1400-1459",2021-10-12,54,2,59,113
"23434","1400-1459",2021-10-13,55,3,60,115
"23435","1400-1459",2021-10-14,59,4,62,121
"23436","1400-1459",2021-10-15,60,5,62,122
"23437","1400-1459",2021-10-16,52,6,58,110
"23438","1400-1459",2021-10-17,62,7,65,127
"23439","1400-1459",2021-10-18,61,1,63,124
"23440","1400-1459",2021-10-19,54,2,59,113
"23441","1400-1459",2021-10-20,55,3,59,114
"23442","1400-1459",2021-10-21,59,4,62,121
"23443","1400-1459",2021-10-22,59,5,64,123
"23444","1400-1459",2021-10-23,52,6,60,112
"23445","1400-1459",2021-10-24,62,7,66,128
"23446","1400-1459",2021-10-25,60,1,63,123
"23447","1400-1459",2021-10-26,54,2,59,113
"23448","1400-1459",2021-10-27,55,3,59,114
"23449","1400-1459",2021-10-28,59,4,62,121
"23450","1400-1459",2021-10-29,60,5,63,123
"23451","1400-1459",2021-10-30,47,6,60,107
"23452","1400-1459",2021-10-31,60,7,64,124
"23453","1500-1559",2021-10-01,62,5,70,132
"23454","1500-1559",2021-10-02,45,6,52,97
"23455","1500-1559",2021-10-03,61,7,67,128
"23456","1500-1559",2021-10-04,62,1,70,132
"23457","1500-1559",2021-10-05,47,2,56,103
"23458","1500-1559",2021-10-06,50,3,57,107
"23459","1500-1559",2021-10-07,67,4,68,135
"23460","1500-1559",2021-10-08,68,5,62,130
"23461","1500-1559",2021-10-09,53,6,52,105
"23462","1500-1559",2021-10-10,63,7,65,128
"23463","1500-1559",2021-10-11,69,1,66,135
"23464","1500-1559",2021-10-12,60,2,62,122
"23465","1500-1559",2021-10-13,61,3,62,123
"23466","1500-1559",2021-10-14,67,4,72,139
"23467","1500-1559",2021-10-15,67,5,65,132
"23468","1500-1559",2021-10-16,51,6,55,106
"23469","1500-1559",2021-10-17,61,7,68,129
"23470","1500-1559",2021-10-18,69,1,67,136
"23471","1500-1559",2021-10-19,60,2,61,121
"23472","1500-1559",2021-10-20,60,3,62,122
"23473","1500-1559",2021-10-21,67,4,71,138
"23474","1500-1559",2021-10-22,69,5,66,135
"23475","1500-1559",2021-10-23,52,6,55,107
"23476","1500-1559",2021-10-24,63,7,67,130
"23477","1500-1559",2021-10-25,70,1,68,138
"23478","1500-1559",2021-10-26,60,2,61,121
"23479","1500-1559",2021-10-27,60,3,62,122
"23480","1500-1559",2021-10-28,67,4,72,139
"23481","1500-1559",2021-10-29,68,5,66,134
"23482","1500-1559",2021-10-30,48,6,55,103
"23483","1500-1559",2021-10-31,55,7,66,121
"23484","1600-1659",2021-10-01,69,5,54,123
"23485","1600-1659",2021-10-02,54,6,53,107
"23486","1600-1659",2021-10-03,76,7,53,129
"23487","1600-1659",2021-10-04,68,1,54,122
"23488","1600-1659",2021-10-05,62,2,60,122
"23489","1600-1659",2021-10-06,58,3,55,113
"23490","1600-1659",2021-10-07,63,4,63,126
"23491","1600-1659",2021-10-08,63,5,65,128
"23492","1600-1659",2021-10-09,49,6,51,100
"23493","1600-1659",2021-10-10,64,7,57,121
"23494","1600-1659",2021-10-11,61,1,64,125
"23495","1600-1659",2021-10-12,55,2,59,114
"23496","1600-1659",2021-10-13,55,3,57,112
"23497","1600-1659",2021-10-14,62,4,60,122
"23498","1600-1659",2021-10-15,62,5,63,125
"23499","1600-1659",2021-10-16,49,6,48,97
"23500","1600-1659",2021-10-17,64,7,54,118
"23501","1600-1659",2021-10-18,61,1,63,124
"23502","1600-1659",2021-10-19,55,2,59,114
"23503","1600-1659",2021-10-20,55,3,57,112
"23504","1600-1659",2021-10-21,62,4,61,123
"23505","1600-1659",2021-10-22,64,5,62,126
"23506","1600-1659",2021-10-23,50,6,50,100
"23507","1600-1659",2021-10-24,64,7,56,120
"23508","1600-1659",2021-10-25,60,1,62,122
"23509","1600-1659",2021-10-26,55,2,59,114
"23510","1600-1659",2021-10-27,55,3,57,112
"23511","1600-1659",2021-10-28,62,4,60,122
"23512","1600-1659",2021-10-29,62,5,61,123
"23513","1600-1659",2021-10-30,49,6,48,97
"23514","1600-1659",2021-10-31,55,7,55,110
"23515","1700-1759",2021-10-01,62,5,76,138
"23516","1700-1759",2021-10-02,57,6,64,121
"23517","1700-1759",2021-10-03,62,7,82,144
"23518","1700-1759",2021-10-04,62,1,77,139
"23519","1700-1759",2021-10-05,59,2,71,130
"23520","1700-1759",2021-10-06,60,3,74,134
"23521","1700-1759",2021-10-07,65,4,68,133
"23522","1700-1759",2021-10-08,62,5,67,129
"23523","1700-1759",2021-10-09,55,6,63,118
"23524","1700-1759",2021-10-10,65,7,74,139
"23525","1700-1759",2021-10-11,64,1,69,133
"23526","1700-1759",2021-10-12,56,2,64,120
"23527","1700-1759",2021-10-13,58,3,67,125
"23528","1700-1759",2021-10-14,66,4,69,135
"23529","1700-1759",2021-10-15,63,5,66,129
"23530","1700-1759",2021-10-16,54,6,64,118
"23531","1700-1759",2021-10-17,65,7,75,140
"23532","1700-1759",2021-10-18,64,1,69,133
"23533","1700-1759",2021-10-19,56,2,64,120
"23534","1700-1759",2021-10-20,58,3,66,124
"23535","1700-1759",2021-10-21,66,4,69,135
"23536","1700-1759",2021-10-22,61,5,68,129
"23537","1700-1759",2021-10-23,54,6,64,118
"23538","1700-1759",2021-10-24,65,7,75,140
"23539","1700-1759",2021-10-25,64,1,69,133
"23540","1700-1759",2021-10-26,56,2,64,120
"23541","1700-1759",2021-10-27,58,3,66,124
"23542","1700-1759",2021-10-28,66,4,69,135
"23543","1700-1759",2021-10-29,63,5,68,131
"23544","1700-1759",2021-10-30,48,6,62,110
"23545","1700-1759",2021-10-31,57,7,64,121
"23546","1800-1859",2021-10-01,63,5,65,128
"23547","1800-1859",2021-10-02,48,6,57,105
"23548","1800-1859",2021-10-03,65,7,66,131
"23549","1800-1859",2021-10-04,61,1,66,127
"23550","1800-1859",2021-10-05,59,2,58,117
"23551","1800-1859",2021-10-06,61,3,61,122
"23552","1800-1859",2021-10-07,61,4,70,131
"23553","1800-1859",2021-10-08,61,5,70,131
"23554","1800-1859",2021-10-09,53,6,56,109
"23555","1800-1859",2021-10-10,65,7,68,133
"23556","1800-1859",2021-10-11,60,1,68,128
"23557","1800-1859",2021-10-12,56,2,63,119
"23558","1800-1859",2021-10-13,57,3,64,121
"23559","1800-1859",2021-10-14,62,4,67,129
"23560","1800-1859",2021-10-15,61,5,68,129
"23561","1800-1859",2021-10-16,52,6,53,105
"23562","1800-1859",2021-10-17,66,7,65,131
"23563","1800-1859",2021-10-18,60,1,68,128
"23564","1800-1859",2021-10-19,56,2,63,119
"23565","1800-1859",2021-10-20,57,3,64,121
"23566","1800-1859",2021-10-21,62,4,67,129
"23567","1800-1859",2021-10-22,62,5,67,129
"23568","1800-1859",2021-10-23,52,6,53,105
"23569","1800-1859",2021-10-24,66,7,66,132
"23570","1800-1859",2021-10-25,60,1,68,128
"23571","1800-1859",2021-10-26,56,2,63,119
"23572","1800-1859",2021-10-27,57,3,64,121
"23573","1800-1859",2021-10-28,62,4,67,129
"23574","1800-1859",2021-10-29,62,5,68,130
"23575","1800-1859",2021-10-30,42,6,48,90
"23576","1800-1859",2021-10-31,55,7,66,121
"23577","1900-1959",2021-10-01,67,5,59,126
"23578","1900-1959",2021-10-02,57,6,48,105
"23579","1900-1959",2021-10-03,71,7,58,129
"23580","1900-1959",2021-10-04,67,1,58,125
"23581","1900-1959",2021-10-05,60,2,55,115
"23582","1900-1959",2021-10-06,60,3,53,113
"23583","1900-1959",2021-10-07,69,4,51,120
"23584","1900-1959",2021-10-08,70,5,51,121
"23585","1900-1959",2021-10-09,58,6,39,97
"23586","1900-1959",2021-10-10,68,7,53,121
"23587","1900-1959",2021-10-11,68,1,52,120
"23588","1900-1959",2021-10-12,64,2,48,112
"23589","1900-1959",2021-10-13,62,3,47,109
"23590","1900-1959",2021-10-14,68,4,53,121
"23591","1900-1959",2021-10-15,68,5,53,121
"23592","1900-1959",2021-10-16,56,6,40,96
"23593","1900-1959",2021-10-17,66,7,55,121
"23594","1900-1959",2021-10-18,68,1,52,120
"23595","1900-1959",2021-10-19,64,2,48,112
"23596","1900-1959",2021-10-20,62,3,47,109
"23597","1900-1959",2021-10-21,68,4,53,121
"23598","1900-1959",2021-10-22,68,5,54,122
"23599","1900-1959",2021-10-23,58,6,40,98
"23600","1900-1959",2021-10-24,66,7,55,121
"23601","1900-1959",2021-10-25,68,1,52,120
"23602","1900-1959",2021-10-26,64,2,48,112
"23603","1900-1959",2021-10-27,62,3,47,109
"23604","1900-1959",2021-10-28,68,4,53,121
"23605","1900-1959",2021-10-29,67,5,54,121
"23606","1900-1959",2021-10-30,53,6,37,90
"23607","1900-1959",2021-10-31,55,7,48,103
"23608","2000-2059",2021-10-01,45,5,72,117
"23609","2000-2059",2021-10-02,27,6,58,85
"23610","2000-2059",2021-10-03,42,7,74,116
"23611","2000-2059",2021-10-04,44,1,73,117
"23612","2000-2059",2021-10-05,34,2,65,99
"23613","2000-2059",2021-10-06,35,3,65,100
"23614","2000-2059",2021-10-07,43,4,79,122
"23615","2000-2059",2021-10-08,45,5,80,125
"23616","2000-2059",2021-10-09,27,6,70,97
"23617","2000-2059",2021-10-10,41,7,76,117
"23618","2000-2059",2021-10-11,49,1,80,129
"23619","2000-2059",2021-10-12,41,2,67,108
"23620","2000-2059",2021-10-13,43,3,70,113
"23621","2000-2059",2021-10-14,47,4,81,128
"23622","2000-2059",2021-10-15,49,5,80,129
"23623","2000-2059",2021-10-16,32,6,69,101
"23624","2000-2059",2021-10-17,47,7,76,123
"23625","2000-2059",2021-10-18,49,1,80,129
"23626","2000-2059",2021-10-19,42,2,67,109
"23627","2000-2059",2021-10-20,43,3,70,113
"23628","2000-2059",2021-10-21,47,4,81,128
"23629","2000-2059",2021-10-22,49,5,80,129
"23630","2000-2059",2021-10-23,30,6,68,98
"23631","2000-2059",2021-10-24,47,7,76,123
"23632","2000-2059",2021-10-25,49,1,80,129
"23633","2000-2059",2021-10-26,42,2,67,109
"23634","2000-2059",2021-10-27,43,3,70,113
"23635","2000-2059",2021-10-28,47,4,81,128
"23636","2000-2059",2021-10-29,49,5,80,129
"23637","2000-2059",2021-10-30,26,6,63,89
"23638","2000-2059",2021-10-31,35,7,67,102
"23639","2100-2159",2021-10-01,45,5,80,125
"23640","2100-2159",2021-10-02,30,6,70,100
"23641","2100-2159",2021-10-03,50,7,80,130
"23642","2100-2159",2021-10-04,45,1,77,122
"23643","2100-2159",2021-10-05,33,2,73,106
"23644","2100-2159",2021-10-06,36,3,74,110
"23645","2100-2159",2021-10-07,53,4,75,128
"23646","2100-2159",2021-10-08,52,5,72,124
"23647","2100-2159",2021-10-09,39,6,61,100
"23648","2100-2159",2021-10-10,59,7,79,138
"23649","2100-2159",2021-10-11,50,1,69,119
"23650","2100-2159",2021-10-12,42,2,66,108
"23651","2100-2159",2021-10-13,41,3,64,105
"23652","2100-2159",2021-10-14,50,4,71,121
"23653","2100-2159",2021-10-15,49,5,68,117
"23654","2100-2159",2021-10-16,36,6,60,96
"23655","2100-2159",2021-10-17,54,7,76,130
"23656","2100-2159",2021-10-18,50,1,69,119
"23657","2100-2159",2021-10-19,41,2,66,107
"23658","2100-2159",2021-10-20,41,3,64,105
"23659","2100-2159",2021-10-21,50,4,71,121
"23660","2100-2159",2021-10-22,49,5,69,118
"23661","2100-2159",2021-10-23,36,6,60,96
"23662","2100-2159",2021-10-24,54,7,76,130
"23663","2100-2159",2021-10-25,50,1,69,119
"23664","2100-2159",2021-10-26,41,2,66,107
"23665","2100-2159",2021-10-27,41,3,64,105
"23666","2100-2159",2021-10-28,50,4,71,121
"23667","2100-2159",2021-10-29,48,5,70,118
"23668","2100-2159",2021-10-30,30,6,52,82
"23669","2100-2159",2021-10-31,44,7,60,104
"23670","2200-2259",2021-10-01,37,5,65,102
"23671","2200-2259",2021-10-02,27,6,38,65
"23672","2200-2259",2021-10-03,35,7,61,96
"23673","2200-2259",2021-10-04,29,1,64,93
"23674","2200-2259",2021-10-05,21,2,55,76
"23675","2200-2259",2021-10-06,30,3,59,89
"23676","2200-2259",2021-10-07,32,4,71,103
"23677","2200-2259",2021-10-08,36,5,74,110
"23678","2200-2259",2021-10-09,26,6,56,82
"23679","2200-2259",2021-10-10,35,7,65,100
"23680","2200-2259",2021-10-11,33,1,74,107
"23681","2200-2259",2021-10-12,23,2,71,94
"23682","2200-2259",2021-10-13,29,3,71,100
"23683","2200-2259",2021-10-14,34,4,75,109
"23684","2200-2259",2021-10-15,38,5,77,115
"23685","2200-2259",2021-10-16,25,6,60,85
"23686","2200-2259",2021-10-17,36,7,68,104
"23687","2200-2259",2021-10-18,33,1,75,108
"23688","2200-2259",2021-10-19,23,2,71,94
"23689","2200-2259",2021-10-20,29,3,71,100
"23690","2200-2259",2021-10-21,34,4,75,109
"23691","2200-2259",2021-10-22,38,5,78,116
"23692","2200-2259",2021-10-23,25,6,60,85
"23693","2200-2259",2021-10-24,36,7,68,104
"23694","2200-2259",2021-10-25,33,1,76,109
"23695","2200-2259",2021-10-26,23,2,71,94
"23696","2200-2259",2021-10-27,29,3,71,100
"23697","2200-2259",2021-10-28,34,4,75,109
"23698","2200-2259",2021-10-29,38,5,76,114
"23699","2200-2259",2021-10-30,25,6,54,79
"23700","2200-2259",2021-10-31,33,7,59,92
"23701","2300-2359",2021-10-01,20,5,64,84
"23702","2300-2359",2021-10-02,16,6,36,52
"23703","2300-2359",2021-10-03,20,7,69,89
"23704","2300-2359",2021-10-04,19,1,61,80
"23705","2300-2359",2021-10-05,19,2,48,67
"23706","2300-2359",2021-10-06,19,3,50,69
"23707","2300-2359",2021-10-07,28,4,64,92
"23708","2300-2359",2021-10-08,26,5,67,93
"23709","2300-2359",2021-10-09,19,6,47,66
"23710","2300-2359",2021-10-10,26,7,70,96
"23711","2300-2359",2021-10-11,26,1,67,93
"23712","2300-2359",2021-10-12,19,2,54,73
"23713","2300-2359",2021-10-13,22,3,54,76
"23714","2300-2359",2021-10-14,27,4,65,92
"23715","2300-2359",2021-10-15,25,5,68,93
"23716","2300-2359",2021-10-16,20,6,45,65
"23717","2300-2359",2021-10-17,25,7,71,96
"23718","2300-2359",2021-10-18,26,1,66,92
"23719","2300-2359",2021-10-19,19,2,55,74
"23720","2300-2359",2021-10-20,22,3,54,76
"23721","2300-2359",2021-10-21,27,4,66,93
"23722","2300-2359",2021-10-22,25,5,67,92
"23723","2300-2359",2021-10-23,20,6,46,66
"23724","2300-2359",2021-10-24,25,7,72,97
"23725","2300-2359",2021-10-25,26,1,66,92
"23726","2300-2359",2021-10-26,19,2,55,74
"23727","2300-2359",2021-10-27,22,3,54,76
"23728","2300-2359",2021-10-28,27,4,65,92
"23729","2300-2359",2021-10-29,25,5,66,91
"23730","2300-2359",2021-10-30,19,6,37,56
"23731","2300-2359",2021-10-31,22,7,60,82
"23732","0001-0559",2021-11-01,19,1,49,68
"23733","0001-0559",2021-11-02,18,2,32,50
"23734","0001-0559",2021-11-03,18,3,37,55
"23735","0001-0559",2021-11-04,20,4,47,67
"23736","0001-0559",2021-11-05,20,5,47,67
"23737","0001-0559",2021-11-06,24,6,48,72
"23738","0001-0559",2021-11-07,12,7,52,64
"23739","0001-0559",2021-11-08,23,1,44,67
"23740","0001-0559",2021-11-09,12,2,31,43
"23741","0001-0559",2021-11-10,13,3,37,50
"23742","0001-0559",2021-11-11,21,4,47,68
"23743","0001-0559",2021-11-12,21,5,44,65
"23744","0001-0559",2021-11-13,18,6,38,56
"23745","0001-0559",2021-11-14,12,7,48,60
"23746","0001-0559",2021-11-15,22,1,44,66
"23747","0001-0559",2021-11-16,12,2,30,42
"23748","0001-0559",2021-11-17,12,3,49,61
"23749","0001-0559",2021-11-18,21,4,57,78
"23750","0001-0559",2021-11-19,23,5,60,83
"23751","0001-0559",2021-11-20,24,6,57,81
"23752","0001-0559",2021-11-21,15,7,57,72
"23753","0001-0559",2021-11-22,25,1,55,80
"23754","0001-0559",2021-11-23,19,2,63,82
"23755","0001-0559",2021-11-24,21,3,63,84
"23756","0001-0559",2021-11-25,18,4,31,49
"23757","0001-0559",2021-11-26,10,5,50,60
"23758","0001-0559",2021-11-27,24,6,63,87
"23759","0001-0559",2021-11-28,21,7,71,92
"23760","0001-0559",2021-11-29,25,1,64,89
"23761","0001-0559",2021-11-30,23,2,49,72
"23762","0600-0659",2021-11-01,80,1,26,106
"23763","0600-0659",2021-11-02,75,2,25,100
"23764","0600-0659",2021-11-03,71,3,28,99
"23765","0600-0659",2021-11-04,76,4,32,108
"23766","0600-0659",2021-11-05,74,5,32,106
"23767","0600-0659",2021-11-06,75,6,28,103
"23768","0600-0659",2021-11-07,77,7,26,103
"23769","0600-0659",2021-11-08,80,1,32,112
"23770","0600-0659",2021-11-09,76,2,25,101
"23771","0600-0659",2021-11-10,74,3,26,100
"23772","0600-0659",2021-11-11,81,4,31,112
"23773","0600-0659",2021-11-12,82,5,31,113
"23774","0600-0659",2021-11-13,80,6,28,108
"23775","0600-0659",2021-11-14,79,7,29,108
"23776","0600-0659",2021-11-15,80,1,31,111
"23777","0600-0659",2021-11-16,76,2,25,101
"23778","0600-0659",2021-11-17,75,3,30,105
"23779","0600-0659",2021-11-18,80,4,30,110
"23780","0600-0659",2021-11-19,86,5,29,115
"23781","0600-0659",2021-11-20,79,6,29,108
"23782","0600-0659",2021-11-21,79,7,27,106
"23783","0600-0659",2021-11-22,83,1,28,111
"23784","0600-0659",2021-11-23,88,2,27,115
"23785","0600-0659",2021-11-24,88,3,30,118
"23786","0600-0659",2021-11-25,78,4,22,100
"23787","0600-0659",2021-11-26,63,5,21,84
"23788","0600-0659",2021-11-27,77,6,28,105
"23789","0600-0659",2021-11-28,84,7,29,113
"23790","0600-0659",2021-11-29,87,1,31,118
"23791","0600-0659",2021-11-30,81,2,27,108
"23792","0700-0759",2021-11-01,90,1,53,143
"23793","0700-0759",2021-11-02,82,2,56,138
"23794","0700-0759",2021-11-03,87,3,50,137
"23795","0700-0759",2021-11-04,92,4,54,146
"23796","0700-0759",2021-11-05,89,5,52,141
"23797","0700-0759",2021-11-06,85,6,47,132
"23798","0700-0759",2021-11-07,83,7,43,126
"23799","0700-0759",2021-11-08,83,1,55,138
"23800","0700-0759",2021-11-09,75,2,50,125
"23801","0700-0759",2021-11-10,78,3,48,126
"23802","0700-0759",2021-11-11,86,4,54,140
"23803","0700-0759",2021-11-12,84,5,54,138
"23804","0700-0759",2021-11-13,76,6,50,126
"23805","0700-0759",2021-11-14,83,7,45,128
"23806","0700-0759",2021-11-15,84,1,54,138
"23807","0700-0759",2021-11-16,75,2,50,125
"23808","0700-0759",2021-11-17,75,3,43,118
"23809","0700-0759",2021-11-18,83,4,46,129
"23810","0700-0759",2021-11-19,82,5,52,134
"23811","0700-0759",2021-11-20,78,6,44,122
"23812","0700-0759",2021-11-21,82,7,42,124
"23813","0700-0759",2021-11-22,80,1,49,129
"23814","0700-0759",2021-11-23,82,2,46,128
"23815","0700-0759",2021-11-24,84,3,47,131
"23816","0700-0759",2021-11-25,71,4,40,111
"23817","0700-0759",2021-11-26,66,5,38,104
"23818","0700-0759",2021-11-27,80,6,44,124
"23819","0700-0759",2021-11-28,86,7,49,135
"23820","0700-0759",2021-11-29,85,1,48,133
"23821","0700-0759",2021-11-30,82,2,48,130
"23822","0800-0859",2021-11-01,97,1,45,142
"23823","0800-0859",2021-11-02,93,2,36,129
"23824","0800-0859",2021-11-03,90,3,38,128
"23825","0800-0859",2021-11-04,96,4,43,139
"23826","0800-0859",2021-11-05,98,5,40,138
"23827","0800-0859",2021-11-06,83,6,37,120
"23828","0800-0859",2021-11-07,92,7,39,131
"23829","0800-0859",2021-11-08,102,1,37,139
"23830","0800-0859",2021-11-09,97,2,29,126
"23831","0800-0859",2021-11-10,93,3,32,125
"23832","0800-0859",2021-11-11,100,4,40,140
"23833","0800-0859",2021-11-12,102,5,37,139
"23834","0800-0859",2021-11-13,87,6,39,126
"23835","0800-0859",2021-11-14,92,7,39,131
"23836","0800-0859",2021-11-15,101,1,37,138
"23837","0800-0859",2021-11-16,98,2,29,127
"23838","0800-0859",2021-11-17,91,3,35,126
"23839","0800-0859",2021-11-18,99,4,42,141
"23840","0800-0859",2021-11-19,97,5,43,140
"23841","0800-0859",2021-11-20,87,6,42,129
"23842","0800-0859",2021-11-21,91,7,41,132
"23843","0800-0859",2021-11-22,95,1,43,138
"23844","0800-0859",2021-11-23,93,2,44,137
"23845","0800-0859",2021-11-24,96,3,45,141
"23846","0800-0859",2021-11-25,91,4,36,127
"23847","0800-0859",2021-11-26,81,5,36,117
"23848","0800-0859",2021-11-27,87,6,41,128
"23849","0800-0859",2021-11-28,93,7,44,137
"23850","0800-0859",2021-11-29,92,1,46,138
"23851","0800-0859",2021-11-30,94,2,40,134
"23852","0900-0959",2021-11-01,60,1,66,126
"23853","0900-0959",2021-11-02,53,2,58,111
"23854","0900-0959",2021-11-03,54,3,59,113
"23855","0900-0959",2021-11-04,61,4,64,125
"23856","0900-0959",2021-11-05,59,5,61,120
"23857","0900-0959",2021-11-06,55,6,56,111
"23858","0900-0959",2021-11-07,57,7,56,113
"23859","0900-0959",2021-11-08,61,1,59,120
"23860","0900-0959",2021-11-09,54,2,56,110
"23861","0900-0959",2021-11-10,55,3,55,110
"23862","0900-0959",2021-11-11,61,4,59,120
"23863","0900-0959",2021-11-12,61,5,59,120
"23864","0900-0959",2021-11-13,57,6,50,107
"23865","0900-0959",2021-11-14,59,7,56,115
"23866","0900-0959",2021-11-15,61,1,59,120
"23867","0900-0959",2021-11-16,53,2,56,109
"23868","0900-0959",2021-11-17,60,3,55,115
"23869","0900-0959",2021-11-18,58,4,59,117
"23870","0900-0959",2021-11-19,57,5,58,115
"23871","0900-0959",2021-11-20,53,6,56,109
"23872","0900-0959",2021-11-21,56,7,53,109
"23873","0900-0959",2021-11-22,59,1,59,118
"23874","0900-0959",2021-11-23,60,2,60,120
"23875","0900-0959",2021-11-24,63,3,61,124
"23876","0900-0959",2021-11-25,59,4,58,117
"23877","0900-0959",2021-11-26,57,5,47,104
"23878","0900-0959",2021-11-27,54,6,58,112
"23879","0900-0959",2021-11-28,63,7,58,121
"23880","0900-0959",2021-11-29,61,1,64,125
"23881","0900-0959",2021-11-30,56,2,57,113
"23882","1000-1059",2021-11-01,79,1,52,131
"23883","1000-1059",2021-11-02,73,2,44,117
"23884","1000-1059",2021-11-03,73,3,46,119
"23885","1000-1059",2021-11-04,78,4,51,129
"23886","1000-1059",2021-11-05,74,5,52,126
"23887","1000-1059",2021-11-06,68,6,49,117
"23888","1000-1059",2021-11-07,70,7,40,110
"23889","1000-1059",2021-11-08,73,1,52,125
"23890","1000-1059",2021-11-09,67,2,38,105
"23891","1000-1059",2021-11-10,66,3,39,105
"23892","1000-1059",2021-11-11,76,4,50,126
"23893","1000-1059",2021-11-12,72,5,52,124
"23894","1000-1059",2021-11-13,63,6,42,105
"23895","1000-1059",2021-11-14,71,7,41,112
"23896","1000-1059",2021-11-15,73,1,51,124
"23897","1000-1059",2021-11-16,67,2,38,105
"23898","1000-1059",2021-11-17,64,3,38,102
"23899","1000-1059",2021-11-18,75,4,47,122
"23900","1000-1059",2021-11-19,73,5,48,121
"23901","1000-1059",2021-11-20,65,6,42,107
"23902","1000-1059",2021-11-21,70,7,42,112
"23903","1000-1059",2021-11-22,71,1,47,118
"23904","1000-1059",2021-11-23,69,2,46,115
"23905","1000-1059",2021-11-24,68,3,48,116
"23906","1000-1059",2021-11-25,58,4,40,98
"23907","1000-1059",2021-11-26,54,5,30,84
"23908","1000-1059",2021-11-27,66,6,43,109
"23909","1000-1059",2021-11-28,69,7,46,115
"23910","1000-1059",2021-11-29,70,1,45,115
"23911","1000-1059",2021-11-30,71,2,48,119
"23912","1100-1159",2021-11-01,57,1,57,114
"23913","1100-1159",2021-11-02,51,2,64,115
"23914","1100-1159",2021-11-03,51,3,62,113
"23915","1100-1159",2021-11-04,54,4,62,116
"23916","1100-1159",2021-11-05,56,5,65,121
"23917","1100-1159",2021-11-06,50,6,65,115
"23918","1100-1159",2021-11-07,50,7,64,114
"23919","1100-1159",2021-11-08,54,1,69,123
"23920","1100-1159",2021-11-09,47,2,67,114
"23921","1100-1159",2021-11-10,47,3,65,112
"23922","1100-1159",2021-11-11,52,4,71,123
"23923","1100-1159",2021-11-12,53,5,72,125
"23924","1100-1159",2021-11-13,47,6,66,113
"23925","1100-1159",2021-11-14,50,7,66,116
"23926","1100-1159",2021-11-15,53,1,69,122
"23927","1100-1159",2021-11-16,46,2,67,113
"23928","1100-1159",2021-11-17,48,3,66,114
"23929","1100-1159",2021-11-18,50,4,69,119
"23930","1100-1159",2021-11-19,50,5,66,116
"23931","1100-1159",2021-11-20,49,6,64,113
"23932","1100-1159",2021-11-21,49,7,61,110
"23933","1100-1159",2021-11-22,50,1,64,114
"23934","1100-1159",2021-11-23,52,2,59,111
"23935","1100-1159",2021-11-24,52,3,59,111
"23936","1100-1159",2021-11-25,48,4,59,107
"23937","1100-1159",2021-11-26,51,5,58,109
"23938","1100-1159",2021-11-27,51,6,63,114
"23939","1100-1159",2021-11-28,52,7,59,111
"23940","1100-1159",2021-11-29,51,1,56,107
"23941","1100-1159",2021-11-30,49,2,65,114
"23942","1200-1259",2021-11-01,58,1,77,135
"23943","1200-1259",2021-11-02,51,2,66,117
"23944","1200-1259",2021-11-03,54,3,69,123
"23945","1200-1259",2021-11-04,57,4,74,131
"23946","1200-1259",2021-11-05,58,5,72,130
"23947","1200-1259",2021-11-06,54,6,62,116
"23948","1200-1259",2021-11-07,55,7,75,130
"23949","1200-1259",2021-11-08,56,1,71,127
"23950","1200-1259",2021-11-09,57,2,66,123
"23951","1200-1259",2021-11-10,58,3,66,124
"23952","1200-1259",2021-11-11,55,4,73,128
"23953","1200-1259",2021-11-12,57,5,72,129
"23954","1200-1259",2021-11-13,51,6,65,116
"23955","1200-1259",2021-11-14,55,7,75,130
"23956","1200-1259",2021-11-15,56,1,71,127
"23957","1200-1259",2021-11-16,59,2,64,123
"23958","1200-1259",2021-11-17,57,3,66,123
"23959","1200-1259",2021-11-18,55,4,74,129
"23960","1200-1259",2021-11-19,55,5,74,129
"23961","1200-1259",2021-11-20,51,6,69,120
"23962","1200-1259",2021-11-21,53,7,79,132
"23963","1200-1259",2021-11-22,54,1,74,128
"23964","1200-1259",2021-11-23,54,2,84,138
"23965","1200-1259",2021-11-24,55,3,84,139
"23966","1200-1259",2021-11-25,50,4,70,120
"23967","1200-1259",2021-11-26,52,5,66,118
"23968","1200-1259",2021-11-27,51,6,73,124
"23969","1200-1259",2021-11-28,54,7,86,140
"23970","1200-1259",2021-11-29,56,1,85,141
"23971","1200-1259",2021-11-30,52,2,72,124
"23972","1300-1359",2021-11-01,73,1,58,131
"23973","1300-1359",2021-11-02,69,2,53,122
"23974","1300-1359",2021-11-03,69,3,53,122
"23975","1300-1359",2021-11-04,74,4,54,128
"23976","1300-1359",2021-11-05,73,5,55,128
"23977","1300-1359",2021-11-06,56,6,50,106
"23978","1300-1359",2021-11-07,72,7,47,119
"23979","1300-1359",2021-11-08,75,1,53,128
"23980","1300-1359",2021-11-09,69,2,53,122
"23981","1300-1359",2021-11-10,71,3,54,125
"23982","1300-1359",2021-11-11,77,4,50,127
"23983","1300-1359",2021-11-12,74,5,51,125
"23984","1300-1359",2021-11-13,61,6,51,112
"23985","1300-1359",2021-11-14,72,7,48,120
"23986","1300-1359",2021-11-15,76,1,53,129
"23987","1300-1359",2021-11-16,69,2,54,123
"23988","1300-1359",2021-11-17,74,3,54,128
"23989","1300-1359",2021-11-18,75,4,48,123
"23990","1300-1359",2021-11-19,75,5,44,119
"23991","1300-1359",2021-11-20,63,6,42,105
"23992","1300-1359",2021-11-21,71,7,39,110
"23993","1300-1359",2021-11-22,74,1,43,117
"23994","1300-1359",2021-11-23,72,2,43,115
"23995","1300-1359",2021-11-24,73,3,43,116
"23996","1300-1359",2021-11-25,70,4,49,119
"23997","1300-1359",2021-11-26,70,5,46,116
"23998","1300-1359",2021-11-27,68,6,43,111
"23999","1300-1359",2021-11-28,77,7,43,120
"24000","1300-1359",2021-11-29,75,1,44,119
"24001","1300-1359",2021-11-30,73,2,42,115
"24002","1400-1459",2021-11-01,64,1,60,124
"24003","1400-1459",2021-11-02,52,2,53,105
"24004","1400-1459",2021-11-03,55,3,55,110
"24005","1400-1459",2021-11-04,59,4,60,119
"24006","1400-1459",2021-11-05,59,5,61,120
"24007","1400-1459",2021-11-06,50,6,53,103
"24008","1400-1459",2021-11-07,53,7,66,119
"24009","1400-1459",2021-11-08,56,1,68,124
"24010","1400-1459",2021-11-09,51,2,60,111
"24011","1400-1459",2021-11-10,51,3,61,112
"24012","1400-1459",2021-11-11,54,4,66,120
"24013","1400-1459",2021-11-12,53,5,69,122
"24014","1400-1459",2021-11-13,50,6,57,107
"24015","1400-1459",2021-11-14,53,7,66,119
"24016","1400-1459",2021-11-15,55,1,68,123
"24017","1400-1459",2021-11-16,51,2,61,112
"24018","1400-1459",2021-11-17,54,3,61,115
"24019","1400-1459",2021-11-18,56,4,66,122
"24020","1400-1459",2021-11-19,58,5,67,125
"24021","1400-1459",2021-11-20,52,6,64,116
"24022","1400-1459",2021-11-21,57,7,65,122
"24023","1400-1459",2021-11-22,60,1,68,128
"24024","1400-1459",2021-11-23,65,2,66,131
"24025","1400-1459",2021-11-24,62,3,68,130
"24026","1400-1459",2021-11-25,36,4,53,89
"24027","1400-1459",2021-11-26,56,5,59,115
"24028","1400-1459",2021-11-27,54,6,62,116
"24029","1400-1459",2021-11-28,58,7,65,123
"24030","1400-1459",2021-11-29,61,1,66,127
"24031","1400-1459",2021-11-30,58,2,65,123
"24032","1500-1559",2021-11-01,66,1,66,132
"24033","1500-1559",2021-11-02,51,2,59,110
"24034","1500-1559",2021-11-03,52,3,59,111
"24035","1500-1559",2021-11-04,60,4,62,122
"24036","1500-1559",2021-11-05,63,5,58,121
"24037","1500-1559",2021-11-06,45,6,47,92
"24038","1500-1559",2021-11-07,65,7,52,117
"24039","1500-1559",2021-11-08,72,1,55,127
"24040","1500-1559",2021-11-09,58,2,51,109
"24041","1500-1559",2021-11-10,60,3,51,111
"24042","1500-1559",2021-11-11,70,4,58,128
"24043","1500-1559",2021-11-12,72,5,55,127
"24044","1500-1559",2021-11-13,59,6,46,105
"24045","1500-1559",2021-11-14,64,7,53,117
"24046","1500-1559",2021-11-15,71,1,56,127
"24047","1500-1559",2021-11-16,59,2,52,111
"24048","1500-1559",2021-11-17,61,3,52,113
"24049","1500-1559",2021-11-18,68,4,58,126
"24050","1500-1559",2021-11-19,68,5,62,130
"24051","1500-1559",2021-11-20,54,6,49,103
"24052","1500-1559",2021-11-21,61,7,58,119
"24053","1500-1559",2021-11-22,64,1,61,125
"24054","1500-1559",2021-11-23,57,2,63,120
"24055","1500-1559",2021-11-24,59,3,63,122
"24056","1500-1559",2021-11-25,44,4,50,94
"24057","1500-1559",2021-11-26,61,5,53,114
"24058","1500-1559",2021-11-27,59,6,54,113
"24059","1500-1559",2021-11-28,65,7,63,128
"24060","1500-1559",2021-11-29,60,1,63,123
"24061","1500-1559",2021-11-30,61,2,64,125
"24062","1600-1659",2021-11-01,57,1,62,119
"24063","1600-1659",2021-11-02,61,2,56,117
"24064","1600-1659",2021-11-03,61,3,55,116
"24065","1600-1659",2021-11-04,65,4,64,129
"24066","1600-1659",2021-11-05,64,5,62,126
"24067","1600-1659",2021-11-06,48,6,48,96
"24068","1600-1659",2021-11-07,65,7,60,125
"24069","1600-1659",2021-11-08,61,1,58,119
"24070","1600-1659",2021-11-09,59,2,61,120
"24071","1600-1659",2021-11-10,60,3,62,122
"24072","1600-1659",2021-11-11,64,4,60,124
"24073","1600-1659",2021-11-12,63,5,58,121
"24074","1600-1659",2021-11-13,53,6,52,105
"24075","1600-1659",2021-11-14,65,7,60,125
"24076","1600-1659",2021-11-15,62,1,58,120
"24077","1600-1659",2021-11-16,59,2,62,121
"24078","1600-1659",2021-11-17,59,3,62,121
"24079","1600-1659",2021-11-18,66,4,58,124
"24080","1600-1659",2021-11-19,68,5,56,124
"24081","1600-1659",2021-11-20,60,6,52,112
"24082","1600-1659",2021-11-21,68,7,56,124
"24083","1600-1659",2021-11-22,67,1,56,123
"24084","1600-1659",2021-11-23,70,2,55,125
"24085","1600-1659",2021-11-24,68,3,54,122
"24086","1600-1659",2021-11-25,30,4,62,92
"24087","1600-1659",2021-11-26,60,5,60,120
"24088","1600-1659",2021-11-27,64,6,53,117
"24089","1600-1659",2021-11-28,71,7,53,124
"24090","1600-1659",2021-11-29,69,1,55,124
"24091","1600-1659",2021-11-30,67,2,54,121
"24092","1700-1759",2021-11-01,64,1,67,131
"24093","1700-1759",2021-11-02,51,2,59,110
"24094","1700-1759",2021-11-03,52,3,61,113
"24095","1700-1759",2021-11-04,62,4,63,125
"24096","1700-1759",2021-11-05,59,5,62,121
"24097","1700-1759",2021-11-06,50,6,56,106
"24098","1700-1759",2021-11-07,62,7,65,127
"24099","1700-1759",2021-11-08,60,1,72,132
"24100","1700-1759",2021-11-09,52,2,63,115
"24101","1700-1759",2021-11-10,51,3,64,115
"24102","1700-1759",2021-11-11,64,4,71,135
"24103","1700-1759",2021-11-12,61,5,70,131
"24104","1700-1759",2021-11-13,53,6,62,115
"24105","1700-1759",2021-11-14,62,7,65,127
"24106","1700-1759",2021-11-15,60,1,71,131
"24107","1700-1759",2021-11-16,51,2,63,114
"24108","1700-1759",2021-11-17,56,3,64,120
"24109","1700-1759",2021-11-18,63,4,71,134
"24110","1700-1759",2021-11-19,61,5,71,132
"24111","1700-1759",2021-11-20,55,6,61,116
"24112","1700-1759",2021-11-21,59,7,68,127
"24113","1700-1759",2021-11-22,59,1,73,132
"24114","1700-1759",2021-11-23,57,2,68,125
"24115","1700-1759",2021-11-24,60,3,68,128
"24116","1700-1759",2021-11-25,34,4,37,71
"24117","1700-1759",2021-11-26,47,5,59,106
"24118","1700-1759",2021-11-27,59,6,61,120
"24119","1700-1759",2021-11-28,60,7,71,131
"24120","1700-1759",2021-11-29,62,1,71,133
"24121","1700-1759",2021-11-30,57,2,70,127
"24122","1800-1859",2021-11-01,60,1,68,128
"24123","1800-1859",2021-11-02,60,2,60,120
"24124","1800-1859",2021-11-03,59,3,63,122
"24125","1800-1859",2021-11-04,63,4,66,129
"24126","1800-1859",2021-11-05,62,5,62,124
"24127","1800-1859",2021-11-06,56,6,52,108
"24128","1800-1859",2021-11-07,65,7,65,130
"24129","1800-1859",2021-11-08,66,1,66,132
"24130","1800-1859",2021-11-09,57,2,62,119
"24131","1800-1859",2021-11-10,58,3,61,119
"24132","1800-1859",2021-11-11,67,4,68,135
"24133","1800-1859",2021-11-12,67,5,65,132
"24134","1800-1859",2021-11-13,52,6,54,106
"24135","1800-1859",2021-11-14,65,7,64,129
"24136","1800-1859",2021-11-15,65,1,66,131
"24137","1800-1859",2021-11-16,58,2,62,120
"24138","1800-1859",2021-11-17,59,3,62,121
"24139","1800-1859",2021-11-18,65,4,65,130
"24140","1800-1859",2021-11-19,67,5,64,131
"24141","1800-1859",2021-11-20,53,6,57,110
"24142","1800-1859",2021-11-21,61,7,61,122
"24143","1800-1859",2021-11-22,62,1,63,125
"24144","1800-1859",2021-11-23,60,2,62,122
"24145","1800-1859",2021-11-24,64,3,65,129
"24146","1800-1859",2021-11-25,14,4,33,47
"24147","1800-1859",2021-11-26,52,5,54,106
"24148","1800-1859",2021-11-27,58,6,61,119
"24149","1800-1859",2021-11-28,67,7,66,133
"24150","1800-1859",2021-11-29,65,1,64,129
"24151","1800-1859",2021-11-30,61,2,64,125
"24152","1900-1959",2021-11-01,66,1,51,117
"24153","1900-1959",2021-11-02,61,2,51,112
"24154","1900-1959",2021-11-03,59,3,49,108
"24155","1900-1959",2021-11-04,67,4,55,122
"24156","1900-1959",2021-11-05,66,5,59,125
"24157","1900-1959",2021-11-06,55,6,47,102
"24158","1900-1959",2021-11-07,68,7,53,121
"24159","1900-1959",2021-11-08,73,1,56,129
"24160","1900-1959",2021-11-09,58,2,47,105
"24161","1900-1959",2021-11-10,56,3,47,103
"24162","1900-1959",2021-11-11,73,4,55,128
"24163","1900-1959",2021-11-12,70,5,56,126
"24164","1900-1959",2021-11-13,51,6,46,97
"24165","1900-1959",2021-11-14,67,7,52,119
"24166","1900-1959",2021-11-15,72,1,55,127
"24167","1900-1959",2021-11-16,57,2,46,103
"24168","1900-1959",2021-11-17,56,3,47,103
"24169","1900-1959",2021-11-18,73,4,55,128
"24170","1900-1959",2021-11-19,70,5,55,125
"24171","1900-1959",2021-11-20,60,6,46,106
"24172","1900-1959",2021-11-21,65,7,52,117
"24173","1900-1959",2021-11-22,66,1,51,117
"24174","1900-1959",2021-11-23,69,2,50,119
"24175","1900-1959",2021-11-24,72,3,49,121
"24176","1900-1959",2021-11-25,17,4,35,52
"24177","1900-1959",2021-11-26,50,5,50,100
"24178","1900-1959",2021-11-27,68,6,48,116
"24179","1900-1959",2021-11-28,72,7,52,124
"24180","1900-1959",2021-11-29,72,1,53,125
"24181","1900-1959",2021-11-30,63,2,53,116
"24182","2000-2059",2021-11-01,50,1,80,130
"24183","2000-2059",2021-11-02,46,2,72,118
"24184","2000-2059",2021-11-03,47,3,75,122
"24185","2000-2059",2021-11-04,48,4,85,133
"24186","2000-2059",2021-11-05,50,5,84,134
"24187","2000-2059",2021-11-06,30,6,73,103
"24188","2000-2059",2021-11-07,41,7,79,120
"24189","2000-2059",2021-11-08,43,1,80,123
"24190","2000-2059",2021-11-09,37,2,65,102
"24191","2000-2059",2021-11-10,39,3,66,105
"24192","2000-2059",2021-11-11,41,4,80,121
"24193","2000-2059",2021-11-12,42,5,81,123
"24194","2000-2059",2021-11-13,25,6,63,88
"24195","2000-2059",2021-11-14,40,7,80,120
"24196","2000-2059",2021-11-15,42,1,79,121
"24197","2000-2059",2021-11-16,37,2,66,103
"24198","2000-2059",2021-11-17,43,3,68,111
"24199","2000-2059",2021-11-18,46,4,80,126
"24200","2000-2059",2021-11-19,45,5,78,123
"24201","2000-2059",2021-11-20,40,6,67,107
"24202","2000-2059",2021-11-21,47,7,76,123
"24203","2000-2059",2021-11-22,47,1,76,123
"24204","2000-2059",2021-11-23,44,2,74,118
"24205","2000-2059",2021-11-24,43,3,79,122
"24206","2000-2059",2021-11-25,22,4,31,53
"24207","2000-2059",2021-11-26,42,5,60,102
"24208","2000-2059",2021-11-27,43,6,74,117
"24209","2000-2059",2021-11-28,46,7,82,128
"24210","2000-2059",2021-11-29,44,1,79,123
"24211","2000-2059",2021-11-30,45,2,72,117
"24212","2100-2159",2021-11-01,50,1,70,120
"24213","2100-2159",2021-11-02,32,2,64,96
"24214","2100-2159",2021-11-03,35,3,63,98
"24215","2100-2159",2021-11-04,42,4,72,114
"24216","2100-2159",2021-11-05,42,5,74,116
"24217","2100-2159",2021-11-06,28,6,60,88
"24218","2100-2159",2021-11-07,48,7,77,125
"24219","2100-2159",2021-11-08,38,1,79,117
"24220","2100-2159",2021-11-09,26,2,69,95
"24221","2100-2159",2021-11-10,29,3,70,99
"24222","2100-2159",2021-11-11,40,4,79,119
"24223","2100-2159",2021-11-12,39,5,77,116
"24224","2100-2159",2021-11-13,28,6,66,94
"24225","2100-2159",2021-11-14,48,7,76,124
"24226","2100-2159",2021-11-15,38,1,80,118
"24227","2100-2159",2021-11-16,26,2,69,95
"24228","2100-2159",2021-11-17,31,3,72,103
"24229","2100-2159",2021-11-18,38,4,77,115
"24230","2100-2159",2021-11-19,43,5,75,118
"24231","2100-2159",2021-11-20,34,6,70,104
"24232","2100-2159",2021-11-21,49,7,73,122
"24233","2100-2159",2021-11-22,39,1,70,109
"24234","2100-2159",2021-11-23,44,2,76,120
"24235","2100-2159",2021-11-24,48,3,76,124
"24236","2100-2159",2021-11-25,10,4,31,41
"24237","2100-2159",2021-11-26,28,5,66,94
"24238","2100-2159",2021-11-27,45,6,76,121
"24239","2100-2159",2021-11-28,51,7,78,129
"24240","2100-2159",2021-11-29,48,1,76,124
"24241","2100-2159",2021-11-30,37,2,70,107
"24242","2200-2259",2021-11-01,33,1,73,106
"24243","2200-2259",2021-11-02,32,2,67,99
"24244","2200-2259",2021-11-03,38,3,68,106
"24245","2200-2259",2021-11-04,38,4,67,105
"24246","2200-2259",2021-11-05,41,5,66,107
"24247","2200-2259",2021-11-06,23,6,50,73
"24248","2200-2259",2021-11-07,41,7,73,114
"24249","2200-2259",2021-11-08,39,1,65,104
"24250","2200-2259",2021-11-09,30,2,54,84
"24251","2200-2259",2021-11-10,36,3,56,92
"24252","2200-2259",2021-11-11,40,4,67,107
"24253","2200-2259",2021-11-12,42,5,64,106
"24254","2200-2259",2021-11-13,29,6,49,78
"24255","2200-2259",2021-11-14,41,7,71,112
"24256","2200-2259",2021-11-15,40,1,63,103
"24257","2200-2259",2021-11-16,30,2,54,84
"24258","2200-2259",2021-11-17,40,3,59,99
"24259","2200-2259",2021-11-18,43,4,70,113
"24260","2200-2259",2021-11-19,42,5,75,117
"24261","2200-2259",2021-11-20,38,6,51,89
"24262","2200-2259",2021-11-21,38,7,78,116
"24263","2200-2259",2021-11-22,38,1,73,111
"24264","2200-2259",2021-11-23,44,2,71,115
"24265","2200-2259",2021-11-24,43,3,75,118
"24266","2200-2259",2021-11-25,22,4,26,48
"24267","2200-2259",2021-11-26,39,5,59,98
"24268","2200-2259",2021-11-27,44,6,65,109
"24269","2200-2259",2021-11-28,46,7,78,124
"24270","2200-2259",2021-11-29,42,1,76,118
"24271","2200-2259",2021-11-30,35,2,64,99
"24272","2300-2359",2021-11-01,25,1,68,93
"24273","2300-2359",2021-11-02,21,2,57,78
"24274","2300-2359",2021-11-03,22,3,57,79
"24275","2300-2359",2021-11-04,27,4,64,91
"24276","2300-2359",2021-11-05,25,5,68,93
"24277","2300-2359",2021-11-06,35,6,42,77
"24278","2300-2359",2021-11-07,29,7,73,102
"24279","2300-2359",2021-11-08,30,1,74,104
"24280","2300-2359",2021-11-09,24,2,59,83
"24281","2300-2359",2021-11-10,25,3,60,85
"24282","2300-2359",2021-11-11,30,4,73,103
"24283","2300-2359",2021-11-12,29,5,77,106
"24284","2300-2359",2021-11-13,30,6,46,76
"24285","2300-2359",2021-11-14,30,7,74,104
"24286","2300-2359",2021-11-15,29,1,75,104
"24287","2300-2359",2021-11-16,24,2,59,83
"24288","2300-2359",2021-11-17,27,3,59,86
"24289","2300-2359",2021-11-18,28,4,70,98
"24290","2300-2359",2021-11-19,28,5,71,99
"24291","2300-2359",2021-11-20,27,6,60,87
"24292","2300-2359",2021-11-21,27,7,70,97
"24293","2300-2359",2021-11-22,27,1,67,94
"24294","2300-2359",2021-11-23,26,2,68,94
"24295","2300-2359",2021-11-24,28,3,70,98
"24296","2300-2359",2021-11-25,15,4,24,39
"24297","2300-2359",2021-11-26,26,5,53,79
"24298","2300-2359",2021-11-27,27,6,69,96
"24299","2300-2359",2021-11-28,29,7,71,100
"24300","2300-2359",2021-11-29,29,1,68,97
"24301","2300-2359",2021-11-30,24,2,65,89
"24302","0001-0559",2021-12-01,12,3,42,54
"24303","0001-0559",2021-12-02,15,4,52,67
"24304","0001-0559",2021-12-03,16,5,54,70
"24305","0001-0559",2021-12-04,18,6,34,52
"24306","0001-0559",2021-12-05,14,7,54,68
"24307","0001-0559",2021-12-06,19,1,45,64
"24308","0001-0559",2021-12-07,13,2,30,43
"24309","0001-0559",2021-12-08,12,3,37,49
"24310","0001-0559",2021-12-09,17,4,50,67
"24311","0001-0559",2021-12-10,17,5,52,69
"24312","0001-0559",2021-12-11,19,6,32,51
"24313","0001-0559",2021-12-12,14,7,51,65
"24314","0001-0559",2021-12-13,19,1,46,65
"24315","0001-0559",2021-12-14,12,2,28,40
"24316","0001-0559",2021-12-15,13,3,35,48
"24317","0001-0559",2021-12-16,25,4,64,89
"24318","0001-0559",2021-12-17,22,5,65,87
"24319","0001-0559",2021-12-18,23,6,60,83
"24320","0001-0559",2021-12-19,18,7,62,80
"24321","0001-0559",2021-12-20,24,1,62,86
"24322","0001-0559",2021-12-21,21,2,64,85
"24323","0001-0559",2021-12-22,20,3,67,87
"24324","0001-0559",2021-12-23,20,4,76,96
"24325","0001-0559",2021-12-24,17,5,48,65
"24326","0001-0559",2021-12-25,14,6,52,66
"24327","0001-0559",2021-12-26,20,7,73,93
"24328","0001-0559",2021-12-27,20,1,74,94
"24329","0001-0559",2021-12-28,19,2,70,89
"24330","0001-0559",2021-12-29,18,3,74,92
"24331","0001-0559",2021-12-30,20,4,73,93
"24332","0001-0559",2021-12-31,17,5,48,65
"24333","0600-0659",2021-12-01,75,3,30,105
"24334","0600-0659",2021-12-02,82,4,32,114
"24335","0600-0659",2021-12-03,79,5,31,110
"24336","0600-0659",2021-12-04,74,6,29,103
"24337","0600-0659",2021-12-05,75,7,31,106
"24338","0600-0659",2021-12-06,78,1,31,109
"24339","0600-0659",2021-12-07,76,2,25,101
"24340","0600-0659",2021-12-08,73,3,28,101
"24341","0600-0659",2021-12-09,79,4,32,111
"24342","0600-0659",2021-12-10,80,5,31,111
"24343","0600-0659",2021-12-11,73,6,28,101
"24344","0600-0659",2021-12-12,75,7,31,106
"24345","0600-0659",2021-12-13,80,1,31,111
"24346","0600-0659",2021-12-14,76,2,25,101
"24347","0600-0659",2021-12-15,73,3,29,102
"24348","0600-0659",2021-12-16,85,4,32,117
"24349","0600-0659",2021-12-17,90,5,31,121
"24350","0600-0659",2021-12-18,83,6,31,114
"24351","0600-0659",2021-12-19,84,7,29,113
"24352","0600-0659",2021-12-20,88,1,30,118
"24353","0600-0659",2021-12-21,85,2,32,117
"24354","0600-0659",2021-12-22,88,3,32,120
"24355","0600-0659",2021-12-23,97,4,32,129
"24356","0600-0659",2021-12-24,85,5,23,108
"24357","0600-0659",2021-12-25,66,6,30,96
"24358","0600-0659",2021-12-26,88,7,31,119
"24359","0600-0659",2021-12-27,90,1,31,121
"24360","0600-0659",2021-12-28,86,2,32,118
"24361","0600-0659",2021-12-29,87,3,32,119
"24362","0600-0659",2021-12-30,92,4,32,124
"24363","0600-0659",2021-12-31,85,5,25,110
"24364","0700-0759",2021-12-01,73,3,41,114
"24365","0700-0759",2021-12-02,76,4,47,123
"24366","0700-0759",2021-12-03,76,5,49,125
"24367","0700-0759",2021-12-04,70,6,43,113
"24368","0700-0759",2021-12-05,74,7,41,115
"24369","0700-0759",2021-12-06,76,1,49,125
"24370","0700-0759",2021-12-07,69,2,48,117
"24371","0700-0759",2021-12-08,69,3,42,111
"24372","0700-0759",2021-12-09,76,4,47,123
"24373","0700-0759",2021-12-10,76,5,50,126
"24374","0700-0759",2021-12-11,70,6,42,112
"24375","0700-0759",2021-12-12,74,7,41,115
"24376","0700-0759",2021-12-13,75,1,49,124
"24377","0700-0759",2021-12-14,69,2,47,116
"24378","0700-0759",2021-12-15,69,3,41,110
"24379","0700-0759",2021-12-16,67,4,57,124
"24380","0700-0759",2021-12-17,74,5,60,134
"24381","0700-0759",2021-12-18,67,6,49,116
"24382","0700-0759",2021-12-19,73,7,49,122
"24383","0700-0759",2021-12-20,72,1,59,131
"24384","0700-0759",2021-12-21,71,2,55,126
"24385","0700-0759",2021-12-22,70,3,55,125
"24386","0700-0759",2021-12-23,71,4,54,125
"24387","0700-0759",2021-12-24,66,5,46,112
"24388","0700-0759",2021-12-25,54,6,38,92
"24389","0700-0759",2021-12-26,72,7,53,125
"24390","0700-0759",2021-12-27,72,1,55,127
"24391","0700-0759",2021-12-28,70,2,52,122
"24392","0700-0759",2021-12-29,69,3,52,121
"24393","0700-0759",2021-12-30,69,4,53,122
"24394","0700-0759",2021-12-31,64,5,46,110
"24395","0800-0859",2021-12-01,87,3,39,126
"24396","0800-0859",2021-12-02,93,4,40,133
"24397","0800-0859",2021-12-03,93,5,39,132
"24398","0800-0859",2021-12-04,80,6,40,120
"24399","0800-0859",2021-12-05,87,7,37,124
"24400","0800-0859",2021-12-06,91,1,39,130
"24401","0800-0859",2021-12-07,87,2,35,122
"24402","0800-0859",2021-12-08,89,3,36,125
"24403","0800-0859",2021-12-09,94,4,39,133
"24404","0800-0859",2021-12-10,92,5,39,131
"24405","0800-0859",2021-12-11,80,6,40,120
"24406","0800-0859",2021-12-12,87,7,37,124
"24407","0800-0859",2021-12-13,92,1,40,132
"24408","0800-0859",2021-12-14,87,2,35,122
"24409","0800-0859",2021-12-15,88,3,36,124
"24410","0800-0859",2021-12-16,107,4,38,145
"24411","0800-0859",2021-12-17,104,5,40,144
"24412","0800-0859",2021-12-18,83,6,43,126
"24413","0800-0859",2021-12-19,89,7,43,132
"24414","0800-0859",2021-12-20,102,1,42,144
"24415","0800-0859",2021-12-21,102,2,40,142
"24416","0800-0859",2021-12-22,102,3,42,144
"24417","0800-0859",2021-12-23,100,4,49,149
"24418","0800-0859",2021-12-24,97,5,42,139
"24419","0800-0859",2021-12-25,79,6,38,117
"24420","0800-0859",2021-12-26,94,7,45,139
"24421","0800-0859",2021-12-27,97,1,48,145
"24422","0800-0859",2021-12-28,99,2,44,143
"24423","0800-0859",2021-12-29,99,3,43,142
"24424","0800-0859",2021-12-30,99,4,48,147
"24425","0800-0859",2021-12-31,96,5,42,138
"24426","0900-0959",2021-12-01,58,3,50,108
"24427","0900-0959",2021-12-02,53,4,52,105
"24428","0900-0959",2021-12-03,54,5,51,105
"24429","0900-0959",2021-12-04,51,6,42,93
"24430","0900-0959",2021-12-05,52,7,45,97
"24431","0900-0959",2021-12-06,52,1,52,104
"24432","0900-0959",2021-12-07,48,2,46,94
"24433","0900-0959",2021-12-08,48,3,47,95
"24434","0900-0959",2021-12-09,49,4,51,100
"24435","0900-0959",2021-12-10,53,5,51,104
"24436","0900-0959",2021-12-11,51,6,44,95
"24437","0900-0959",2021-12-12,52,7,46,98
"24438","0900-0959",2021-12-13,52,1,52,104
"24439","0900-0959",2021-12-14,48,2,46,94
"24440","0900-0959",2021-12-15,50,3,47,97
"24441","0900-0959",2021-12-16,54,4,53,107
"24442","0900-0959",2021-12-17,61,5,58,119
"24443","0900-0959",2021-12-18,53,6,48,101
"24444","0900-0959",2021-12-19,60,7,50,110
"24445","0900-0959",2021-12-20,60,1,53,113
"24446","0900-0959",2021-12-21,56,2,53,109
"24447","0900-0959",2021-12-22,57,3,52,109
"24448","0900-0959",2021-12-23,60,4,53,113
"24449","0900-0959",2021-12-24,56,5,50,106
"24450","0900-0959",2021-12-25,52,6,25,77
"24451","0900-0959",2021-12-26,59,7,51,110
"24452","0900-0959",2021-12-27,62,1,50,112
"24453","0900-0959",2021-12-28,60,2,51,111
"24454","0900-0959",2021-12-29,61,3,50,111
"24455","0900-0959",2021-12-30,61,4,49,110
"24456","0900-0959",2021-12-31,56,5,47,103
"24457","1000-1059",2021-12-01,58,3,38,96
"24458","1000-1059",2021-12-02,61,4,39,100
"24459","1000-1059",2021-12-03,60,5,36,96
"24460","1000-1059",2021-12-04,54,6,38,92
"24461","1000-1059",2021-12-05,61,7,37,98
"24462","1000-1059",2021-12-06,60,1,36,96
"24463","1000-1059",2021-12-07,58,2,35,93
"24464","1000-1059",2021-12-08,58,3,34,92
"24465","1000-1059",2021-12-09,62,4,38,100
"24466","1000-1059",2021-12-10,61,5,37,98
"24467","1000-1059",2021-12-11,55,6,36,91
"24468","1000-1059",2021-12-12,61,7,36,97
"24469","1000-1059",2021-12-13,60,1,36,96
"24470","1000-1059",2021-12-14,58,2,35,93
"24471","1000-1059",2021-12-15,58,3,33,91
"24472","1000-1059",2021-12-16,68,4,50,118
"24473","1000-1059",2021-12-17,71,5,48,119
"24474","1000-1059",2021-12-18,61,6,41,102
"24475","1000-1059",2021-12-19,66,7,42,108
"24476","1000-1059",2021-12-20,68,1,47,115
"24477","1000-1059",2021-12-21,69,2,47,116
"24478","1000-1059",2021-12-22,68,3,47,115
"24479","1000-1059",2021-12-23,67,4,47,114
"24480","1000-1059",2021-12-24,58,5,38,96
"24481","1000-1059",2021-12-25,48,6,44,92
"24482","1000-1059",2021-12-26,67,7,48,115
"24483","1000-1059",2021-12-27,63,1,46,109
"24484","1000-1059",2021-12-28,65,2,47,112
"24485","1000-1059",2021-12-29,62,3,47,109
"24486","1000-1059",2021-12-30,63,4,48,111
"24487","1000-1059",2021-12-31,56,5,39,95
"24488","1100-1159",2021-12-01,39,3,55,94
"24489","1100-1159",2021-12-02,44,4,59,103
"24490","1100-1159",2021-12-03,43,5,60,103
"24491","1100-1159",2021-12-04,37,6,53,90
"24492","1100-1159",2021-12-05,41,7,56,97
"24493","1100-1159",2021-12-06,40,1,55,95
"24494","1100-1159",2021-12-07,40,2,51,91
"24495","1100-1159",2021-12-08,39,3,53,92
"24496","1100-1159",2021-12-09,43,4,57,100
"24497","1100-1159",2021-12-10,42,5,58,100
"24498","1100-1159",2021-12-11,37,6,52,89
"24499","1100-1159",2021-12-12,40,7,56,96
"24500","1100-1159",2021-12-13,40,1,55,95
"24501","1100-1159",2021-12-14,40,2,51,91
"24502","1100-1159",2021-12-15,39,3,53,92
"24503","1100-1159",2021-12-16,52,4,68,120
"24504","1100-1159",2021-12-17,54,5,70,124
"24505","1100-1159",2021-12-18,46,6,61,107
"24506","1100-1159",2021-12-19,47,7,60,107
"24507","1100-1159",2021-12-20,50,1,69,119
"24508","1100-1159",2021-12-21,50,2,68,118
"24509","1100-1159",2021-12-22,53,3,71,124
"24510","1100-1159",2021-12-23,52,4,62,114
"24511","1100-1159",2021-12-24,47,5,67,114
"24512","1100-1159",2021-12-25,46,6,59,105
"24513","1100-1159",2021-12-26,50,7,57,107
"24514","1100-1159",2021-12-27,51,1,61,112
"24515","1100-1159",2021-12-28,50,2,60,110
"24516","1100-1159",2021-12-29,53,3,64,117
"24517","1100-1159",2021-12-30,52,4,62,114
"24518","1100-1159",2021-12-31,49,5,66,115
"24519","1200-1259",2021-12-01,53,3,68,121
"24520","1200-1259",2021-12-02,58,4,70,128
"24521","1200-1259",2021-12-03,61,5,70,131
"24522","1200-1259",2021-12-04,49,6,66,115
"24523","1200-1259",2021-12-05,57,7,76,133
"24524","1200-1259",2021-12-06,61,1,74,135
"24525","1200-1259",2021-12-07,56,2,69,125
"24526","1200-1259",2021-12-08,55,3,69,124
"24527","1200-1259",2021-12-09,57,4,73,130
"24528","1200-1259",2021-12-10,60,5,74,134
"24529","1200-1259",2021-12-11,47,6,68,115
"24530","1200-1259",2021-12-12,55,7,75,130
"24531","1200-1259",2021-12-13,60,1,75,135
"24532","1200-1259",2021-12-14,55,2,69,124
"24533","1200-1259",2021-12-15,55,3,69,124
"24534","1200-1259",2021-12-16,51,4,60,111
"24535","1200-1259",2021-12-17,51,5,63,114
"24536","1200-1259",2021-12-18,58,6,54,112
"24537","1200-1259",2021-12-19,61,7,64,125
"24538","1200-1259",2021-12-20,59,1,60,119
"24539","1200-1259",2021-12-21,58,2,56,114
"24540","1200-1259",2021-12-22,60,3,58,118
"24541","1200-1259",2021-12-23,61,4,66,127
"24542","1200-1259",2021-12-24,60,5,53,113
"24543","1200-1259",2021-12-25,58,6,51,109
"24544","1200-1259",2021-12-26,63,7,67,130
"24545","1200-1259",2021-12-27,62,1,65,127
"24546","1200-1259",2021-12-28,61,2,64,125
"24547","1200-1259",2021-12-29,63,3,65,128
"24548","1200-1259",2021-12-30,63,4,66,129
"24549","1200-1259",2021-12-31,59,5,52,111
"24550","1300-1359",2021-12-01,76,3,46,122
"24551","1300-1359",2021-12-02,75,4,45,120
"24552","1300-1359",2021-12-03,76,5,47,123
"24553","1300-1359",2021-12-04,63,6,37,100
"24554","1300-1359",2021-12-05,68,7,36,104
"24555","1300-1359",2021-12-06,75,1,42,117
"24556","1300-1359",2021-12-07,67,2,39,106
"24557","1300-1359",2021-12-08,74,3,40,114
"24558","1300-1359",2021-12-09,75,4,42,117
"24559","1300-1359",2021-12-10,75,5,42,117
"24560","1300-1359",2021-12-11,64,6,36,100
"24561","1300-1359",2021-12-12,65,7,36,101
"24562","1300-1359",2021-12-13,75,1,42,117
"24563","1300-1359",2021-12-14,68,2,39,107
"24564","1300-1359",2021-12-15,72,3,40,112
"24565","1300-1359",2021-12-16,73,4,49,122
"24566","1300-1359",2021-12-17,74,5,51,125
"24567","1300-1359",2021-12-18,58,6,52,110
"24568","1300-1359",2021-12-19,61,7,53,114
"24569","1300-1359",2021-12-20,67,1,53,120
"24570","1300-1359",2021-12-21,64,2,53,117
"24571","1300-1359",2021-12-22,66,3,53,119
"24572","1300-1359",2021-12-23,63,4,55,118
"24573","1300-1359",2021-12-24,70,5,48,118
"24574","1300-1359",2021-12-25,57,6,44,101
"24575","1300-1359",2021-12-26,62,7,54,116
"24576","1300-1359",2021-12-27,62,1,53,115
"24577","1300-1359",2021-12-28,62,2,54,116
"24578","1300-1359",2021-12-29,64,3,54,118
"24579","1300-1359",2021-12-30,62,4,54,116
"24580","1300-1359",2021-12-31,71,5,48,119
"24581","1400-1459",2021-12-01,46,3,56,102
"24582","1400-1459",2021-12-02,45,4,64,109
"24583","1400-1459",2021-12-03,48,5,65,113
"24584","1400-1459",2021-12-04,40,6,57,97
"24585","1400-1459",2021-12-05,44,7,68,112
"24586","1400-1459",2021-12-06,48,1,67,115
"24587","1400-1459",2021-12-07,44,2,60,104
"24588","1400-1459",2021-12-08,43,3,61,104
"24589","1400-1459",2021-12-09,45,4,66,111
"24590","1400-1459",2021-12-10,46,5,69,115
"24591","1400-1459",2021-12-11,40,6,58,98
"24592","1400-1459",2021-12-12,44,7,66,110
"24593","1400-1459",2021-12-13,47,1,68,115
"24594","1400-1459",2021-12-14,44,2,60,104
"24595","1400-1459",2021-12-15,44,3,63,107
"24596","1400-1459",2021-12-16,48,4,68,116
"24597","1400-1459",2021-12-17,47,5,72,119
"24598","1400-1459",2021-12-18,47,6,59,106
"24599","1400-1459",2021-12-19,51,7,65,116
"24600","1400-1459",2021-12-20,49,1,70,119
"24601","1400-1459",2021-12-21,48,2,67,115
"24602","1400-1459",2021-12-22,49,3,68,117
"24603","1400-1459",2021-12-23,51,4,69,120
"24604","1400-1459",2021-12-24,38,5,69,107
"24605","1400-1459",2021-12-25,39,6,55,94
"24606","1400-1459",2021-12-26,52,7,65,117
"24607","1400-1459",2021-12-27,50,1,67,117
"24608","1400-1459",2021-12-28,51,2,65,116
"24609","1400-1459",2021-12-29,52,3,66,118
"24610","1400-1459",2021-12-30,51,4,67,118
"24611","1400-1459",2021-12-31,39,5,69,108
"24612","1500-1559",2021-12-01,58,3,52,110
"24613","1500-1559",2021-12-02,61,4,49,110
"24614","1500-1559",2021-12-03,60,5,52,112
"24615","1500-1559",2021-12-04,57,6,39,96
"24616","1500-1559",2021-12-05,59,7,47,106
"24617","1500-1559",2021-12-06,60,1,53,113
"24618","1500-1559",2021-12-07,55,2,49,104
"24619","1500-1559",2021-12-08,58,3,48,106
"24620","1500-1559",2021-12-09,60,4,49,109
"24621","1500-1559",2021-12-10,60,5,50,110
"24622","1500-1559",2021-12-11,57,6,40,97
"24623","1500-1559",2021-12-12,57,7,46,103
"24624","1500-1559",2021-12-13,60,1,51,111
"24625","1500-1559",2021-12-14,55,2,48,103
"24626","1500-1559",2021-12-15,59,3,46,105
"24627","1500-1559",2021-12-16,75,4,64,139
"24628","1500-1559",2021-12-17,77,5,62,139
"24629","1500-1559",2021-12-18,64,6,56,120
"24630","1500-1559",2021-12-19,70,7,61,131
"24631","1500-1559",2021-12-20,79,1,64,143
"24632","1500-1559",2021-12-21,75,2,61,136
"24633","1500-1559",2021-12-22,75,3,63,138
"24634","1500-1559",2021-12-23,71,4,63,134
"24635","1500-1559",2021-12-24,69,5,57,126
"24636","1500-1559",2021-12-25,63,6,52,115
"24637","1500-1559",2021-12-26,65,7,65,130
"24638","1500-1559",2021-12-27,71,1,64,135
"24639","1500-1559",2021-12-28,67,2,60,127
"24640","1500-1559",2021-12-29,67,3,61,128
"24641","1500-1559",2021-12-30,68,4,62,130
"24642","1500-1559",2021-12-31,69,5,57,126
"24643","1600-1659",2021-12-01,57,3,58,115
"24644","1600-1659",2021-12-02,59,4,62,121
"24645","1600-1659",2021-12-03,61,5,60,121
"24646","1600-1659",2021-12-04,46,6,53,99
"24647","1600-1659",2021-12-05,61,7,56,117
"24648","1600-1659",2021-12-06,59,1,58,117
"24649","1600-1659",2021-12-07,54,2,58,112
"24650","1600-1659",2021-12-08,55,3,59,114
"24651","1600-1659",2021-12-09,60,4,59,119
"24652","1600-1659",2021-12-10,61,5,60,121
"24653","1600-1659",2021-12-11,46,6,53,99
"24654","1600-1659",2021-12-12,60,7,54,114
"24655","1600-1659",2021-12-13,58,1,58,116
"24656","1600-1659",2021-12-14,53,2,58,111
"24657","1600-1659",2021-12-15,53,3,60,113
"24658","1600-1659",2021-12-16,67,4,52,119
"24659","1600-1659",2021-12-17,67,5,57,124
"24660","1600-1659",2021-12-18,60,6,50,110
"24661","1600-1659",2021-12-19,65,7,56,121
"24662","1600-1659",2021-12-20,69,1,56,125
"24663","1600-1659",2021-12-21,63,2,54,117
"24664","1600-1659",2021-12-22,68,3,56,124
"24665","1600-1659",2021-12-23,71,4,55,126
"24666","1600-1659",2021-12-24,58,5,66,124
"24667","1600-1659",2021-12-25,60,6,49,109
"24668","1600-1659",2021-12-26,69,7,55,124
"24669","1600-1659",2021-12-27,69,1,58,127
"24670","1600-1659",2021-12-28,63,2,55,118
"24671","1600-1659",2021-12-29,67,3,57,124
"24672","1600-1659",2021-12-30,69,4,55,124
"24673","1600-1659",2021-12-31,59,5,66,125
"24674","1700-1759",2021-12-01,57,3,62,119
"24675","1700-1759",2021-12-02,61,4,60,121
"24676","1700-1759",2021-12-03,62,5,62,124
"24677","1700-1759",2021-12-04,56,6,52,108
"24678","1700-1759",2021-12-05,61,7,59,120
"24679","1700-1759",2021-12-06,57,1,61,118
"24680","1700-1759",2021-12-07,51,2,55,106
"24681","1700-1759",2021-12-08,55,3,58,113
"24682","1700-1759",2021-12-09,59,4,59,118
"24683","1700-1759",2021-12-10,61,5,59,120
"24684","1700-1759",2021-12-11,52,6,49,101
"24685","1700-1759",2021-12-12,61,7,59,120
"24686","1700-1759",2021-12-13,57,1,60,117
"24687","1700-1759",2021-12-14,50,2,55,105
"24688","1700-1759",2021-12-15,57,3,59,116
"24689","1700-1759",2021-12-16,58,4,65,123
"24690","1700-1759",2021-12-17,58,5,66,124
"24691","1700-1759",2021-12-18,55,6,54,109
"24692","1700-1759",2021-12-19,58,7,58,116
"24693","1700-1759",2021-12-20,57,1,66,123
"24694","1700-1759",2021-12-21,57,2,65,122
"24695","1700-1759",2021-12-22,59,3,65,124
"24696","1700-1759",2021-12-23,58,4,62,120
"24697","1700-1759",2021-12-24,48,5,51,99
"24698","1700-1759",2021-12-25,53,6,50,103
"24699","1700-1759",2021-12-26,58,7,58,116
"24700","1700-1759",2021-12-27,60,1,62,122
"24701","1700-1759",2021-12-28,58,2,61,119
"24702","1700-1759",2021-12-29,60,3,62,122
"24703","1700-1759",2021-12-30,58,4,62,120
"24704","1700-1759",2021-12-31,49,5,51,100
"24705","1800-1859",2021-12-01,57,3,54,111
"24706","1800-1859",2021-12-02,62,4,53,115
"24707","1800-1859",2021-12-03,63,5,55,118
"24708","1800-1859",2021-12-04,44,6,49,93
"24709","1800-1859",2021-12-05,64,7,53,117
"24710","1800-1859",2021-12-06,64,1,56,120
"24711","1800-1859",2021-12-07,56,2,52,108
"24712","1800-1859",2021-12-08,55,3,53,108
"24713","1800-1859",2021-12-09,62,4,55,117
"24714","1800-1859",2021-12-10,61,5,54,115
"24715","1800-1859",2021-12-11,44,6,51,95
"24716","1800-1859",2021-12-12,64,7,54,118
"24717","1800-1859",2021-12-13,63,1,56,119
"24718","1800-1859",2021-12-14,57,2,52,109
"24719","1800-1859",2021-12-15,56,3,56,112
"24720","1800-1859",2021-12-16,70,4,61,131
"24721","1800-1859",2021-12-17,69,5,61,130
"24722","1800-1859",2021-12-18,60,6,55,115
"24723","1800-1859",2021-12-19,66,7,55,121
"24724","1800-1859",2021-12-20,69,1,58,127
"24725","1800-1859",2021-12-21,69,2,59,128
"24726","1800-1859",2021-12-22,71,3,61,132
"24727","1800-1859",2021-12-23,68,4,57,125
"24728","1800-1859",2021-12-24,37,5,48,85
"24729","1800-1859",2021-12-25,50,6,48,98
"24730","1800-1859",2021-12-26,69,7,58,127
"24731","1800-1859",2021-12-27,69,1,55,124
"24732","1800-1859",2021-12-28,66,2,55,121
"24733","1800-1859",2021-12-29,70,3,57,127
"24734","1800-1859",2021-12-30,68,4,55,123
"24735","1800-1859",2021-12-31,37,5,48,85
"24736","1900-1959",2021-12-01,52,3,51,103
"24737","1900-1959",2021-12-02,58,4,59,117
"24738","1900-1959",2021-12-03,58,5,59,117
"24739","1900-1959",2021-12-04,49,6,52,101
"24740","1900-1959",2021-12-05,64,7,57,121
"24741","1900-1959",2021-12-06,62,1,57,119
"24742","1900-1959",2021-12-07,46,2,56,102
"24743","1900-1959",2021-12-08,48,3,52,100
"24744","1900-1959",2021-12-09,61,4,58,119
"24745","1900-1959",2021-12-10,60,5,59,119
"24746","1900-1959",2021-12-11,46,6,55,101
"24747","1900-1959",2021-12-12,64,7,56,120
"24748","1900-1959",2021-12-13,62,1,57,119
"24749","1900-1959",2021-12-14,46,2,56,102
"24750","1900-1959",2021-12-15,51,3,52,103
"24751","1900-1959",2021-12-16,66,4,63,129
"24752","1900-1959",2021-12-17,67,5,62,129
"24753","1900-1959",2021-12-18,57,6,56,113
"24754","1900-1959",2021-12-19,57,7,64,121
"24755","1900-1959",2021-12-20,60,1,64,124
"24756","1900-1959",2021-12-21,59,2,63,122
"24757","1900-1959",2021-12-22,58,3,67,125
"24758","1900-1959",2021-12-23,66,4,66,132
"24759","1900-1959",2021-12-24,34,5,48,82
"24760","1900-1959",2021-12-25,44,6,53,97
"24761","1900-1959",2021-12-26,66,7,65,131
"24762","1900-1959",2021-12-27,65,1,62,127
"24763","1900-1959",2021-12-28,62,2,62,124
"24764","1900-1959",2021-12-29,60,3,64,124
"24765","1900-1959",2021-12-30,65,4,62,127
"24766","1900-1959",2021-12-31,34,5,50,84
"24767","2000-2059",2021-12-01,40,3,66,106
"24768","2000-2059",2021-12-02,45,4,69,114
"24769","2000-2059",2021-12-03,44,5,68,112
"24770","2000-2059",2021-12-04,27,6,59,86
"24771","2000-2059",2021-12-05,44,7,75,119
"24772","2000-2059",2021-12-06,41,1,68,109
"24773","2000-2059",2021-12-07,35,2,56,91
"24774","2000-2059",2021-12-08,39,3,62,101
"24775","2000-2059",2021-12-09,44,4,69,113
"24776","2000-2059",2021-12-10,43,5,68,111
"24777","2000-2059",2021-12-11,27,6,54,81
"24778","2000-2059",2021-12-12,44,7,75,119
"24779","2000-2059",2021-12-13,41,1,67,108
"24780","2000-2059",2021-12-14,35,2,57,92
"24781","2000-2059",2021-12-15,40,3,62,102
"24782","2000-2059",2021-12-16,55,4,78,133
"24783","2000-2059",2021-12-17,54,5,77,131
"24784","2000-2059",2021-12-18,47,6,72,119
"24785","2000-2059",2021-12-19,51,7,76,127
"24786","2000-2059",2021-12-20,53,1,78,131
"24787","2000-2059",2021-12-21,51,2,74,125
"24788","2000-2059",2021-12-22,54,3,73,127
"24789","2000-2059",2021-12-23,54,4,77,131
"24790","2000-2059",2021-12-24,35,5,60,95
"24791","2000-2059",2021-12-25,35,6,64,99
"24792","2000-2059",2021-12-26,50,7,76,126
"24793","2000-2059",2021-12-27,52,1,79,131
"24794","2000-2059",2021-12-28,51,2,77,128
"24795","2000-2059",2021-12-29,55,3,76,131
"24796","2000-2059",2021-12-30,54,4,78,132
"24797","2000-2059",2021-12-31,36,5,60,96
"24798","2100-2159",2021-12-01,32,3,67,99
"24799","2100-2159",2021-12-02,42,4,74,116
"24800","2100-2159",2021-12-03,39,5,74,113
"24801","2100-2159",2021-12-04,29,6,63,92
"24802","2100-2159",2021-12-05,51,7,75,126
"24803","2100-2159",2021-12-06,37,1,75,112
"24804","2100-2159",2021-12-07,26,2,65,91
"24805","2100-2159",2021-12-08,27,3,67,94
"24806","2100-2159",2021-12-09,38,4,76,114
"24807","2100-2159",2021-12-10,36,5,73,109
"24808","2100-2159",2021-12-11,26,6,62,88
"24809","2100-2159",2021-12-12,49,7,75,124
"24810","2100-2159",2021-12-13,38,1,75,113
"24811","2100-2159",2021-12-14,26,2,65,91
"24812","2100-2159",2021-12-15,28,3,68,96
"24813","2100-2159",2021-12-16,44,4,71,115
"24814","2100-2159",2021-12-17,47,5,71,118
"24815","2100-2159",2021-12-18,46,6,75,121
"24816","2100-2159",2021-12-19,53,7,68,121
"24817","2100-2159",2021-12-20,48,1,70,118
"24818","2100-2159",2021-12-21,48,2,72,120
"24819","2100-2159",2021-12-22,47,3,73,120
"24820","2100-2159",2021-12-23,56,4,76,132
"24821","2100-2159",2021-12-24,30,5,52,82
"24822","2100-2159",2021-12-25,40,6,59,99
"24823","2100-2159",2021-12-26,53,7,75,128
"24824","2100-2159",2021-12-27,53,1,74,127
"24825","2100-2159",2021-12-28,53,2,71,124
"24826","2100-2159",2021-12-29,52,3,74,126
"24827","2100-2159",2021-12-30,54,4,74,128
"24828","2100-2159",2021-12-31,30,5,53,83
"24829","2200-2259",2021-12-01,37,3,57,94
"24830","2200-2259",2021-12-02,39,4,63,102
"24831","2200-2259",2021-12-03,40,5,64,104
"24832","2200-2259",2021-12-04,28,6,50,78
"24833","2200-2259",2021-12-05,38,7,69,107
"24834","2200-2259",2021-12-06,32,1,59,91
"24835","2200-2259",2021-12-07,25,2,51,76
"24836","2200-2259",2021-12-08,32,3,55,87
"24837","2200-2259",2021-12-09,38,4,61,99
"24838","2200-2259",2021-12-10,38,5,62,100
"24839","2200-2259",2021-12-11,26,6,47,73
"24840","2200-2259",2021-12-12,38,7,68,106
"24841","2200-2259",2021-12-13,33,1,59,92
"24842","2200-2259",2021-12-14,24,2,51,75
"24843","2200-2259",2021-12-15,29,3,59,88
"24844","2200-2259",2021-12-16,38,4,77,115
"24845","2200-2259",2021-12-17,37,5,79,116
"24846","2200-2259",2021-12-18,36,6,60,96
"24847","2200-2259",2021-12-19,35,7,79,114
"24848","2200-2259",2021-12-20,37,1,74,111
"24849","2200-2259",2021-12-21,38,2,69,107
"24850","2200-2259",2021-12-22,39,3,71,110
"24851","2200-2259",2021-12-23,38,4,74,112
"24852","2200-2259",2021-12-24,23,5,47,70
"24853","2200-2259",2021-12-25,27,6,62,89
"24854","2200-2259",2021-12-26,37,7,74,111
"24855","2200-2259",2021-12-27,40,1,75,115
"24856","2200-2259",2021-12-28,38,2,74,112
"24857","2200-2259",2021-12-29,39,3,75,114
"24858","2200-2259",2021-12-30,37,4,77,114
"24859","2200-2259",2021-12-31,25,5,48,73
"24860","2300-2359",2021-12-01,25,3,60,85
"24861","2300-2359",2021-12-02,28,4,68,96
"24862","2300-2359",2021-12-03,29,5,66,95
"24863","2300-2359",2021-12-04,27,6,43,70
"24864","2300-2359",2021-12-05,30,7,73,103
"24865","2300-2359",2021-12-06,30,1,65,95
"24866","2300-2359",2021-12-07,25,2,51,76
"24867","2300-2359",2021-12-08,26,3,54,80
"24868","2300-2359",2021-12-09,29,4,67,96
"24869","2300-2359",2021-12-10,31,5,65,96
"24870","2300-2359",2021-12-11,28,6,41,69
"24871","2300-2359",2021-12-12,30,7,72,102
"24872","2300-2359",2021-12-13,30,1,65,95
"24873","2300-2359",2021-12-14,25,2,51,76
"24874","2300-2359",2021-12-15,25,3,51,76
"24875","2300-2359",2021-12-16,36,4,69,105
"24876","2300-2359",2021-12-17,37,5,68,105
"24877","2300-2359",2021-12-18,35,6,63,98
"24878","2300-2359",2021-12-19,34,7,65,99
"24879","2300-2359",2021-12-20,33,1,69,102
"24880","2300-2359",2021-12-21,33,2,65,98
"24881","2300-2359",2021-12-22,35,3,65,100
"24882","2300-2359",2021-12-23,33,4,64,97
"24883","2300-2359",2021-12-24,21,5,36,57
"24884","2300-2359",2021-12-25,33,6,45,78
"24885","2300-2359",2021-12-26,35,7,59,94
"24886","2300-2359",2021-12-27,33,1,62,95
"24887","2300-2359",2021-12-28,32,2,59,91
"24888","2300-2359",2021-12-29,34,3,59,93
"24889","2300-2359",2021-12-30,33,4,61,94
"24890","2300-2359",2021-12-31,22,5,38,60
"24891","0001-0559",2022-01-01,17,6,56,73
"24892","0001-0559",2022-01-02,20,7,75,95
"24893","0001-0559",2022-01-03,19,1,74,93
"24894","0001-0559",2022-01-04,15,2,52,67
"24895","0001-0559",2022-01-05,12,3,45,57
"24896","0001-0559",2022-01-06,15,4,50,65
"24897","0001-0559",2022-01-07,16,5,51,67
"24898","0001-0559",2022-01-08,15,6,31,46
"24899","0001-0559",2022-01-09,15,7,49,64
"24900","0001-0559",2022-01-10,16,1,48,64
"24901","0001-0559",2022-01-11,13,2,39,52
"24902","0001-0559",2022-01-12,12,3,44,56
"24903","0001-0559",2022-01-13,15,4,51,66
"24904","0001-0559",2022-01-14,23,5,52,75
"24905","0001-0559",2022-01-15,15,6,30,45
"24906","0001-0559",2022-01-16,14,7,45,59
"24907","0001-0559",2022-01-17,20,1,50,70
"24908","0001-0559",2022-01-18,16,2,42,58
"24909","0001-0559",2022-01-19,14,3,47,61
"24910","0001-0559",2022-01-20,19,4,52,71
"24911","0001-0559",2022-01-21,20,5,54,74
"24912","0001-0559",2022-01-22,14,6,30,44
"24913","0001-0559",2022-01-23,15,7,50,65
"24914","0001-0559",2022-01-24,20,1,49,69
"24915","0001-0559",2022-01-25,15,2,40,55
"24916","0001-0559",2022-01-26,14,3,46,60
"24917","0001-0559",2022-01-27,19,4,52,71
"24918","0001-0559",2022-01-28,20,5,54,74
"24919","0001-0559",2022-01-29,14,6,30,44
"24920","0001-0559",2022-01-30,15,7,50,65
"24921","0001-0559",2022-01-31,20,1,49,69
"24922","0600-0659",2022-01-01,68,6,32,100
"24923","0600-0659",2022-01-02,91,7,32,123
"24924","0600-0659",2022-01-03,94,1,34,128
"24925","0600-0659",2022-01-04,79,2,29,108
"24926","0600-0659",2022-01-05,69,3,23,92
"24927","0600-0659",2022-01-06,73,4,29,102
"24928","0600-0659",2022-01-07,76,5,30,106
"24929","0600-0659",2022-01-08,71,6,23,94
"24930","0600-0659",2022-01-09,71,7,26,97
"24931","0600-0659",2022-01-10,75,1,29,104
"24932","0600-0659",2022-01-11,70,2,21,91
"24933","0600-0659",2022-01-12,69,3,21,90
"24934","0600-0659",2022-01-13,73,4,29,102
"24935","0600-0659",2022-01-14,74,5,30,104
"24936","0600-0659",2022-01-15,71,6,23,94
"24937","0600-0659",2022-01-16,68,7,24,92
"24938","0600-0659",2022-01-17,72,1,28,100
"24939","0600-0659",2022-01-18,66,2,20,86
"24940","0600-0659",2022-01-19,65,3,21,86
"24941","0600-0659",2022-01-20,75,4,28,103
"24942","0600-0659",2022-01-21,78,5,29,107
"24943","0600-0659",2022-01-22,71,6,24,95
"24944","0600-0659",2022-01-23,75,7,26,101
"24945","0600-0659",2022-01-24,76,1,28,104
"24946","0600-0659",2022-01-25,66,2,20,86
"24947","0600-0659",2022-01-26,65,3,21,86
"24948","0600-0659",2022-01-27,75,4,28,103
"24949","0600-0659",2022-01-28,77,5,29,106
"24950","0600-0659",2022-01-29,71,6,24,95
"24951","0600-0659",2022-01-30,75,7,26,101
"24952","0600-0659",2022-01-31,76,1,28,104
"24953","0700-0759",2022-01-01,58,6,39,97
"24954","0700-0759",2022-01-02,73,7,53,126
"24955","0700-0759",2022-01-03,73,1,53,126
"24956","0700-0759",2022-01-04,75,2,42,117
"24957","0700-0759",2022-01-05,70,3,36,106
"24958","0700-0759",2022-01-06,77,4,38,115
"24959","0700-0759",2022-01-07,79,5,39,118
"24960","0700-0759",2022-01-08,75,6,38,113
"24961","0700-0759",2022-01-09,73,7,34,107
"24962","0700-0759",2022-01-10,76,1,38,114
"24963","0700-0759",2022-01-11,72,2,38,110
"24964","0700-0759",2022-01-12,71,3,39,110
"24965","0700-0759",2022-01-13,74,4,37,111
"24966","0700-0759",2022-01-14,78,5,39,117
"24967","0700-0759",2022-01-15,75,6,38,113
"24968","0700-0759",2022-01-16,69,7,31,100
"24969","0700-0759",2022-01-17,80,1,36,116
"24970","0700-0759",2022-01-18,74,2,34,108
"24971","0700-0759",2022-01-19,73,3,35,108
"24972","0700-0759",2022-01-20,80,4,40,120
"24973","0700-0759",2022-01-21,81,5,40,121
"24974","0700-0759",2022-01-22,79,6,39,118
"24975","0700-0759",2022-01-23,74,7,38,112
"24976","0700-0759",2022-01-24,79,1,39,118
"24977","0700-0759",2022-01-25,77,2,34,111
"24978","0700-0759",2022-01-26,74,3,35,109
"24979","0700-0759",2022-01-27,81,4,40,121
"24980","0700-0759",2022-01-28,81,5,39,120
"24981","0700-0759",2022-01-29,79,6,39,118
"24982","0700-0759",2022-01-30,75,7,37,112
"24983","0700-0759",2022-01-31,79,1,38,117
"24984","0800-0859",2022-01-01,77,6,36,113
"24985","0800-0859",2022-01-02,95,7,46,141
"24986","0800-0859",2022-01-03,99,1,49,148
"24987","0800-0859",2022-01-04,83,2,35,118
"24988","0800-0859",2022-01-05,84,3,35,119
"24989","0800-0859",2022-01-06,87,4,38,125
"24990","0800-0859",2022-01-07,88,5,42,130
"24991","0800-0859",2022-01-08,76,6,43,119
"24992","0800-0859",2022-01-09,81,7,40,121
"24993","0800-0859",2022-01-10,87,1,42,129
"24994","0800-0859",2022-01-11,86,2,36,122
"24995","0800-0859",2022-01-12,86,3,33,119
"24996","0800-0859",2022-01-13,86,4,37,123
"24997","0800-0859",2022-01-14,90,5,44,134
"24998","0800-0859",2022-01-15,77,6,43,120
"24999","0800-0859",2022-01-16,82,7,39,121
"25000","0800-0859",2022-01-17,80,1,44,124
"25001","0800-0859",2022-01-18,78,2,38,116
"25002","0800-0859",2022-01-19,77,3,35,112
"25003","0800-0859",2022-01-20,85,4,41,126
"25004","0800-0859",2022-01-21,85,5,45,130
"25005","0800-0859",2022-01-22,75,6,41,116
"25006","0800-0859",2022-01-23,84,7,41,125
"25007","0800-0859",2022-01-24,84,1,43,127
"25008","0800-0859",2022-01-25,79,2,37,116
"25009","0800-0859",2022-01-26,77,3,35,112
"25010","0800-0859",2022-01-27,84,4,41,125
"25011","0800-0859",2022-01-28,84,5,45,129
"25012","0800-0859",2022-01-29,74,6,41,115
"25013","0800-0859",2022-01-30,84,7,41,125
"25014","0800-0859",2022-01-31,84,1,43,127
"25015","0900-0959",2022-01-01,52,6,33,85
"25016","0900-0959",2022-01-02,59,7,52,111
"25017","0900-0959",2022-01-03,61,1,51,112
"25018","0900-0959",2022-01-04,61,2,58,119
"25019","0900-0959",2022-01-05,66,3,55,121
"25020","0900-0959",2022-01-06,71,4,57,128
"25021","0900-0959",2022-01-07,69,5,57,126
"25022","0900-0959",2022-01-08,64,6,45,109
"25023","0900-0959",2022-01-09,71,7,50,121
"25024","0900-0959",2022-01-10,71,1,56,127
"25025","0900-0959",2022-01-11,64,2,55,119
"25026","0900-0959",2022-01-12,61,3,53,114
"25027","0900-0959",2022-01-13,67,4,53,120
"25028","0900-0959",2022-01-14,69,5,53,122
"25029","0900-0959",2022-01-15,61,6,43,104
"25030","0900-0959",2022-01-16,67,7,46,113
"25031","0900-0959",2022-01-17,71,1,51,122
"25032","0900-0959",2022-01-18,61,2,47,108
"25033","0900-0959",2022-01-19,62,3,46,108
"25034","0900-0959",2022-01-20,69,4,54,123
"25035","0900-0959",2022-01-21,65,5,55,120
"25036","0900-0959",2022-01-22,59,6,49,108
"25037","0900-0959",2022-01-23,66,7,49,115
"25038","0900-0959",2022-01-24,68,1,55,123
"25039","0900-0959",2022-01-25,63,2,50,113
"25040","0900-0959",2022-01-26,62,3,48,110
"25041","0900-0959",2022-01-27,69,4,55,124
"25042","0900-0959",2022-01-28,67,5,56,123
"25043","0900-0959",2022-01-29,60,6,49,109
"25044","0900-0959",2022-01-30,66,7,50,116
"25045","0900-0959",2022-01-31,69,1,56,125
"25046","1000-1059",2022-01-01,54,6,42,96
"25047","1000-1059",2022-01-02,68,7,49,117
"25048","1000-1059",2022-01-03,65,1,46,111
"25049","1000-1059",2022-01-04,57,2,33,90
"25050","1000-1059",2022-01-05,57,3,31,88
"25051","1000-1059",2022-01-06,61,4,33,94
"25052","1000-1059",2022-01-07,61,5,34,95
"25053","1000-1059",2022-01-08,57,6,34,91
"25054","1000-1059",2022-01-09,63,7,37,100
"25055","1000-1059",2022-01-10,58,1,33,91
"25056","1000-1059",2022-01-11,57,2,30,87
"25057","1000-1059",2022-01-12,56,3,31,87
"25058","1000-1059",2022-01-13,59,4,32,91
"25059","1000-1059",2022-01-14,64,5,42,106
"25060","1000-1059",2022-01-15,51,6,34,85
"25061","1000-1059",2022-01-16,59,7,34,93
"25062","1000-1059",2022-01-17,61,1,40,101
"25063","1000-1059",2022-01-18,60,2,32,92
"25064","1000-1059",2022-01-19,55,3,33,88
"25065","1000-1059",2022-01-20,65,4,41,106
"25066","1000-1059",2022-01-21,66,5,42,108
"25067","1000-1059",2022-01-22,56,6,32,88
"25068","1000-1059",2022-01-23,65,7,43,108
"25069","1000-1059",2022-01-24,65,1,40,105
"25070","1000-1059",2022-01-25,60,2,33,93
"25071","1000-1059",2022-01-26,56,3,33,89
"25072","1000-1059",2022-01-27,66,4,41,107
"25073","1000-1059",2022-01-28,66,5,41,107
"25074","1000-1059",2022-01-29,57,6,32,89
"25075","1000-1059",2022-01-30,67,7,43,110
"25076","1000-1059",2022-01-31,66,1,42,108
"25077","1100-1159",2022-01-01,46,6,60,106
"25078","1100-1159",2022-01-02,50,7,56,106
"25079","1100-1159",2022-01-03,51,1,62,113
"25080","1100-1159",2022-01-04,45,2,64,109
"25081","1100-1159",2022-01-05,45,3,62,107
"25082","1100-1159",2022-01-06,47,4,71,118
"25083","1100-1159",2022-01-07,48,5,68,116
"25084","1100-1159",2022-01-08,43,6,64,107
"25085","1100-1159",2022-01-09,46,7,64,110
"25086","1100-1159",2022-01-10,47,1,66,113
"25087","1100-1159",2022-01-11,44,2,63,107
"25088","1100-1159",2022-01-12,44,3,62,106
"25089","1100-1159",2022-01-13,44,4,69,113
"25090","1100-1159",2022-01-14,48,5,71,119
"25091","1100-1159",2022-01-15,42,6,62,104
"25092","1100-1159",2022-01-16,43,7,68,111
"25093","1100-1159",2022-01-17,51,1,67,118
"25094","1100-1159",2022-01-18,49,2,65,114
"25095","1100-1159",2022-01-19,50,3,63,113
"25096","1100-1159",2022-01-20,51,4,71,122
"25097","1100-1159",2022-01-21,51,5,67,118
"25098","1100-1159",2022-01-22,41,6,66,107
"25099","1100-1159",2022-01-23,51,7,69,120
"25100","1100-1159",2022-01-24,51,1,68,119
"25101","1100-1159",2022-01-25,49,2,66,115
"25102","1100-1159",2022-01-26,49,3,63,112
"25103","1100-1159",2022-01-27,51,4,72,123
"25104","1100-1159",2022-01-28,50,5,67,117
"25105","1100-1159",2022-01-29,41,6,66,107
"25106","1100-1159",2022-01-30,51,7,70,121
"25107","1100-1159",2022-01-31,52,1,66,118
"25108","1200-1259",2022-01-01,60,6,53,113
"25109","1200-1259",2022-01-02,63,7,70,133
"25110","1200-1259",2022-01-03,60,1,66,126
"25111","1200-1259",2022-01-04,62,2,56,118
"25112","1200-1259",2022-01-05,56,3,55,111
"25113","1200-1259",2022-01-06,58,4,59,117
"25114","1200-1259",2022-01-07,62,5,57,119
"25115","1200-1259",2022-01-08,51,6,58,109
"25116","1200-1259",2022-01-09,57,7,62,119
"25117","1200-1259",2022-01-10,59,1,58,117
"25118","1200-1259",2022-01-11,55,2,57,112
"25119","1200-1259",2022-01-12,54,3,54,108
"25120","1200-1259",2022-01-13,57,4,57,114
"25121","1200-1259",2022-01-14,58,5,57,115
"25122","1200-1259",2022-01-15,51,6,57,108
"25123","1200-1259",2022-01-16,58,7,57,115
"25124","1200-1259",2022-01-17,58,1,63,121
"25125","1200-1259",2022-01-18,56,2,60,116
"25126","1200-1259",2022-01-19,55,3,59,114
"25127","1200-1259",2022-01-20,58,4,63,121
"25128","1200-1259",2022-01-21,60,5,60,120
"25129","1200-1259",2022-01-22,50,6,54,104
"25130","1200-1259",2022-01-23,59,7,60,119
"25131","1200-1259",2022-01-24,58,1,63,121
"25132","1200-1259",2022-01-25,57,2,61,118
"25133","1200-1259",2022-01-26,54,3,58,112
"25134","1200-1259",2022-01-27,58,4,64,122
"25135","1200-1259",2022-01-28,59,5,61,120
"25136","1200-1259",2022-01-29,50,6,55,105
"25137","1200-1259",2022-01-30,60,7,61,121
"25138","1200-1259",2022-01-31,58,1,65,123
"25139","1300-1359",2022-01-01,59,6,45,104
"25140","1300-1359",2022-01-02,61,7,53,114
"25141","1300-1359",2022-01-03,63,1,54,117
"25142","1300-1359",2022-01-04,70,2,59,129
"25143","1300-1359",2022-01-05,68,3,64,132
"25144","1300-1359",2022-01-06,71,4,65,136
"25145","1300-1359",2022-01-07,70,5,68,138
"25146","1300-1359",2022-01-08,64,6,53,117
"25147","1300-1359",2022-01-09,61,7,61,122
"25148","1300-1359",2022-01-10,73,1,67,140
"25149","1300-1359",2022-01-11,70,2,63,133
"25150","1300-1359",2022-01-12,68,3,62,130
"25151","1300-1359",2022-01-13,70,4,63,133
"25152","1300-1359",2022-01-14,68,5,59,127
"25153","1300-1359",2022-01-15,63,6,50,113
"25154","1300-1359",2022-01-16,63,7,55,118
"25155","1300-1359",2022-01-17,69,1,61,130
"25156","1300-1359",2022-01-18,66,2,59,125
"25157","1300-1359",2022-01-19,65,3,57,122
"25158","1300-1359",2022-01-20,66,4,60,126
"25159","1300-1359",2022-01-21,64,5,60,124
"25160","1300-1359",2022-01-22,63,6,52,115
"25161","1300-1359",2022-01-23,65,7,59,124
"25162","1300-1359",2022-01-24,68,1,61,129
"25163","1300-1359",2022-01-25,67,2,60,127
"25164","1300-1359",2022-01-26,65,3,58,123
"25165","1300-1359",2022-01-27,66,4,58,124
"25166","1300-1359",2022-01-28,65,5,58,123
"25167","1300-1359",2022-01-29,62,6,51,113
"25168","1300-1359",2022-01-30,65,7,59,124
"25169","1300-1359",2022-01-31,68,1,61,129
"25170","1400-1459",2022-01-01,42,6,61,103
"25171","1400-1459",2022-01-02,52,7,66,118
"25172","1400-1459",2022-01-03,49,1,70,119
"25173","1400-1459",2022-01-04,49,2,58,107
"25174","1400-1459",2022-01-05,53,3,54,107
"25175","1400-1459",2022-01-06,54,4,55,109
"25176","1400-1459",2022-01-07,53,5,58,111
"25177","1400-1459",2022-01-08,49,6,53,102
"25178","1400-1459",2022-01-09,56,7,56,112
"25179","1400-1459",2022-01-10,55,1,58,113
"25180","1400-1459",2022-01-11,50,2,53,103
"25181","1400-1459",2022-01-12,51,3,53,104
"25182","1400-1459",2022-01-13,51,4,54,105
"25183","1400-1459",2022-01-14,53,5,60,113
"25184","1400-1459",2022-01-15,45,6,53,98
"25185","1400-1459",2022-01-16,49,7,57,106
"25186","1400-1459",2022-01-17,59,1,60,119
"25187","1400-1459",2022-01-18,52,2,56,108
"25188","1400-1459",2022-01-19,54,3,56,110
"25189","1400-1459",2022-01-20,57,4,55,112
"25190","1400-1459",2022-01-21,58,5,57,115
"25191","1400-1459",2022-01-22,45,6,51,96
"25192","1400-1459",2022-01-23,57,7,56,113
"25193","1400-1459",2022-01-24,56,1,58,114
"25194","1400-1459",2022-01-25,52,2,56,108
"25195","1400-1459",2022-01-26,56,3,53,109
"25196","1400-1459",2022-01-27,57,4,56,113
"25197","1400-1459",2022-01-28,58,5,57,115
"25198","1400-1459",2022-01-29,46,6,52,98
"25199","1400-1459",2022-01-30,57,7,57,114
"25200","1400-1459",2022-01-31,59,1,58,117
"25201","1500-1559",2022-01-01,62,6,54,116
"25202","1500-1559",2022-01-02,68,7,66,134
"25203","1500-1559",2022-01-03,71,1,64,135
"25204","1500-1559",2022-01-04,59,2,55,114
"25205","1500-1559",2022-01-05,53,3,45,98
"25206","1500-1559",2022-01-06,58,4,50,108
"25207","1500-1559",2022-01-07,59,5,51,110
"25208","1500-1559",2022-01-08,50,6,48,98
"25209","1500-1559",2022-01-09,55,7,51,106
"25210","1500-1559",2022-01-10,55,1,50,105
"25211","1500-1559",2022-01-11,54,2,47,101
"25212","1500-1559",2022-01-12,53,3,44,97
"25213","1500-1559",2022-01-13,57,4,47,104
"25214","1500-1559",2022-01-14,62,5,53,115
"25215","1500-1559",2022-01-15,51,6,49,100
"25216","1500-1559",2022-01-16,57,7,51,108
"25217","1500-1559",2022-01-17,55,1,49,104
"25218","1500-1559",2022-01-18,53,2,45,98
"25219","1500-1559",2022-01-19,52,3,44,96
"25220","1500-1559",2022-01-20,56,4,51,107
"25221","1500-1559",2022-01-21,59,5,52,111
"25222","1500-1559",2022-01-22,50,6,49,99
"25223","1500-1559",2022-01-23,58,7,51,109
"25224","1500-1559",2022-01-24,55,1,50,105
"25225","1500-1559",2022-01-25,53,2,48,101
"25226","1500-1559",2022-01-26,52,3,46,98
"25227","1500-1559",2022-01-27,57,4,50,107
"25228","1500-1559",2022-01-28,58,5,53,111
"25229","1500-1559",2022-01-29,50,6,48,98
"25230","1500-1559",2022-01-30,58,7,52,110
"25231","1500-1559",2022-01-31,55,1,52,107
"25232","1600-1659",2022-01-01,59,6,47,106
"25233","1600-1659",2022-01-02,69,7,55,124
"25234","1600-1659",2022-01-03,70,1,59,129
"25235","1600-1659",2022-01-04,56,2,65,121
"25236","1600-1659",2022-01-05,57,3,69,126
"25237","1600-1659",2022-01-06,62,4,69,131
"25238","1600-1659",2022-01-07,61,5,68,129
"25239","1600-1659",2022-01-08,53,6,61,114
"25240","1600-1659",2022-01-09,67,7,62,129
"25241","1600-1659",2022-01-10,60,1,69,129
"25242","1600-1659",2022-01-11,57,2,66,123
"25243","1600-1659",2022-01-12,57,3,68,125
"25244","1600-1659",2022-01-13,60,4,70,130
"25245","1600-1659",2022-01-14,62,5,64,126
"25246","1600-1659",2022-01-15,50,6,59,109
"25247","1600-1659",2022-01-16,57,7,60,117
"25248","1600-1659",2022-01-17,55,1,63,118
"25249","1600-1659",2022-01-18,51,2,61,112
"25250","1600-1659",2022-01-19,52,3,62,114
"25251","1600-1659",2022-01-20,60,4,64,124
"25252","1600-1659",2022-01-21,59,5,66,125
"25253","1600-1659",2022-01-22,48,6,54,102
"25254","1600-1659",2022-01-23,60,7,65,125
"25255","1600-1659",2022-01-24,56,1,63,119
"25256","1600-1659",2022-01-25,51,2,60,111
"25257","1600-1659",2022-01-26,52,3,64,116
"25258","1600-1659",2022-01-27,61,4,65,126
"25259","1600-1659",2022-01-28,59,5,65,124
"25260","1600-1659",2022-01-29,48,6,55,103
"25261","1600-1659",2022-01-30,60,7,64,124
"25262","1600-1659",2022-01-31,57,1,64,121
"25263","1700-1759",2022-01-01,52,6,52,104
"25264","1700-1759",2022-01-02,59,7,57,116
"25265","1700-1759",2022-01-03,60,1,59,119
"25266","1700-1759",2022-01-04,64,2,56,120
"25267","1700-1759",2022-01-05,54,3,55,109
"25268","1700-1759",2022-01-06,59,4,59,118
"25269","1700-1759",2022-01-07,57,5,61,118
"25270","1700-1759",2022-01-08,53,6,49,102
"25271","1700-1759",2022-01-09,62,7,60,122
"25272","1700-1759",2022-01-10,64,1,60,124
"25273","1700-1759",2022-01-11,56,2,58,114
"25274","1700-1759",2022-01-12,55,3,53,108
"25275","1700-1759",2022-01-13,64,4,58,122
"25276","1700-1759",2022-01-14,64,5,63,127
"25277","1700-1759",2022-01-15,51,6,47,98
"25278","1700-1759",2022-01-16,59,7,53,112
"25279","1700-1759",2022-01-17,62,1,63,125
"25280","1700-1759",2022-01-18,54,2,58,112
"25281","1700-1759",2022-01-19,54,3,55,109
"25282","1700-1759",2022-01-20,64,4,62,126
"25283","1700-1759",2022-01-21,63,5,65,128
"25284","1700-1759",2022-01-22,53,6,49,102
"25285","1700-1759",2022-01-23,63,7,60,123
"25286","1700-1759",2022-01-24,62,1,62,124
"25287","1700-1759",2022-01-25,53,2,58,111
"25288","1700-1759",2022-01-26,55,3,57,112
"25289","1700-1759",2022-01-27,64,4,62,126
"25290","1700-1759",2022-01-28,62,5,65,127
"25291","1700-1759",2022-01-29,50,6,49,99
"25292","1700-1759",2022-01-30,64,7,60,124
"25293","1700-1759",2022-01-31,63,1,64,127
"25294","1800-1859",2022-01-01,54,6,51,105
"25295","1800-1859",2022-01-02,68,7,58,126
"25296","1800-1859",2022-01-03,67,1,57,124
"25297","1800-1859",2022-01-04,61,2,59,120
"25298","1800-1859",2022-01-05,56,3,60,116
"25299","1800-1859",2022-01-06,63,4,62,125
"25300","1800-1859",2022-01-07,62,5,63,125
"25301","1800-1859",2022-01-08,45,6,51,96
"25302","1800-1859",2022-01-09,65,7,62,127
"25303","1800-1859",2022-01-10,62,1,65,127
"25304","1800-1859",2022-01-11,53,2,57,110
"25305","1800-1859",2022-01-12,54,3,61,115
"25306","1800-1859",2022-01-13,59,4,63,122
"25307","1800-1859",2022-01-14,63,5,70,133
"25308","1800-1859",2022-01-15,43,6,47,90
"25309","1800-1859",2022-01-16,54,7,60,114
"25310","1800-1859",2022-01-17,64,1,65,129
"25311","1800-1859",2022-01-18,53,2,59,112
"25312","1800-1859",2022-01-19,55,3,61,116
"25313","1800-1859",2022-01-20,64,4,66,130
"25314","1800-1859",2022-01-21,64,5,67,131
"25315","1800-1859",2022-01-22,46,6,51,97
"25316","1800-1859",2022-01-23,63,7,66,129
"25317","1800-1859",2022-01-24,64,1,67,131
"25318","1800-1859",2022-01-25,53,2,59,112
"25319","1800-1859",2022-01-26,56,3,60,116
"25320","1800-1859",2022-01-27,64,4,66,130
"25321","1800-1859",2022-01-28,64,5,66,130
"25322","1800-1859",2022-01-29,46,6,49,95
"25323","1800-1859",2022-01-30,64,7,66,130
"25324","1800-1859",2022-01-31,64,1,67,131
"25325","1900-1959",2022-01-01,47,6,51,98
"25326","1900-1959",2022-01-02,66,7,68,134
"25327","1900-1959",2022-01-03,66,1,66,132
"25328","1900-1959",2022-01-04,61,2,51,112
"25329","1900-1959",2022-01-05,49,3,39,88
"25330","1900-1959",2022-01-06,54,4,47,101
"25331","1900-1959",2022-01-07,55,5,45,100
"25332","1900-1959",2022-01-08,47,6,43,90
"25333","1900-1959",2022-01-09,59,7,48,107
"25334","1900-1959",2022-01-10,58,1,44,102
"25335","1900-1959",2022-01-11,51,2,38,89
"25336","1900-1959",2022-01-12,50,3,38,88
"25337","1900-1959",2022-01-13,54,4,46,100
"25338","1900-1959",2022-01-14,60,5,45,105
"25339","1900-1959",2022-01-15,42,6,37,79
"25340","1900-1959",2022-01-16,51,7,45,96
"25341","1900-1959",2022-01-17,60,1,47,107
"25342","1900-1959",2022-01-18,56,2,38,94
"25343","1900-1959",2022-01-19,55,3,39,94
"25344","1900-1959",2022-01-20,61,4,49,110
"25345","1900-1959",2022-01-21,60,5,47,107
"25346","1900-1959",2022-01-22,43,6,39,82
"25347","1900-1959",2022-01-23,61,7,50,111
"25348","1900-1959",2022-01-24,63,1,46,109
"25349","1900-1959",2022-01-25,55,2,37,92
"25350","1900-1959",2022-01-26,55,3,39,94
"25351","1900-1959",2022-01-27,60,4,50,110
"25352","1900-1959",2022-01-28,60,5,47,107
"25353","1900-1959",2022-01-29,43,6,38,81
"25354","1900-1959",2022-01-30,62,7,51,113
"25355","1900-1959",2022-01-31,63,1,46,109
"25356","2000-2059",2022-01-01,42,6,70,112
"25357","2000-2059",2022-01-02,50,7,76,126
"25358","2000-2059",2022-01-03,50,1,76,126
"25359","2000-2059",2022-01-04,40,2,75,115
"25360","2000-2059",2022-01-05,33,3,74,107
"25361","2000-2059",2022-01-06,43,4,76,119
"25362","2000-2059",2022-01-07,43,5,73,116
"25363","2000-2059",2022-01-08,24,6,71,95
"25364","2000-2059",2022-01-09,41,7,79,120
"25365","2000-2059",2022-01-10,39,1,77,116
"25366","2000-2059",2022-01-11,29,2,76,105
"25367","2000-2059",2022-01-12,32,3,74,106
"25368","2000-2059",2022-01-13,43,4,75,118
"25369","2000-2059",2022-01-14,46,5,80,126
"25370","2000-2059",2022-01-15,25,6,72,97
"25371","2000-2059",2022-01-16,37,7,78,115
"25372","2000-2059",2022-01-17,45,1,78,123
"25373","2000-2059",2022-01-18,32,2,78,110
"25374","2000-2059",2022-01-19,32,3,80,112
"25375","2000-2059",2022-01-20,48,4,82,130
"25376","2000-2059",2022-01-21,50,5,79,129
"25377","2000-2059",2022-01-22,29,6,73,102
"25378","2000-2059",2022-01-23,47,7,80,127
"25379","2000-2059",2022-01-24,44,1,79,123
"25380","2000-2059",2022-01-25,32,2,78,110
"25381","2000-2059",2022-01-26,34,3,80,114
"25382","2000-2059",2022-01-27,49,4,82,131
"25383","2000-2059",2022-01-28,50,5,79,129
"25384","2000-2059",2022-01-29,29,6,73,102
"25385","2000-2059",2022-01-30,47,7,81,128
"25386","2000-2059",2022-01-31,45,1,79,124
"25387","2100-2159",2022-01-01,43,6,64,107
"25388","2100-2159",2022-01-02,54,7,76,130
"25389","2100-2159",2022-01-03,54,1,73,127
"25390","2100-2159",2022-01-04,33,2,68,101
"25391","2100-2159",2022-01-05,26,3,59,85
"25392","2100-2159",2022-01-06,27,4,68,95
"25393","2100-2159",2022-01-07,29,5,71,100
"25394","2100-2159",2022-01-08,22,6,59,81
"25395","2100-2159",2022-01-09,36,7,70,106
"25396","2100-2159",2022-01-10,30,1,70,100
"25397","2100-2159",2022-01-11,23,2,59,82
"25398","2100-2159",2022-01-12,26,3,57,83
"25399","2100-2159",2022-01-13,28,4,66,94
"25400","2100-2159",2022-01-14,33,5,71,104
"25401","2100-2159",2022-01-15,19,6,55,74
"25402","2100-2159",2022-01-16,37,7,57,94
"25403","2100-2159",2022-01-17,35,1,69,104
"25404","2100-2159",2022-01-18,28,2,58,86
"25405","2100-2159",2022-01-19,30,3,55,85
"25406","2100-2159",2022-01-20,32,4,69,101
"25407","2100-2159",2022-01-21,34,5,71,105
"25408","2100-2159",2022-01-22,18,6,55,73
"25409","2100-2159",2022-01-23,33,7,68,101
"25410","2100-2159",2022-01-24,34,1,70,104
"25411","2100-2159",2022-01-25,27,2,58,85
"25412","2100-2159",2022-01-26,29,3,56,85
"25413","2100-2159",2022-01-27,32,4,70,102
"25414","2100-2159",2022-01-28,34,5,71,105
"25415","2100-2159",2022-01-29,18,6,55,73
"25416","2100-2159",2022-01-30,33,7,69,102
"25417","2100-2159",2022-01-31,33,1,70,103
"25418","2200-2259",2022-01-01,32,6,56,88
"25419","2200-2259",2022-01-02,40,7,72,112
"25420","2200-2259",2022-01-03,39,1,73,112
"25421","2200-2259",2022-01-04,34,2,60,94
"25422","2200-2259",2022-01-05,35,3,56,91
"25423","2200-2259",2022-01-06,41,4,60,101
"25424","2200-2259",2022-01-07,43,5,61,104
"25425","2200-2259",2022-01-08,35,6,51,86
"25426","2200-2259",2022-01-09,42,7,69,111
"25427","2200-2259",2022-01-10,35,1,58,93
"25428","2200-2259",2022-01-11,30,2,51,81
"25429","2200-2259",2022-01-12,33,3,56,89
"25430","2200-2259",2022-01-13,41,4,59,100
"25431","2200-2259",2022-01-14,42,5,63,105
"25432","2200-2259",2022-01-15,31,6,49,80
"25433","2200-2259",2022-01-16,35,7,67,102
"25434","2200-2259",2022-01-17,37,1,63,100
"25435","2200-2259",2022-01-18,28,2,55,83
"25436","2200-2259",2022-01-19,35,3,59,94
"25437","2200-2259",2022-01-20,42,4,65,107
"25438","2200-2259",2022-01-21,43,5,65,108
"25439","2200-2259",2022-01-22,32,6,47,79
"25440","2200-2259",2022-01-23,40,7,68,108
"25441","2200-2259",2022-01-24,36,1,62,98
"25442","2200-2259",2022-01-25,29,2,54,83
"25443","2200-2259",2022-01-26,35,3,60,95
"25444","2200-2259",2022-01-27,42,4,64,106
"25445","2200-2259",2022-01-28,43,5,65,108
"25446","2200-2259",2022-01-29,32,6,47,79
"25447","2200-2259",2022-01-30,39,7,68,107
"25448","2200-2259",2022-01-31,35,1,62,97
"25449","2300-2359",2022-01-01,33,6,55,88
"25450","2300-2359",2022-01-02,36,7,62,98
"25451","2300-2359",2022-01-03,36,1,61,97
"25452","2300-2359",2022-01-04,25,2,54,79
"25453","2300-2359",2022-01-05,22,3,48,70
"25454","2300-2359",2022-01-06,23,4,58,81
"25455","2300-2359",2022-01-07,23,5,57,80
"25456","2300-2359",2022-01-08,20,6,39,59
"25457","2300-2359",2022-01-09,23,7,64,87
"25458","2300-2359",2022-01-10,23,1,55,78
"25459","2300-2359",2022-01-11,20,2,47,67
"25460","2300-2359",2022-01-12,20,3,49,69
"25461","2300-2359",2022-01-13,22,4,58,80
"25462","2300-2359",2022-01-14,23,5,64,87
"25463","2300-2359",2022-01-15,21,6,36,57
"25464","2300-2359",2022-01-16,24,7,56,80
"25465","2300-2359",2022-01-17,23,1,60,83
"25466","2300-2359",2022-01-18,20,2,48,68
"25467","2300-2359",2022-01-19,21,3,49,70
"25468","2300-2359",2022-01-20,23,4,62,85
"25469","2300-2359",2022-01-21,23,5,62,85
"25470","2300-2359",2022-01-22,21,6,38,59
"25471","2300-2359",2022-01-23,24,7,61,85
"25472","2300-2359",2022-01-24,23,1,59,82
"25473","2300-2359",2022-01-25,19,2,48,67
"25474","2300-2359",2022-01-26,21,3,49,70
"25475","2300-2359",2022-01-27,23,4,62,85
"25476","2300-2359",2022-01-28,23,5,62,85
"25477","2300-2359",2022-01-29,21,6,38,59
"25478","2300-2359",2022-01-30,24,7,61,85
"25479","2300-2359",2022-01-31,23,1,59,82
"25480","0001-0559",2022-02-01,15,2,40,55
"25481","0001-0559",2022-02-02,14,3,46,60
"25482","0001-0559",2022-02-03,20,4,52,72
"25483","0001-0559",2022-02-04,20,5,55,75
"25484","0001-0559",2022-02-05,14,6,29,43
"25485","0001-0559",2022-02-06,15,7,52,67
"25486","0001-0559",2022-02-07,20,1,51,71
"25487","0001-0559",2022-02-08,15,2,40,55
"25488","0001-0559",2022-02-09,14,3,44,58
"25489","0001-0559",2022-02-10,19,4,54,73
"25490","0001-0559",2022-02-11,16,5,58,74
"25491","0001-0559",2022-02-12,15,6,35,50
"25492","0001-0559",2022-02-13,12,7,48,60
"25493","0001-0559",2022-02-14,21,1,54,75
"25494","0001-0559",2022-02-15,11,2,40,51
"25495","0001-0559",2022-02-16,9,3,51,60
"25496","0001-0559",2022-02-17,13,4,64,77
"25497","0001-0559",2022-02-18,14,5,65,79
"25498","0001-0559",2022-02-19,11,6,43,54
"25499","0001-0559",2022-02-20,10,7,59,69
"25500","0001-0559",2022-02-21,14,1,61,75
"25501","0001-0559",2022-02-22,11,2,50,61
"25502","0001-0559",2022-02-23,9,3,54,63
"25503","0001-0559",2022-02-24,13,4,64,77
"25504","0001-0559",2022-02-25,14,5,65,79
"25505","0001-0559",2022-02-26,11,6,43,54
"25506","0001-0559",2022-02-27,10,7,65,75
"25507","0001-0559",2022-02-28,14,1,61,75
"25508","0600-0659",2022-02-01,64,2,18,82
"25509","0600-0659",2022-02-02,63,3,19,82
"25510","0600-0659",2022-02-03,71,4,26,97
"25511","0600-0659",2022-02-04,73,5,26,99
"25512","0600-0659",2022-02-05,68,6,24,92
"25513","0600-0659",2022-02-06,75,7,24,99
"25514","0600-0659",2022-02-07,74,1,25,99
"25515","0600-0659",2022-02-08,63,2,20,83
"25516","0600-0659",2022-02-09,63,3,19,82
"25517","0600-0659",2022-02-10,72,4,26,98
"25518","0600-0659",2022-02-11,78,5,26,104
"25519","0600-0659",2022-02-12,73,6,25,98
"25520","0600-0659",2022-02-13,79,7,25,104
"25521","0600-0659",2022-02-14,80,1,27,107
"25522","0600-0659",2022-02-15,71,2,20,91
"25523","0600-0659",2022-02-16,69,3,21,90
"25524","0600-0659",2022-02-17,85,4,23,108
"25525","0600-0659",2022-02-18,82,5,23,105
"25526","0600-0659",2022-02-19,79,6,20,99
"25527","0600-0659",2022-02-20,81,7,20,101
"25528","0600-0659",2022-02-21,81,1,22,103
"25529","0600-0659",2022-02-22,77,2,21,98
"25530","0600-0659",2022-02-23,76,3,18,94
"25531","0600-0659",2022-02-24,85,4,23,108
"25532","0600-0659",2022-02-25,82,5,23,105
"25533","0600-0659",2022-02-26,79,6,21,100
"25534","0600-0659",2022-02-27,82,7,21,103
"25535","0600-0659",2022-02-28,83,1,23,106
"25536","0700-0759",2022-02-01,78,2,31,109
"25537","0700-0759",2022-02-02,76,3,33,109
"25538","0700-0759",2022-02-03,82,4,40,122
"25539","0700-0759",2022-02-04,82,5,37,119
"25540","0700-0759",2022-02-05,80,6,38,118
"25541","0700-0759",2022-02-06,77,7,38,115
"25542","0700-0759",2022-02-07,81,1,39,120
"25543","0700-0759",2022-02-08,80,2,31,111
"25544","0700-0759",2022-02-09,77,3,33,110
"25545","0700-0759",2022-02-10,82,4,39,121
"25546","0700-0759",2022-02-11,83,5,37,120
"25547","0700-0759",2022-02-12,78,6,39,117
"25548","0700-0759",2022-02-13,77,7,36,113
"25549","0700-0759",2022-02-14,83,1,40,123
"25550","0700-0759",2022-02-15,80,2,32,112
"25551","0700-0759",2022-02-16,77,3,30,107
"25552","0700-0759",2022-02-17,84,4,40,124
"25553","0700-0759",2022-02-18,81,5,36,117
"25554","0700-0759",2022-02-19,81,6,40,121
"25555","0700-0759",2022-02-20,80,7,37,117
"25556","0700-0759",2022-02-21,81,1,36,117
"25557","0700-0759",2022-02-22,78,2,33,111
"25558","0700-0759",2022-02-23,78,3,35,113
"25559","0700-0759",2022-02-24,85,4,40,125
"25560","0700-0759",2022-02-25,83,5,36,119
"25561","0700-0759",2022-02-26,81,6,40,121
"25562","0700-0759",2022-02-27,80,7,38,118
"25563","0700-0759",2022-02-28,83,1,35,118
"25564","0800-0859",2022-02-01,78,2,37,115
"25565","0800-0859",2022-02-02,76,3,35,111
"25566","0800-0859",2022-02-03,82,4,39,121
"25567","0800-0859",2022-02-04,85,5,44,129
"25568","0800-0859",2022-02-05,74,6,40,114
"25569","0800-0859",2022-02-06,84,7,41,125
"25570","0800-0859",2022-02-07,83,1,42,125
"25571","0800-0859",2022-02-08,78,2,36,114
"25572","0800-0859",2022-02-09,77,3,35,112
"25573","0800-0859",2022-02-10,84,4,40,124
"25574","0800-0859",2022-02-11,85,5,48,133
"25575","0800-0859",2022-02-12,74,6,43,117
"25576","0800-0859",2022-02-13,83,7,43,126
"25577","0800-0859",2022-02-14,81,1,46,127
"25578","0800-0859",2022-02-15,76,2,40,116
"25579","0800-0859",2022-02-16,74,3,37,111
"25580","0800-0859",2022-02-17,80,4,42,122
"25581","0800-0859",2022-02-18,83,5,41,124
"25582","0800-0859",2022-02-19,72,6,41,113
"25583","0800-0859",2022-02-20,80,7,40,120
"25584","0800-0859",2022-02-21,79,1,40,119
"25585","0800-0859",2022-02-22,71,2,38,109
"25586","0800-0859",2022-02-23,72,3,38,110
"25587","0800-0859",2022-02-24,82,4,42,124
"25588","0800-0859",2022-02-25,84,5,41,125
"25589","0800-0859",2022-02-26,73,6,41,114
"25590","0800-0859",2022-02-27,81,7,40,121
"25591","0800-0859",2022-02-28,80,1,41,121
"25592","0900-0959",2022-02-01,59,2,50,109
"25593","0900-0959",2022-02-02,58,3,50,108
"25594","0900-0959",2022-02-03,64,4,56,120
"25595","0900-0959",2022-02-04,63,5,58,121
"25596","0900-0959",2022-02-05,56,6,50,106
"25597","0900-0959",2022-02-06,63,7,54,117
"25598","0900-0959",2022-02-07,65,1,59,124
"25599","0900-0959",2022-02-08,58,2,53,111
"25600","0900-0959",2022-02-09,58,3,52,110
"25601","0900-0959",2022-02-10,65,4,58,123
"25602","0900-0959",2022-02-11,61,5,58,119
"25603","0900-0959",2022-02-12,59,6,49,108
"25604","0900-0959",2022-02-13,61,7,54,115
"25605","0900-0959",2022-02-14,67,1,59,126
"25606","0900-0959",2022-02-15,58,2,54,112
"25607","0900-0959",2022-02-16,60,3,50,110
"25608","0900-0959",2022-02-17,61,4,59,120
"25609","0900-0959",2022-02-18,61,5,61,122
"25610","0900-0959",2022-02-19,55,6,52,107
"25611","0900-0959",2022-02-20,62,7,56,118
"25612","0900-0959",2022-02-21,64,1,59,123
"25613","0900-0959",2022-02-22,59,2,55,114
"25614","0900-0959",2022-02-23,60,3,53,113
"25615","0900-0959",2022-02-24,61,4,61,122
"25616","0900-0959",2022-02-25,61,5,63,124
"25617","0900-0959",2022-02-26,55,6,52,107
"25618","0900-0959",2022-02-27,62,7,57,119
"25619","0900-0959",2022-02-28,64,1,63,127
"25620","1000-1059",2022-02-01,62,2,34,96
"25621","1000-1059",2022-02-02,60,3,34,94
"25622","1000-1059",2022-02-03,69,4,43,112
"25623","1000-1059",2022-02-04,69,5,43,112
"25624","1000-1059",2022-02-05,58,6,35,93
"25625","1000-1059",2022-02-06,68,7,43,111
"25626","1000-1059",2022-02-07,69,1,43,112
"25627","1000-1059",2022-02-08,63,2,35,98
"25628","1000-1059",2022-02-09,60,3,36,96
"25629","1000-1059",2022-02-10,69,4,43,112
"25630","1000-1059",2022-02-11,70,5,43,113
"25631","1000-1059",2022-02-12,58,6,37,95
"25632","1000-1059",2022-02-13,68,7,44,112
"25633","1000-1059",2022-02-14,71,1,45,116
"25634","1000-1059",2022-02-15,64,2,37,101
"25635","1000-1059",2022-02-16,60,3,39,99
"25636","1000-1059",2022-02-17,75,4,50,125
"25637","1000-1059",2022-02-18,71,5,47,118
"25638","1000-1059",2022-02-19,64,6,40,104
"25639","1000-1059",2022-02-20,71,7,48,119
"25640","1000-1059",2022-02-21,69,1,49,118
"25641","1000-1059",2022-02-22,67,2,41,108
"25642","1000-1059",2022-02-23,63,3,40,103
"25643","1000-1059",2022-02-24,75,4,48,123
"25644","1000-1059",2022-02-25,71,5,46,117
"25645","1000-1059",2022-02-26,65,6,39,104
"25646","1000-1059",2022-02-27,72,7,48,120
"25647","1000-1059",2022-02-28,70,1,48,118
"25648","1100-1159",2022-02-01,49,2,64,113
"25649","1100-1159",2022-02-02,49,3,62,111
"25650","1100-1159",2022-02-03,52,4,66,118
"25651","1100-1159",2022-02-04,51,5,66,117
"25652","1100-1159",2022-02-05,40,6,65,105
"25653","1100-1159",2022-02-06,53,7,69,122
"25654","1100-1159",2022-02-07,51,1,65,116
"25655","1100-1159",2022-02-08,49,2,65,114
"25656","1100-1159",2022-02-09,49,3,63,112
"25657","1100-1159",2022-02-10,52,4,67,119
"25658","1100-1159",2022-02-11,56,5,64,120
"25659","1100-1159",2022-02-12,43,6,64,107
"25660","1100-1159",2022-02-13,56,7,66,122
"25661","1100-1159",2022-02-14,55,1,63,118
"25662","1100-1159",2022-02-15,50,2,61,111
"25663","1100-1159",2022-02-16,52,3,62,114
"25664","1100-1159",2022-02-17,61,4,64,125
"25665","1100-1159",2022-02-18,60,5,67,127
"25666","1100-1159",2022-02-19,45,6,63,108
"25667","1100-1159",2022-02-20,59,7,64,123
"25668","1100-1159",2022-02-21,60,1,65,125
"25669","1100-1159",2022-02-22,52,2,62,114
"25670","1100-1159",2022-02-23,50,3,61,111
"25671","1100-1159",2022-02-24,58,4,65,123
"25672","1100-1159",2022-02-25,57,5,66,123
"25673","1100-1159",2022-02-26,45,6,65,110
"25674","1100-1159",2022-02-27,60,7,64,124
"25675","1100-1159",2022-02-28,58,1,65,123
"25676","1200-1259",2022-02-01,57,2,62,119
"25677","1200-1259",2022-02-02,55,3,58,113
"25678","1200-1259",2022-02-03,58,4,63,121
"25679","1200-1259",2022-02-04,59,5,59,118
"25680","1200-1259",2022-02-05,50,6,51,101
"25681","1200-1259",2022-02-06,56,7,58,114
"25682","1200-1259",2022-02-07,58,1,61,119
"25683","1200-1259",2022-02-08,57,2,58,115
"25684","1200-1259",2022-02-09,56,3,55,111
"25685","1200-1259",2022-02-10,59,4,63,122
"25686","1200-1259",2022-02-11,63,5,59,122
"25687","1200-1259",2022-02-12,57,6,55,112
"25688","1200-1259",2022-02-13,57,7,61,118
"25689","1200-1259",2022-02-14,62,1,62,124
"25690","1200-1259",2022-02-15,59,2,60,119
"25691","1200-1259",2022-02-16,61,3,58,119
"25692","1200-1259",2022-02-17,60,4,66,126
"25693","1200-1259",2022-02-18,61,5,65,126
"25694","1200-1259",2022-02-19,55,6,56,111
"25695","1200-1259",2022-02-20,57,7,65,122
"25696","1200-1259",2022-02-21,63,1,67,130
"25697","1200-1259",2022-02-22,57,2,58,115
"25698","1200-1259",2022-02-23,58,3,56,114
"25699","1200-1259",2022-02-24,60,4,65,125
"25700","1200-1259",2022-02-25,61,5,63,124
"25701","1200-1259",2022-02-26,54,6,55,109
"25702","1200-1259",2022-02-27,61,7,65,126
"25703","1200-1259",2022-02-28,62,1,65,127
"25704","1300-1359",2022-02-01,68,2,60,128
"25705","1300-1359",2022-02-02,66,3,59,125
"25706","1300-1359",2022-02-03,68,4,58,126
"25707","1300-1359",2022-02-04,67,5,59,126
"25708","1300-1359",2022-02-05,61,6,49,110
"25709","1300-1359",2022-02-06,67,7,58,125
"25710","1300-1359",2022-02-07,68,1,60,128
"25711","1300-1359",2022-02-08,68,2,59,127
"25712","1300-1359",2022-02-09,66,3,59,125
"25713","1300-1359",2022-02-10,67,4,58,125
"25714","1300-1359",2022-02-11,63,5,63,126
"25715","1300-1359",2022-02-12,60,6,53,113
"25716","1300-1359",2022-02-13,63,7,56,119
"25717","1300-1359",2022-02-14,61,1,63,124
"25718","1300-1359",2022-02-15,62,2,61,123
"25719","1300-1359",2022-02-16,62,3,61,123
"25720","1300-1359",2022-02-17,63,4,62,125
"25721","1300-1359",2022-02-18,64,5,61,125
"25722","1300-1359",2022-02-19,58,6,50,108
"25723","1300-1359",2022-02-20,63,7,57,120
"25724","1300-1359",2022-02-21,62,1,60,122
"25725","1300-1359",2022-02-22,60,2,60,120
"25726","1300-1359",2022-02-23,57,3,59,116
"25727","1300-1359",2022-02-24,62,4,64,126
"25728","1300-1359",2022-02-25,62,5,64,126
"25729","1300-1359",2022-02-26,58,6,50,108
"25730","1300-1359",2022-02-27,62,7,61,123
"25731","1300-1359",2022-02-28,59,1,63,122
"25732","1400-1459",2022-02-01,53,2,55,108
"25733","1400-1459",2022-02-02,55,3,52,107
"25734","1400-1459",2022-02-03,58,4,58,116
"25735","1400-1459",2022-02-04,58,5,57,115
"25736","1400-1459",2022-02-05,47,6,53,100
"25737","1400-1459",2022-02-06,60,7,58,118
"25738","1400-1459",2022-02-07,59,1,57,116
"25739","1400-1459",2022-02-08,54,2,57,111
"25740","1400-1459",2022-02-09,57,3,55,112
"25741","1400-1459",2022-02-10,59,4,59,118
"25742","1400-1459",2022-02-11,62,5,59,121
"25743","1400-1459",2022-02-12,50,6,52,102
"25744","1400-1459",2022-02-13,56,7,59,115
"25745","1400-1459",2022-02-14,63,1,55,118
"25746","1400-1459",2022-02-15,58,2,55,113
"25747","1400-1459",2022-02-16,60,3,56,116
"25748","1400-1459",2022-02-17,61,4,55,116
"25749","1400-1459",2022-02-18,60,5,54,114
"25750","1400-1459",2022-02-19,42,6,48,90
"25751","1400-1459",2022-02-20,55,7,55,110
"25752","1400-1459",2022-02-21,60,1,52,112
"25753","1400-1459",2022-02-22,59,2,52,111
"25754","1400-1459",2022-02-23,57,3,51,108
"25755","1400-1459",2022-02-24,62,4,52,114
"25756","1400-1459",2022-02-25,62,5,51,113
"25757","1400-1459",2022-02-26,43,6,49,92
"25758","1400-1459",2022-02-27,62,7,54,116
"25759","1400-1459",2022-02-28,62,1,50,112
"25760","1500-1559",2022-02-01,53,2,49,102
"25761","1500-1559",2022-02-02,51,3,48,99
"25762","1500-1559",2022-02-03,56,4,53,109
"25763","1500-1559",2022-02-04,57,5,56,113
"25764","1500-1559",2022-02-05,48,6,48,96
"25765","1500-1559",2022-02-06,58,7,54,112
"25766","1500-1559",2022-02-07,53,1,54,107
"25767","1500-1559",2022-02-08,51,2,50,101
"25768","1500-1559",2022-02-09,50,3,49,99
"25769","1500-1559",2022-02-10,58,4,53,111
"25770","1500-1559",2022-02-11,56,5,58,114
"25771","1500-1559",2022-02-12,52,6,49,101
"25772","1500-1559",2022-02-13,56,7,55,111
"25773","1500-1559",2022-02-14,51,1,58,109
"25774","1500-1559",2022-02-15,49,2,51,100
"25775","1500-1559",2022-02-16,50,3,48,98
"25776","1500-1559",2022-02-17,51,4,62,113
"25777","1500-1559",2022-02-18,51,5,61,112
"25778","1500-1559",2022-02-19,49,6,54,103
"25779","1500-1559",2022-02-20,52,7,61,113
"25780","1500-1559",2022-02-21,49,1,60,109
"25781","1500-1559",2022-02-22,48,2,53,101
"25782","1500-1559",2022-02-23,50,3,50,100
"25783","1500-1559",2022-02-24,51,4,62,113
"25784","1500-1559",2022-02-25,50,5,62,112
"25785","1500-1559",2022-02-26,49,6,53,102
"25786","1500-1559",2022-02-27,51,7,61,112
"25787","1500-1559",2022-02-28,50,1,59,109
"25788","1600-1659",2022-02-01,50,2,62,112
"25789","1600-1659",2022-02-02,52,3,62,114
"25790","1600-1659",2022-02-03,61,4,65,126
"25791","1600-1659",2022-02-04,60,5,65,125
"25792","1600-1659",2022-02-05,47,6,52,99
"25793","1600-1659",2022-02-06,60,7,63,123
"25794","1600-1659",2022-02-07,59,1,64,123
"25795","1600-1659",2022-02-08,51,2,61,112
"25796","1600-1659",2022-02-09,53,3,63,116
"25797","1600-1659",2022-02-10,59,4,64,123
"25798","1600-1659",2022-02-11,64,5,60,124
"25799","1600-1659",2022-02-12,51,6,51,102
"25800","1600-1659",2022-02-13,56,7,58,114
"25801","1600-1659",2022-02-14,62,1,62,124
"25802","1600-1659",2022-02-15,54,2,59,113
"25803","1600-1659",2022-02-16,53,3,59,112
"25804","1600-1659",2022-02-17,66,4,60,126
"25805","1600-1659",2022-02-18,68,5,59,127
"25806","1600-1659",2022-02-19,52,6,52,104
"25807","1600-1659",2022-02-20,60,7,56,116
"25808","1600-1659",2022-02-21,66,1,62,128
"25809","1600-1659",2022-02-22,58,2,59,117
"25810","1600-1659",2022-02-23,57,3,62,119
"25811","1600-1659",2022-02-24,65,4,61,126
"25812","1600-1659",2022-02-25,67,5,60,127
"25813","1600-1659",2022-02-26,52,6,54,106
"25814","1600-1659",2022-02-27,66,7,61,127
"25815","1600-1659",2022-02-28,63,1,61,124
"25816","1700-1759",2022-02-01,52,2,57,109
"25817","1700-1759",2022-02-02,50,3,56,106
"25818","1700-1759",2022-02-03,64,4,63,127
"25819","1700-1759",2022-02-04,62,5,65,127
"25820","1700-1759",2022-02-05,49,6,49,98
"25821","1700-1759",2022-02-06,62,7,61,123
"25822","1700-1759",2022-02-07,62,1,63,125
"25823","1700-1759",2022-02-08,52,2,56,108
"25824","1700-1759",2022-02-09,52,3,55,107
"25825","1700-1759",2022-02-10,62,4,64,126
"25826","1700-1759",2022-02-11,62,5,69,131
"25827","1700-1759",2022-02-12,48,6,54,102
"25828","1700-1759",2022-02-13,54,7,59,113
"25829","1700-1759",2022-02-14,62,1,68,130
"25830","1700-1759",2022-02-15,51,2,57,108
"25831","1700-1759",2022-02-16,51,3,59,110
"25832","1700-1759",2022-02-17,60,4,64,124
"25833","1700-1759",2022-02-18,59,5,65,124
"25834","1700-1759",2022-02-19,51,6,52,103
"25835","1700-1759",2022-02-20,53,7,58,111
"25836","1700-1759",2022-02-21,59,1,63,122
"25837","1700-1759",2022-02-22,53,2,58,111
"25838","1700-1759",2022-02-23,53,3,56,109
"25839","1700-1759",2022-02-24,61,4,65,126
"25840","1700-1759",2022-02-25,60,5,66,126
"25841","1700-1759",2022-02-26,53,6,50,103
"25842","1700-1759",2022-02-27,60,7,63,123
"25843","1700-1759",2022-02-28,58,1,65,123
"25844","1800-1859",2022-02-01,51,2,57,108
"25845","1800-1859",2022-02-02,55,3,57,112
"25846","1800-1859",2022-02-03,63,4,64,127
"25847","1800-1859",2022-02-04,63,5,65,128
"25848","1800-1859",2022-02-05,45,6,48,93
"25849","1800-1859",2022-02-06,62,7,63,125
"25850","1800-1859",2022-02-07,63,1,65,128
"25851","1800-1859",2022-02-08,50,2,57,107
"25852","1800-1859",2022-02-09,53,3,59,112
"25853","1800-1859",2022-02-10,64,4,63,127
"25854","1800-1859",2022-02-11,71,5,64,135
"25855","1800-1859",2022-02-12,53,6,51,104
"25856","1800-1859",2022-02-13,62,7,61,123
"25857","1800-1859",2022-02-14,70,1,64,134
"25858","1800-1859",2022-02-15,56,2,57,113
"25859","1800-1859",2022-02-16,58,3,59,117
"25860","1800-1859",2022-02-17,71,4,70,141
"25861","1800-1859",2022-02-18,71,5,71,142
"25862","1800-1859",2022-02-19,50,6,54,104
"25863","1800-1859",2022-02-20,61,7,65,126
"25864","1800-1859",2022-02-21,69,1,68,137
"25865","1800-1859",2022-02-22,57,2,61,118
"25866","1800-1859",2022-02-23,59,3,62,121
"25867","1800-1859",2022-02-24,71,4,68,139
"25868","1800-1859",2022-02-25,71,5,68,139
"25869","1800-1859",2022-02-26,51,6,56,107
"25870","1800-1859",2022-02-27,68,7,70,138
"25871","1800-1859",2022-02-28,69,1,67,136
"25872","1900-1959",2022-02-01,52,2,37,89
"25873","1900-1959",2022-02-02,53,3,39,92
"25874","1900-1959",2022-02-03,60,4,50,110
"25875","1900-1959",2022-02-04,59,5,48,107
"25876","1900-1959",2022-02-05,42,6,37,79
"25877","1900-1959",2022-02-06,61,7,52,113
"25878","1900-1959",2022-02-07,59,1,48,107
"25879","1900-1959",2022-02-08,52,2,38,90
"25880","1900-1959",2022-02-09,53,3,38,91
"25881","1900-1959",2022-02-10,57,4,49,106
"25882","1900-1959",2022-02-11,56,5,50,106
"25883","1900-1959",2022-02-12,39,6,37,76
"25884","1900-1959",2022-02-13,48,7,49,97
"25885","1900-1959",2022-02-14,53,1,51,104
"25886","1900-1959",2022-02-15,45,2,42,87
"25887","1900-1959",2022-02-16,45,3,41,86
"25888","1900-1959",2022-02-17,58,4,52,110
"25889","1900-1959",2022-02-18,57,5,48,105
"25890","1900-1959",2022-02-19,40,6,42,82
"25891","1900-1959",2022-02-20,49,7,51,100
"25892","1900-1959",2022-02-21,58,1,50,108
"25893","1900-1959",2022-02-22,48,2,41,89
"25894","1900-1959",2022-02-23,47,3,39,86
"25895","1900-1959",2022-02-24,59,4,52,111
"25896","1900-1959",2022-02-25,57,5,50,107
"25897","1900-1959",2022-02-26,42,6,44,86
"25898","1900-1959",2022-02-27,59,7,52,111
"25899","1900-1959",2022-02-28,58,1,49,107
"25900","2000-2059",2022-02-01,30,2,76,106
"25901","2000-2059",2022-02-02,32,3,76,108
"25902","2000-2059",2022-02-03,43,4,80,123
"25903","2000-2059",2022-02-04,45,5,77,122
"25904","2000-2059",2022-02-05,26,6,74,100
"25905","2000-2059",2022-02-06,43,7,78,121
"25906","2000-2059",2022-02-07,44,1,74,118
"25907","2000-2059",2022-02-08,31,2,76,107
"25908","2000-2059",2022-02-09,32,3,77,109
"25909","2000-2059",2022-02-10,46,4,80,126
"25910","2000-2059",2022-02-11,47,5,77,124
"25911","2000-2059",2022-02-12,28,6,76,104
"25912","2000-2059",2022-02-13,43,7,74,117
"25913","2000-2059",2022-02-14,45,1,73,118
"25914","2000-2059",2022-02-15,33,2,70,103
"25915","2000-2059",2022-02-16,36,3,71,107
"25916","2000-2059",2022-02-17,50,4,72,122
"25917","2000-2059",2022-02-18,48,5,77,125
"25918","2000-2059",2022-02-19,29,6,66,95
"25919","2000-2059",2022-02-20,47,7,69,116
"25920","2000-2059",2022-02-21,48,1,75,123
"25921","2000-2059",2022-02-22,37,2,71,108
"25922","2000-2059",2022-02-23,37,3,73,110
"25923","2000-2059",2022-02-24,50,4,73,123
"25924","2000-2059",2022-02-25,48,5,77,125
"25925","2000-2059",2022-02-26,31,6,67,98
"25926","2000-2059",2022-02-27,50,7,72,122
"25927","2000-2059",2022-02-28,47,1,74,121
"25928","2100-2159",2022-02-01,26,2,54,80
"25929","2100-2159",2022-02-02,27,3,54,81
"25930","2100-2159",2022-02-03,31,4,68,99
"25931","2100-2159",2022-02-04,33,5,70,103
"25932","2100-2159",2022-02-05,18,6,52,70
"25933","2100-2159",2022-02-06,33,7,70,103
"25934","2100-2159",2022-02-07,34,1,72,106
"25935","2100-2159",2022-02-08,26,2,55,81
"25936","2100-2159",2022-02-09,28,3,54,82
"25937","2100-2159",2022-02-10,32,4,67,99
"25938","2100-2159",2022-02-11,33,5,77,110
"25939","2100-2159",2022-02-12,18,6,62,80
"25940","2100-2159",2022-02-13,32,7,62,94
"25941","2100-2159",2022-02-14,34,1,75,109
"25942","2100-2159",2022-02-15,26,2,59,85
"25943","2100-2159",2022-02-16,31,3,57,88
"25944","2100-2159",2022-02-17,35,4,76,111
"25945","2100-2159",2022-02-18,36,5,72,108
"25946","2100-2159",2022-02-19,25,6,60,85
"25947","2100-2159",2022-02-20,34,7,66,100
"25948","2100-2159",2022-02-21,37,1,71,108
"25949","2100-2159",2022-02-22,28,2,61,89
"25950","2100-2159",2022-02-23,30,3,57,87
"25951","2100-2159",2022-02-24,35,4,77,112
"25952","2100-2159",2022-02-25,36,5,73,109
"25953","2100-2159",2022-02-26,25,6,63,88
"25954","2100-2159",2022-02-27,35,7,75,110
"25955","2100-2159",2022-02-28,37,1,72,109
"25956","2200-2259",2022-02-01,27,2,51,78
"25957","2200-2259",2022-02-02,33,3,55,88
"25958","2200-2259",2022-02-03,40,4,63,103
"25959","2200-2259",2022-02-04,41,5,63,104
"25960","2200-2259",2022-02-05,30,6,46,76
"25961","2200-2259",2022-02-06,39,7,67,106
"25962","2200-2259",2022-02-07,35,1,62,97
"25963","2200-2259",2022-02-08,28,2,52,80
"25964","2200-2259",2022-02-09,32,3,58,90
"25965","2200-2259",2022-02-10,41,4,64,105
"25966","2200-2259",2022-02-11,41,5,66,107
"25967","2200-2259",2022-02-12,31,6,44,75
"25968","2200-2259",2022-02-13,35,7,62,97
"25969","2200-2259",2022-02-14,36,1,62,98
"25970","2200-2259",2022-02-15,28,2,54,82
"25971","2200-2259",2022-02-16,34,3,60,94
"25972","2200-2259",2022-02-17,40,4,65,105
"25973","2200-2259",2022-02-18,40,5,62,102
"25974","2200-2259",2022-02-19,27,6,49,76
"25975","2200-2259",2022-02-20,36,7,58,94
"25976","2200-2259",2022-02-21,36,1,65,101
"25977","2200-2259",2022-02-22,31,2,54,85
"25978","2200-2259",2022-02-23,34,3,58,92
"25979","2200-2259",2022-02-24,40,4,65,105
"25980","2200-2259",2022-02-25,40,5,61,101
"25981","2200-2259",2022-02-26,28,6,49,77
"25982","2200-2259",2022-02-27,41,7,65,106
"25983","2200-2259",2022-02-28,35,1,62,97
"25984","2300-2359",2022-02-01,18,2,48,66
"25985","2300-2359",2022-02-02,19,3,49,68
"25986","2300-2359",2022-02-03,22,4,57,79
"25987","2300-2359",2022-02-04,22,5,56,78
"25988","2300-2359",2022-02-05,21,6,34,55
"25989","2300-2359",2022-02-06,23,7,56,79
"25990","2300-2359",2022-02-07,22,1,55,77
"25991","2300-2359",2022-02-08,18,2,45,63
"25992","2300-2359",2022-02-09,20,3,46,66
"25993","2300-2359",2022-02-10,23,4,59,82
"25994","2300-2359",2022-02-11,27,5,58,85
"25995","2300-2359",2022-02-12,27,6,38,65
"25996","2300-2359",2022-02-13,28,7,54,82
"25997","2300-2359",2022-02-14,26,1,56,82
"25998","2300-2359",2022-02-15,23,2,45,68
"25999","2300-2359",2022-02-16,25,3,48,73
"26000","2300-2359",2022-02-17,29,4,57,86
"26001","2300-2359",2022-02-18,28,5,60,88
"26002","2300-2359",2022-02-19,30,6,33,63
"26003","2300-2359",2022-02-20,28,7,53,81
"26004","2300-2359",2022-02-21,28,1,58,86
"26005","2300-2359",2022-02-22,26,2,49,75
"26006","2300-2359",2022-02-23,26,3,51,77
"26007","2300-2359",2022-02-24,29,4,57,86
"26008","2300-2359",2022-02-25,28,5,59,87
"26009","2300-2359",2022-02-26,30,6,34,64
"26010","2300-2359",2022-02-27,28,7,58,86
"26011","2300-2359",2022-02-28,28,1,57,85
"26012","0001-0559",2022-03-01,11,2,43,54
"26013","0001-0559",2022-03-02,10,3,50,60
"26014","0001-0559",2022-03-03,12,4,62,74
"26015","0001-0559",2022-03-04,17,5,63,80
"26016","0001-0559",2022-03-05,14,6,41,55
"26017","0001-0559",2022-03-06,15,7,60,75
"26018","0001-0559",2022-03-07,16,1,53,69
"26019","0001-0559",2022-03-08,13,2,40,53
"26020","0001-0559",2022-03-09,13,3,41,54
"26021","0001-0559",2022-03-10,17,4,56,73
"26022","0001-0559",2022-03-11,19,5,59,78
"26023","0001-0559",2022-03-12,19,6,26,45
"26024","0001-0559",2022-03-13,19,7,59,78
"26025","0001-0559",2022-03-14,21,1,57,78
"26026","0001-0559",2022-03-15,17,2,39,56
"26027","0001-0559",2022-03-16,17,3,43,60
"26028","0001-0559",2022-03-17,19,4,62,81
"26029","0001-0559",2022-03-18,20,5,64,84
"26030","0001-0559",2022-03-19,19,6,44,63
"26031","0001-0559",2022-03-20,20,7,61,81
"26032","0001-0559",2022-03-21,21,1,58,79
"26033","0001-0559",2022-03-22,17,2,40,57
"26034","0001-0559",2022-03-23,17,3,43,60
"26035","0001-0559",2022-03-24,19,4,62,81
"26036","0001-0559",2022-03-25,20,5,64,84
"26037","0001-0559",2022-03-26,19,6,43,62
"26038","0001-0559",2022-03-27,24,7,60,84
"26039","0001-0559",2022-03-28,20,1,56,76
"26040","0001-0559",2022-03-29,19,2,38,57
"26041","0001-0559",2022-03-30,19,3,41,60
"26042","0001-0559",2022-03-31,20,4,60,80
"26043","0600-0659",2022-03-01,70,2,19,89
"26044","0600-0659",2022-03-02,71,3,17,88
"26045","0600-0659",2022-03-03,84,4,20,104
"26046","0600-0659",2022-03-04,72,5,26,98
"26047","0600-0659",2022-03-05,68,6,20,88
"26048","0600-0659",2022-03-06,77,7,21,98
"26049","0600-0659",2022-03-07,72,1,29,101
"26050","0600-0659",2022-03-08,68,2,20,88
"26051","0600-0659",2022-03-09,70,3,23,93
"26052","0600-0659",2022-03-10,84,4,29,113
"26053","0600-0659",2022-03-11,79,5,29,108
"26054","0600-0659",2022-03-12,71,6,26,97
"26055","0600-0659",2022-03-13,84,7,26,110
"26056","0600-0659",2022-03-14,80,1,26,106
"26057","0600-0659",2022-03-15,76,2,21,97
"26058","0600-0659",2022-03-16,77,3,21,98
"26059","0600-0659",2022-03-17,84,4,25,109
"26060","0600-0659",2022-03-18,84,5,26,110
"26061","0600-0659",2022-03-19,75,6,21,96
"26062","0600-0659",2022-03-20,86,7,25,111
"26063","0600-0659",2022-03-21,82,1,25,107
"26064","0600-0659",2022-03-22,78,2,21,99
"26065","0600-0659",2022-03-23,78,3,21,99
"26066","0600-0659",2022-03-24,86,4,25,111
"26067","0600-0659",2022-03-25,84,5,26,110
"26068","0600-0659",2022-03-26,75,6,21,96
"26069","0600-0659",2022-03-27,79,7,31,110
"26070","0600-0659",2022-03-28,83,1,31,114
"26071","0600-0659",2022-03-29,78,2,25,103
"26072","0600-0659",2022-03-30,78,3,24,102
"26073","0600-0659",2022-03-31,85,4,30,115
"26074","0700-0759",2022-03-01,81,2,32,113
"26075","0700-0759",2022-03-02,77,3,33,110
"26076","0700-0759",2022-03-03,82,4,40,122
"26077","0700-0759",2022-03-04,77,5,37,114
"26078","0700-0759",2022-03-05,77,6,35,112
"26079","0700-0759",2022-03-06,74,7,40,114
"26080","0700-0759",2022-03-07,82,1,36,118
"26081","0700-0759",2022-03-08,78,2,36,114
"26082","0700-0759",2022-03-09,78,3,39,117
"26083","0700-0759",2022-03-10,80,4,44,124
"26084","0700-0759",2022-03-11,82,5,43,125
"26085","0700-0759",2022-03-12,79,6,46,125
"26086","0700-0759",2022-03-13,82,7,45,127
"26087","0700-0759",2022-03-14,83,1,45,128
"26088","0700-0759",2022-03-15,85,2,45,130
"26089","0700-0759",2022-03-16,82,3,47,129
"26090","0700-0759",2022-03-17,81,4,48,129
"26091","0700-0759",2022-03-18,81,5,47,128
"26092","0700-0759",2022-03-19,84,6,45,129
"26093","0700-0759",2022-03-20,81,7,46,127
"26094","0700-0759",2022-03-21,81,1,46,127
"26095","0700-0759",2022-03-22,83,2,46,129
"26096","0700-0759",2022-03-23,81,3,47,128
"26097","0700-0759",2022-03-24,81,4,48,129
"26098","0700-0759",2022-03-25,81,5,46,127
"26099","0700-0759",2022-03-26,83,6,45,128
"26100","0700-0759",2022-03-27,78,7,47,125
"26101","0700-0759",2022-03-28,74,1,45,119
"26102","0700-0759",2022-03-29,77,2,43,120
"26103","0700-0759",2022-03-30,75,3,46,121
"26104","0700-0759",2022-03-31,78,4,48,126
"26105","0800-0859",2022-03-01,72,2,38,110
"26106","0800-0859",2022-03-02,72,3,38,110
"26107","0800-0859",2022-03-03,84,4,43,127
"26108","0800-0859",2022-03-04,79,5,36,115
"26109","0800-0859",2022-03-05,78,6,38,116
"26110","0800-0859",2022-03-06,79,7,37,116
"26111","0800-0859",2022-03-07,78,1,36,114
"26112","0800-0859",2022-03-08,74,2,36,110
"26113","0800-0859",2022-03-09,74,3,37,111
"26114","0800-0859",2022-03-10,81,4,41,122
"26115","0800-0859",2022-03-11,78,5,39,117
"26116","0800-0859",2022-03-12,80,6,43,123
"26117","0800-0859",2022-03-13,75,7,37,112
"26118","0800-0859",2022-03-14,76,1,39,115
"26119","0800-0859",2022-03-15,74,2,37,111
"26120","0800-0859",2022-03-16,73,3,35,108
"26121","0800-0859",2022-03-17,79,4,40,119
"26122","0800-0859",2022-03-18,77,5,40,117
"26123","0800-0859",2022-03-19,79,6,41,120
"26124","0800-0859",2022-03-20,78,7,41,119
"26125","0800-0859",2022-03-21,78,1,41,119
"26126","0800-0859",2022-03-22,77,2,39,116
"26127","0800-0859",2022-03-23,77,3,37,114
"26128","0800-0859",2022-03-24,79,4,42,121
"26129","0800-0859",2022-03-25,78,5,40,118
"26130","0800-0859",2022-03-26,79,6,40,119
"26131","0800-0859",2022-03-27,79,7,40,119
"26132","0800-0859",2022-03-28,84,1,42,126
"26133","0800-0859",2022-03-29,79,2,40,119
"26134","0800-0859",2022-03-30,81,3,37,118
"26135","0800-0859",2022-03-31,84,4,42,126
"26136","0900-0959",2022-03-01,58,2,54,112
"26137","0900-0959",2022-03-02,61,3,51,112
"26138","0900-0959",2022-03-03,55,4,59,114
"26139","0900-0959",2022-03-04,57,5,54,111
"26140","0900-0959",2022-03-05,53,6,50,103
"26141","0900-0959",2022-03-06,56,7,55,111
"26142","0900-0959",2022-03-07,60,1,55,115
"26143","0900-0959",2022-03-08,56,2,50,106
"26144","0900-0959",2022-03-09,57,3,51,108
"26145","0900-0959",2022-03-10,62,4,54,116
"26146","0900-0959",2022-03-11,62,5,54,116
"26147","0900-0959",2022-03-12,55,6,49,104
"26148","0900-0959",2022-03-13,62,7,58,120
"26149","0900-0959",2022-03-14,64,1,55,119
"26150","0900-0959",2022-03-15,59,2,54,113
"26151","0900-0959",2022-03-16,60,3,53,113
"26152","0900-0959",2022-03-17,61,4,54,115
"26153","0900-0959",2022-03-18,60,5,54,114
"26154","0900-0959",2022-03-19,54,6,49,103
"26155","0900-0959",2022-03-20,58,7,56,114
"26156","0900-0959",2022-03-21,61,1,53,114
"26157","0900-0959",2022-03-22,57,2,53,110
"26158","0900-0959",2022-03-23,57,3,53,110
"26159","0900-0959",2022-03-24,60,4,54,114
"26160","0900-0959",2022-03-25,60,5,54,114
"26161","0900-0959",2022-03-26,56,6,49,105
"26162","0900-0959",2022-03-27,58,7,50,108
"26163","0900-0959",2022-03-28,58,1,52,110
"26164","0900-0959",2022-03-29,54,2,52,106
"26165","0900-0959",2022-03-30,55,3,52,107
"26166","0900-0959",2022-03-31,57,4,52,109
"26167","1000-1059",2022-03-01,65,2,41,106
"26168","1000-1059",2022-03-02,62,3,41,103
"26169","1000-1059",2022-03-03,79,4,54,133
"26170","1000-1059",2022-03-04,75,5,52,127
"26171","1000-1059",2022-03-05,64,6,45,109
"26172","1000-1059",2022-03-06,75,7,52,127
"26173","1000-1059",2022-03-07,73,1,56,129
"26174","1000-1059",2022-03-08,65,2,47,112
"26175","1000-1059",2022-03-09,65,3,45,110
"26176","1000-1059",2022-03-10,71,4,52,123
"26177","1000-1059",2022-03-11,68,5,50,118
"26178","1000-1059",2022-03-12,60,6,51,111
"26179","1000-1059",2022-03-13,70,7,59,129
"26180","1000-1059",2022-03-14,68,1,59,127
"26181","1000-1059",2022-03-15,66,2,53,119
"26182","1000-1059",2022-03-16,63,3,53,116
"26183","1000-1059",2022-03-17,72,4,59,131
"26184","1000-1059",2022-03-18,72,5,58,130
"26185","1000-1059",2022-03-19,61,6,60,121
"26186","1000-1059",2022-03-20,73,7,60,133
"26187","1000-1059",2022-03-21,71,1,60,131
"26188","1000-1059",2022-03-22,71,2,54,125
"26189","1000-1059",2022-03-23,69,3,55,124
"26190","1000-1059",2022-03-24,71,4,59,130
"26191","1000-1059",2022-03-25,72,5,59,131
"26192","1000-1059",2022-03-26,60,6,59,119
"26193","1000-1059",2022-03-27,68,7,62,130
"26194","1000-1059",2022-03-28,68,1,58,126
"26195","1000-1059",2022-03-29,69,2,54,123
"26196","1000-1059",2022-03-30,65,3,55,120
"26197","1000-1059",2022-03-31,67,4,59,126
"26198","1100-1159",2022-03-01,54,2,61,115
"26199","1100-1159",2022-03-02,51,3,61,112
"26200","1100-1159",2022-03-03,61,4,57,118
"26201","1100-1159",2022-03-04,55,5,58,113
"26202","1100-1159",2022-03-05,48,6,57,105
"26203","1100-1159",2022-03-06,58,7,53,111
"26204","1100-1159",2022-03-07,59,1,54,113
"26205","1100-1159",2022-03-08,54,2,52,106
"26206","1100-1159",2022-03-09,52,3,51,103
"26207","1100-1159",2022-03-10,55,4,61,116
"26208","1100-1159",2022-03-11,54,5,62,116
"26209","1100-1159",2022-03-12,53,6,58,111
"26210","1100-1159",2022-03-13,55,7,55,110
"26211","1100-1159",2022-03-14,56,1,56,112
"26212","1100-1159",2022-03-15,52,2,57,109
"26213","1100-1159",2022-03-16,51,3,55,106
"26214","1100-1159",2022-03-17,54,4,60,114
"26215","1100-1159",2022-03-18,52,5,60,112
"26216","1100-1159",2022-03-19,52,6,57,109
"26217","1100-1159",2022-03-20,54,7,58,112
"26218","1100-1159",2022-03-21,53,1,59,112
"26219","1100-1159",2022-03-22,50,2,60,110
"26220","1100-1159",2022-03-23,50,3,58,108
"26221","1100-1159",2022-03-24,55,4,59,114
"26222","1100-1159",2022-03-25,53,5,59,112
"26223","1100-1159",2022-03-26,51,6,59,110
"26224","1100-1159",2022-03-27,54,7,59,113
"26225","1100-1159",2022-03-28,55,1,63,118
"26226","1100-1159",2022-03-29,52,2,60,112
"26227","1100-1159",2022-03-30,52,3,58,110
"26228","1100-1159",2022-03-31,56,4,61,117
"26229","1200-1259",2022-03-01,54,2,58,112
"26230","1200-1259",2022-03-02,57,3,58,115
"26231","1200-1259",2022-03-03,57,4,64,121
"26232","1200-1259",2022-03-04,56,5,60,116
"26233","1200-1259",2022-03-05,50,6,58,108
"26234","1200-1259",2022-03-06,55,7,61,116
"26235","1200-1259",2022-03-07,52,1,63,115
"26236","1200-1259",2022-03-08,49,2,56,105
"26237","1200-1259",2022-03-09,50,3,58,108
"26238","1200-1259",2022-03-10,53,4,54,107
"26239","1200-1259",2022-03-11,53,5,51,104
"26240","1200-1259",2022-03-12,51,6,52,103
"26241","1200-1259",2022-03-13,58,7,56,114
"26242","1200-1259",2022-03-14,58,1,57,115
"26243","1200-1259",2022-03-15,58,2,50,108
"26244","1200-1259",2022-03-16,60,3,52,112
"26245","1200-1259",2022-03-17,62,4,52,114
"26246","1200-1259",2022-03-18,63,5,52,115
"26247","1200-1259",2022-03-19,58,6,51,109
"26248","1200-1259",2022-03-20,63,7,51,114
"26249","1200-1259",2022-03-21,63,1,54,117
"26250","1200-1259",2022-03-22,62,2,49,111
"26251","1200-1259",2022-03-23,63,3,51,114
"26252","1200-1259",2022-03-24,62,4,52,114
"26253","1200-1259",2022-03-25,62,5,52,114
"26254","1200-1259",2022-03-26,57,6,50,107
"26255","1200-1259",2022-03-27,66,7,44,110
"26256","1200-1259",2022-03-28,66,1,47,113
"26257","1200-1259",2022-03-29,63,2,43,106
"26258","1200-1259",2022-03-30,65,3,45,110
"26259","1200-1259",2022-03-31,65,4,46,111
"26260","1300-1359",2022-03-01,59,2,57,116
"26261","1300-1359",2022-03-02,58,3,57,115
"26262","1300-1359",2022-03-03,61,4,65,126
"26263","1300-1359",2022-03-04,62,5,57,119
"26264","1300-1359",2022-03-05,59,6,52,111
"26265","1300-1359",2022-03-06,60,7,58,118
"26266","1300-1359",2022-03-07,62,1,57,119
"26267","1300-1359",2022-03-08,56,2,57,113
"26268","1300-1359",2022-03-09,61,3,54,115
"26269","1300-1359",2022-03-10,59,4,64,123
"26270","1300-1359",2022-03-11,60,5,62,122
"26271","1300-1359",2022-03-12,59,6,59,118
"26272","1300-1359",2022-03-13,57,7,58,115
"26273","1300-1359",2022-03-14,56,1,56,112
"26274","1300-1359",2022-03-15,53,2,58,111
"26275","1300-1359",2022-03-16,56,3,58,114
"26276","1300-1359",2022-03-17,59,4,62,121
"26277","1300-1359",2022-03-18,57,5,61,118
"26278","1300-1359",2022-03-19,57,6,54,111
"26279","1300-1359",2022-03-20,56,7,62,118
"26280","1300-1359",2022-03-21,57,1,57,114
"26281","1300-1359",2022-03-22,54,2,58,112
"26282","1300-1359",2022-03-23,56,3,56,112
"26283","1300-1359",2022-03-24,58,4,62,120
"26284","1300-1359",2022-03-25,57,5,62,119
"26285","1300-1359",2022-03-26,55,6,54,109
"26286","1300-1359",2022-03-27,55,7,62,117
"26287","1300-1359",2022-03-28,57,1,59,116
"26288","1300-1359",2022-03-29,54,2,57,111
"26289","1300-1359",2022-03-30,54,3,55,109
"26290","1300-1359",2022-03-31,58,4,59,117
"26291","1400-1459",2022-03-01,56,2,53,109
"26292","1400-1459",2022-03-02,58,3,54,112
"26293","1400-1459",2022-03-03,60,4,52,112
"26294","1400-1459",2022-03-04,56,5,53,109
"26295","1400-1459",2022-03-05,41,6,47,88
"26296","1400-1459",2022-03-06,59,7,53,112
"26297","1400-1459",2022-03-07,53,1,53,106
"26298","1400-1459",2022-03-08,50,2,51,101
"26299","1400-1459",2022-03-09,47,3,52,99
"26300","1400-1459",2022-03-10,52,4,51,103
"26301","1400-1459",2022-03-11,49,5,51,100
"26302","1400-1459",2022-03-12,43,6,52,95
"26303","1400-1459",2022-03-13,51,7,52,103
"26304","1400-1459",2022-03-14,48,1,55,103
"26305","1400-1459",2022-03-15,45,2,52,97
"26306","1400-1459",2022-03-16,43,3,51,94
"26307","1400-1459",2022-03-17,51,4,54,105
"26308","1400-1459",2022-03-18,52,5,54,106
"26309","1400-1459",2022-03-19,42,6,56,98
"26310","1400-1459",2022-03-20,53,7,55,108
"26311","1400-1459",2022-03-21,49,1,56,105
"26312","1400-1459",2022-03-22,45,2,54,99
"26313","1400-1459",2022-03-23,42,3,53,95
"26314","1400-1459",2022-03-24,52,4,54,106
"26315","1400-1459",2022-03-25,53,5,54,107
"26316","1400-1459",2022-03-26,42,6,54,96
"26317","1400-1459",2022-03-27,48,7,56,104
"26318","1400-1459",2022-03-28,45,1,56,101
"26319","1400-1459",2022-03-29,39,2,55,94
"26320","1400-1459",2022-03-30,39,3,54,93
"26321","1400-1459",2022-03-31,46,4,56,102
"26322","1500-1559",2022-03-01,51,2,53,104
"26323","1500-1559",2022-03-02,51,3,48,99
"26324","1500-1559",2022-03-03,53,4,63,116
"26325","1500-1559",2022-03-04,54,5,62,116
"26326","1500-1559",2022-03-05,51,6,53,104
"26327","1500-1559",2022-03-06,53,7,64,117
"26328","1500-1559",2022-03-07,55,1,65,120
"26329","1500-1559",2022-03-08,52,2,58,110
"26330","1500-1559",2022-03-09,50,3,61,111
"26331","1500-1559",2022-03-10,53,4,69,122
"26332","1500-1559",2022-03-11,52,5,66,118
"26333","1500-1559",2022-03-12,48,6,60,108
"26334","1500-1559",2022-03-13,57,7,64,121
"26335","1500-1559",2022-03-14,57,1,59,116
"26336","1500-1559",2022-03-15,51,2,60,111
"26337","1500-1559",2022-03-16,50,3,58,108
"26338","1500-1559",2022-03-17,57,4,61,118
"26339","1500-1559",2022-03-18,55,5,57,112
"26340","1500-1559",2022-03-19,54,6,53,107
"26341","1500-1559",2022-03-20,58,7,60,118
"26342","1500-1559",2022-03-21,58,1,57,115
"26343","1500-1559",2022-03-22,53,2,60,113
"26344","1500-1559",2022-03-23,51,3,58,109
"26345","1500-1559",2022-03-24,57,4,60,117
"26346","1500-1559",2022-03-25,54,5,57,111
"26347","1500-1559",2022-03-26,54,6,54,108
"26348","1500-1559",2022-03-27,60,7,61,121
"26349","1500-1559",2022-03-28,55,1,58,113
"26350","1500-1559",2022-03-29,51,2,60,111
"26351","1500-1559",2022-03-30,49,3,59,108
"26352","1500-1559",2022-03-31,56,4,62,118
"26353","1600-1659",2022-03-01,57,2,61,118
"26354","1600-1659",2022-03-02,55,3,60,115
"26355","1600-1659",2022-03-03,63,4,54,117
"26356","1600-1659",2022-03-04,62,5,51,113
"26357","1600-1659",2022-03-05,50,6,52,102
"26358","1600-1659",2022-03-06,62,7,55,117
"26359","1600-1659",2022-03-07,60,1,49,109
"26360","1600-1659",2022-03-08,57,2,49,106
"26361","1600-1659",2022-03-09,57,3,49,106
"26362","1600-1659",2022-03-10,64,4,48,112
"26363","1600-1659",2022-03-11,67,5,47,114
"26364","1600-1659",2022-03-12,58,6,45,103
"26365","1600-1659",2022-03-13,62,7,59,121
"26366","1600-1659",2022-03-14,60,1,59,119
"26367","1600-1659",2022-03-15,58,2,55,113
"26368","1600-1659",2022-03-16,60,3,56,116
"26369","1600-1659",2022-03-17,62,4,62,124
"26370","1600-1659",2022-03-18,61,5,62,123
"26371","1600-1659",2022-03-19,56,6,53,109
"26372","1600-1659",2022-03-20,61,7,62,123
"26373","1600-1659",2022-03-21,60,1,64,124
"26374","1600-1659",2022-03-22,62,2,57,119
"26375","1600-1659",2022-03-23,63,3,58,121
"26376","1600-1659",2022-03-24,62,4,62,124
"26377","1600-1659",2022-03-25,62,5,64,126
"26378","1600-1659",2022-03-26,56,6,51,107
"26379","1600-1659",2022-03-27,59,7,60,119
"26380","1600-1659",2022-03-28,62,1,63,125
"26381","1600-1659",2022-03-29,61,2,53,114
"26382","1600-1659",2022-03-30,60,3,55,115
"26383","1600-1659",2022-03-31,66,4,61,127
"26384","1700-1759",2022-03-01,53,2,58,111
"26385","1700-1759",2022-03-02,50,3,58,108
"26386","1700-1759",2022-03-03,56,4,71,127
"26387","1700-1759",2022-03-04,56,5,73,129
"26388","1700-1759",2022-03-05,51,6,53,104
"26389","1700-1759",2022-03-06,57,7,72,129
"26390","1700-1759",2022-03-07,60,1,69,129
"26391","1700-1759",2022-03-08,52,2,62,114
"26392","1700-1759",2022-03-09,52,3,59,111
"26393","1700-1759",2022-03-10,62,4,64,126
"26394","1700-1759",2022-03-11,60,5,65,125
"26395","1700-1759",2022-03-12,44,6,48,92
"26396","1700-1759",2022-03-13,64,7,57,121
"26397","1700-1759",2022-03-14,66,1,58,124
"26398","1700-1759",2022-03-15,62,2,56,118
"26399","1700-1759",2022-03-16,61,3,53,114
"26400","1700-1759",2022-03-17,69,4,56,125
"26401","1700-1759",2022-03-18,67,5,57,124
"26402","1700-1759",2022-03-19,47,6,46,93
"26403","1700-1759",2022-03-20,66,7,56,122
"26404","1700-1759",2022-03-21,69,1,56,125
"26405","1700-1759",2022-03-22,62,2,57,119
"26406","1700-1759",2022-03-23,60,3,53,113
"26407","1700-1759",2022-03-24,68,4,56,124
"26408","1700-1759",2022-03-25,67,5,57,124
"26409","1700-1759",2022-03-26,46,6,47,93
"26410","1700-1759",2022-03-27,63,7,55,118
"26411","1700-1759",2022-03-28,65,1,55,120
"26412","1700-1759",2022-03-29,59,2,54,113
"26413","1700-1759",2022-03-30,58,3,51,109
"26414","1700-1759",2022-03-31,65,4,57,122
"26415","1800-1859",2022-03-01,57,2,59,116
"26416","1800-1859",2022-03-02,58,3,58,116
"26417","1800-1859",2022-03-03,73,4,64,137
"26418","1800-1859",2022-03-04,67,5,59,126
"26419","1800-1859",2022-03-05,47,6,51,98
"26420","1800-1859",2022-03-06,65,7,59,124
"26421","1800-1859",2022-03-07,64,1,59,123
"26422","1800-1859",2022-03-08,55,2,53,108
"26423","1800-1859",2022-03-09,55,3,53,108
"26424","1800-1859",2022-03-10,63,4,66,129
"26425","1800-1859",2022-03-11,63,5,65,128
"26426","1800-1859",2022-03-12,45,6,49,94
"26427","1800-1859",2022-03-13,55,7,67,122
"26428","1800-1859",2022-03-14,55,1,65,120
"26429","1800-1859",2022-03-15,51,2,58,109
"26430","1800-1859",2022-03-16,52,3,59,111
"26431","1800-1859",2022-03-17,57,4,72,129
"26432","1800-1859",2022-03-18,55,5,69,124
"26433","1800-1859",2022-03-19,44,6,54,98
"26434","1800-1859",2022-03-20,55,7,71,126
"26435","1800-1859",2022-03-21,55,1,68,123
"26436","1800-1859",2022-03-22,53,2,62,115
"26437","1800-1859",2022-03-23,52,3,62,114
"26438","1800-1859",2022-03-24,57,4,72,129
"26439","1800-1859",2022-03-25,56,5,69,125
"26440","1800-1859",2022-03-26,44,6,54,98
"26441","1800-1859",2022-03-27,56,7,69,125
"26442","1800-1859",2022-03-28,55,1,66,121
"26443","1800-1859",2022-03-29,54,2,63,117
"26444","1800-1859",2022-03-30,53,3,64,117
"26445","1800-1859",2022-03-31,57,4,70,127
"26446","1900-1959",2022-03-01,47,2,43,90
"26447","1900-1959",2022-03-02,47,3,43,90
"26448","1900-1959",2022-03-03,56,4,55,111
"26449","1900-1959",2022-03-04,57,5,52,109
"26450","1900-1959",2022-03-05,44,6,45,89
"26451","1900-1959",2022-03-06,59,7,53,112
"26452","1900-1959",2022-03-07,57,1,54,111
"26453","1900-1959",2022-03-08,50,2,45,95
"26454","1900-1959",2022-03-09,51,3,46,97
"26455","1900-1959",2022-03-10,66,4,47,113
"26456","1900-1959",2022-03-11,66,5,47,113
"26457","1900-1959",2022-03-12,49,6,42,91
"26458","1900-1959",2022-03-13,67,7,49,116
"26459","1900-1959",2022-03-14,64,1,50,114
"26460","1900-1959",2022-03-15,55,2,48,103
"26461","1900-1959",2022-03-16,57,3,48,105
"26462","1900-1959",2022-03-17,69,4,48,117
"26463","1900-1959",2022-03-18,69,5,49,118
"26464","1900-1959",2022-03-19,52,6,50,102
"26465","1900-1959",2022-03-20,71,7,48,119
"26466","1900-1959",2022-03-21,66,1,50,116
"26467","1900-1959",2022-03-22,58,2,50,108
"26468","1900-1959",2022-03-23,58,3,50,108
"26469","1900-1959",2022-03-24,69,4,49,118
"26470","1900-1959",2022-03-25,69,5,48,117
"26471","1900-1959",2022-03-26,49,6,49,98
"26472","1900-1959",2022-03-27,71,7,50,121
"26473","1900-1959",2022-03-28,67,1,51,118
"26474","1900-1959",2022-03-29,58,2,52,110
"26475","1900-1959",2022-03-30,58,3,51,109
"26476","1900-1959",2022-03-31,71,4,51,122
"26477","2000-2059",2022-03-01,33,2,70,103
"26478","2000-2059",2022-03-02,34,3,71,105
"26479","2000-2059",2022-03-03,51,4,68,119
"26480","2000-2059",2022-03-04,46,5,66,112
"26481","2000-2059",2022-03-05,27,6,57,84
"26482","2000-2059",2022-03-06,45,7,63,108
"26483","2000-2059",2022-03-07,43,1,65,108
"26484","2000-2059",2022-03-08,37,2,67,104
"26485","2000-2059",2022-03-09,37,3,68,105
"26486","2000-2059",2022-03-10,40,4,70,110
"26487","2000-2059",2022-03-11,40,5,70,110
"26488","2000-2059",2022-03-12,31,6,61,92
"26489","2000-2059",2022-03-13,44,7,69,113
"26490","2000-2059",2022-03-14,42,1,70,112
"26491","2000-2059",2022-03-15,33,2,72,105
"26492","2000-2059",2022-03-16,34,3,75,109
"26493","2000-2059",2022-03-17,42,4,75,117
"26494","2000-2059",2022-03-18,43,5,72,115
"26495","2000-2059",2022-03-19,29,6,59,88
"26496","2000-2059",2022-03-20,41,7,72,113
"26497","2000-2059",2022-03-21,39,1,71,110
"26498","2000-2059",2022-03-22,32,2,72,104
"26499","2000-2059",2022-03-23,32,3,74,106
"26500","2000-2059",2022-03-24,43,4,74,117
"26501","2000-2059",2022-03-25,42,5,72,114
"26502","2000-2059",2022-03-26,28,6,57,85
"26503","2000-2059",2022-03-27,41,7,70,111
"26504","2000-2059",2022-03-28,41,1,72,113
"26505","2000-2059",2022-03-29,32,2,73,105
"26506","2000-2059",2022-03-30,31,3,73,104
"26507","2000-2059",2022-03-31,42,4,75,117
"26508","2100-2159",2022-03-01,28,2,57,85
"26509","2100-2159",2022-03-02,29,3,58,87
"26510","2100-2159",2022-03-03,34,4,81,115
"26511","2100-2159",2022-03-04,36,5,77,113
"26512","2100-2159",2022-03-05,22,6,57,79
"26513","2100-2159",2022-03-06,36,7,78,114
"26514","2100-2159",2022-03-07,39,1,71,110
"26515","2100-2159",2022-03-08,27,2,62,89
"26516","2100-2159",2022-03-09,26,3,64,90
"26517","2100-2159",2022-03-10,38,4,78,116
"26518","2100-2159",2022-03-11,40,5,78,118
"26519","2100-2159",2022-03-12,32,6,65,97
"26520","2100-2159",2022-03-13,45,7,73,118
"26521","2100-2159",2022-03-14,44,1,71,115
"26522","2100-2159",2022-03-15,33,2,62,95
"26523","2100-2159",2022-03-16,35,3,62,97
"26524","2100-2159",2022-03-17,49,4,72,121
"26525","2100-2159",2022-03-18,49,5,72,121
"26526","2100-2159",2022-03-19,36,6,60,96
"26527","2100-2159",2022-03-20,46,7,72,118
"26528","2100-2159",2022-03-21,47,1,71,118
"26529","2100-2159",2022-03-22,35,2,62,97
"26530","2100-2159",2022-03-23,37,3,61,98
"26531","2100-2159",2022-03-24,48,4,74,122
"26532","2100-2159",2022-03-25,48,5,72,120
"26533","2100-2159",2022-03-26,38,6,58,96
"26534","2100-2159",2022-03-27,50,7,73,123
"26535","2100-2159",2022-03-28,48,1,67,115
"26536","2100-2159",2022-03-29,38,2,57,95
"26537","2100-2159",2022-03-30,38,3,57,95
"26538","2100-2159",2022-03-31,50,4,73,123
"26539","2200-2259",2022-03-01,29,2,55,84
"26540","2200-2259",2022-03-02,34,3,57,91
"26541","2200-2259",2022-03-03,40,4,58,98
"26542","2200-2259",2022-03-04,41,5,62,103
"26543","2200-2259",2022-03-05,31,6,50,81
"26544","2200-2259",2022-03-06,39,7,64,103
"26545","2200-2259",2022-03-07,37,1,71,108
"26546","2200-2259",2022-03-08,30,2,58,88
"26547","2200-2259",2022-03-09,40,3,58,98
"26548","2200-2259",2022-03-10,47,4,69,116
"26549","2200-2259",2022-03-11,47,5,67,114
"26550","2200-2259",2022-03-12,41,6,46,87
"26551","2200-2259",2022-03-13,39,7,72,111
"26552","2200-2259",2022-03-14,35,1,66,101
"26553","2200-2259",2022-03-15,26,2,55,81
"26554","2200-2259",2022-03-16,29,3,58,87
"26555","2200-2259",2022-03-17,40,4,71,111
"26556","2200-2259",2022-03-18,40,5,68,108
"26557","2200-2259",2022-03-19,33,6,50,83
"26558","2200-2259",2022-03-20,41,7,70,111
"26559","2200-2259",2022-03-21,37,1,66,103
"26560","2200-2259",2022-03-22,28,2,56,84
"26561","2200-2259",2022-03-23,31,3,56,87
"26562","2200-2259",2022-03-24,40,4,70,110
"26563","2200-2259",2022-03-25,40,5,68,108
"26564","2200-2259",2022-03-26,33,6,49,82
"26565","2200-2259",2022-03-27,45,7,68,113
"26566","2200-2259",2022-03-28,44,1,68,112
"26567","2200-2259",2022-03-29,30,2,57,87
"26568","2200-2259",2022-03-30,33,3,57,90
"26569","2200-2259",2022-03-31,47,4,69,116
"26570","2300-2359",2022-03-01,25,2,48,73
"26571","2300-2359",2022-03-02,26,3,48,74
"26572","2300-2359",2022-03-03,27,4,58,85
"26573","2300-2359",2022-03-04,28,5,55,83
"26574","2300-2359",2022-03-05,26,6,40,66
"26575","2300-2359",2022-03-06,27,7,53,80
"26576","2300-2359",2022-03-07,28,1,55,83
"26577","2300-2359",2022-03-08,25,2,49,74
"26578","2300-2359",2022-03-09,25,3,51,76
"26579","2300-2359",2022-03-10,26,4,56,82
"26580","2300-2359",2022-03-11,25,5,59,84
"26581","2300-2359",2022-03-12,16,6,56,72
"26582","2300-2359",2022-03-13,23,7,54,77
"26583","2300-2359",2022-03-14,25,1,55,80
"26584","2300-2359",2022-03-15,23,2,45,68
"26585","2300-2359",2022-03-16,24,3,47,71
"26586","2300-2359",2022-03-17,25,4,59,84
"26587","2300-2359",2022-03-18,25,5,60,85
"26588","2300-2359",2022-03-19,23,6,52,75
"26589","2300-2359",2022-03-20,24,7,59,83
"26590","2300-2359",2022-03-21,24,1,59,83
"26591","2300-2359",2022-03-22,23,2,50,73
"26592","2300-2359",2022-03-23,24,3,52,76
"26593","2300-2359",2022-03-24,25,4,58,83
"26594","2300-2359",2022-03-25,24,5,59,83
"26595","2300-2359",2022-03-26,21,6,53,74
"26596","2300-2359",2022-03-27,25,7,62,87
"26597","2300-2359",2022-03-28,23,1,61,84
"26598","2300-2359",2022-03-29,21,2,52,73
"26599","2300-2359",2022-03-30,23,3,52,75
"26600","2300-2359",2022-03-31,22,4,61,83
"26601","0001-0559",2022-04-01,23,5,59,82
"26602","0001-0559",2022-04-02,21,6,44,65
"26603","0001-0559",2022-04-03,30,7,60,90
"26604","0001-0559",2022-04-04,28,1,51,79
"26605","0001-0559",2022-04-05,27,2,41,68
"26606","0001-0559",2022-04-06,27,3,47,74
"26607","0001-0559",2022-04-07,27,4,57,84
"26608","0001-0559",2022-04-08,27,5,56,83
"26609","0001-0559",2022-04-09,18,6,40,58
"26610","0001-0559",2022-04-10,28,7,58,86
"26611","0001-0559",2022-04-11,26,1,50,76
"26612","0001-0559",2022-04-12,27,2,41,68
"26613","0001-0559",2022-04-13,27,3,45,72
"26614","0001-0559",2022-04-14,27,4,55,82
"26615","0001-0559",2022-04-15,27,5,53,80
"26616","0001-0559",2022-04-16,18,6,39,57
"26617","0001-0559",2022-04-17,27,7,55,82
"26618","0001-0559",2022-04-18,26,1,49,75
"26619","0001-0559",2022-04-19,27,2,40,67
"26620","0001-0559",2022-04-20,26,3,42,68
"26621","0001-0559",2022-04-21,26,4,51,77
"26622","0001-0559",2022-04-22,27,5,51,78
"26623","0001-0559",2022-04-23,18,6,34,52
"26624","0001-0559",2022-04-24,27,7,51,78
"26625","0001-0559",2022-04-25,26,1,46,72
"26626","0001-0559",2022-04-26,27,2,39,66
"26627","0001-0559",2022-04-27,26,3,43,69
"26628","0001-0559",2022-04-28,26,4,51,77
"26629","0001-0559",2022-04-29,27,5,51,78
"26630","0001-0559",2022-04-30,18,6,35,53
"26631","0600-0659",2022-04-01,83,5,33,116
"26632","0600-0659",2022-04-02,79,6,27,106
"26633","0600-0659",2022-04-03,80,7,31,111
"26634","0600-0659",2022-04-04,83,1,32,115
"26635","0600-0659",2022-04-05,76,2,26,102
"26636","0600-0659",2022-04-06,74,3,25,99
"26637","0600-0659",2022-04-07,83,4,33,116
"26638","0600-0659",2022-04-08,79,5,33,112
"26639","0600-0659",2022-04-09,74,6,23,97
"26640","0600-0659",2022-04-10,79,7,34,113
"26641","0600-0659",2022-04-11,77,1,36,113
"26642","0600-0659",2022-04-12,75,2,27,102
"26643","0600-0659",2022-04-13,75,3,28,103
"26644","0600-0659",2022-04-14,82,4,36,118
"26645","0600-0659",2022-04-15,78,5,33,111
"26646","0600-0659",2022-04-16,71,6,27,98
"26647","0600-0659",2022-04-17,77,7,35,112
"26648","0600-0659",2022-04-18,78,1,35,113
"26649","0600-0659",2022-04-19,75,2,28,103
"26650","0600-0659",2022-04-20,79,3,31,110
"26651","0600-0659",2022-04-21,81,4,39,120
"26652","0600-0659",2022-04-22,81,5,38,119
"26653","0600-0659",2022-04-23,81,6,30,111
"26654","0600-0659",2022-04-24,80,7,37,117
"26655","0600-0659",2022-04-25,81,1,38,119
"26656","0600-0659",2022-04-26,79,2,30,109
"26657","0600-0659",2022-04-27,79,3,30,109
"26658","0600-0659",2022-04-28,83,4,38,121
"26659","0600-0659",2022-04-29,83,5,35,118
"26660","0600-0659",2022-04-30,80,6,28,108
"26661","0700-0759",2022-04-01,73,5,46,119
"26662","0700-0759",2022-04-02,70,6,44,114
"26663","0700-0759",2022-04-03,82,7,54,136
"26664","0700-0759",2022-04-04,76,1,53,129
"26665","0700-0759",2022-04-05,74,2,52,126
"26666","0700-0759",2022-04-06,74,3,49,123
"26667","0700-0759",2022-04-07,77,4,52,129
"26668","0700-0759",2022-04-08,79,5,49,128
"26669","0700-0759",2022-04-09,72,6,43,115
"26670","0700-0759",2022-04-10,78,7,48,126
"26671","0700-0759",2022-04-11,81,1,48,129
"26672","0700-0759",2022-04-12,78,2,49,127
"26673","0700-0759",2022-04-13,76,3,47,123
"26674","0700-0759",2022-04-14,81,4,49,130
"26675","0700-0759",2022-04-15,84,5,49,133
"26676","0700-0759",2022-04-16,74,6,40,114
"26677","0700-0759",2022-04-17,82,7,45,127
"26678","0700-0759",2022-04-18,82,1,46,128
"26679","0700-0759",2022-04-19,80,2,48,128
"26680","0700-0759",2022-04-20,77,3,49,126
"26681","0700-0759",2022-04-21,81,4,49,130
"26682","0700-0759",2022-04-22,83,5,51,134
"26683","0700-0759",2022-04-23,72,6,44,116
"26684","0700-0759",2022-04-24,78,7,50,128
"26685","0700-0759",2022-04-25,81,1,49,130
"26686","0700-0759",2022-04-26,78,2,51,129
"26687","0700-0759",2022-04-27,75,3,49,124
"26688","0700-0759",2022-04-28,77,4,50,127
"26689","0700-0759",2022-04-29,79,5,53,132
"26690","0700-0759",2022-04-30,71,6,45,116
"26691","0800-0859",2022-04-01,87,5,42,129
"26692","0800-0859",2022-04-02,89,6,43,132
"26693","0800-0859",2022-04-03,87,7,47,134
"26694","0800-0859",2022-04-04,90,1,48,138
"26695","0800-0859",2022-04-05,84,2,46,130
"26696","0800-0859",2022-04-06,87,3,44,131
"26697","0800-0859",2022-04-07,90,4,49,139
"26698","0800-0859",2022-04-08,90,5,47,137
"26699","0800-0859",2022-04-09,89,6,44,133
"26700","0800-0859",2022-04-10,88,7,49,137
"26701","0800-0859",2022-04-11,90,1,45,135
"26702","0800-0859",2022-04-12,84,2,46,130
"26703","0800-0859",2022-04-13,85,3,45,130
"26704","0800-0859",2022-04-14,84,4,50,134
"26705","0800-0859",2022-04-15,83,5,48,131
"26706","0800-0859",2022-04-16,87,6,43,130
"26707","0800-0859",2022-04-17,82,7,52,134
"26708","0800-0859",2022-04-18,83,1,49,132
"26709","0800-0859",2022-04-19,83,2,44,127
"26710","0800-0859",2022-04-20,83,3,43,126
"26711","0800-0859",2022-04-21,87,4,47,134
"26712","0800-0859",2022-04-22,85,5,46,131
"26713","0800-0859",2022-04-23,88,6,44,132
"26714","0800-0859",2022-04-24,84,7,47,131
"26715","0800-0859",2022-04-25,85,1,46,131
"26716","0800-0859",2022-04-26,85,2,43,128
"26717","0800-0859",2022-04-27,85,3,42,127
"26718","0800-0859",2022-04-28,92,4,47,139
"26719","0800-0859",2022-04-29,90,5,47,137
"26720","0800-0859",2022-04-30,90,6,44,134
"26721","0900-0959",2022-04-01,58,5,51,109
"26722","0900-0959",2022-04-02,50,6,49,99
"26723","0900-0959",2022-04-03,58,7,56,114
"26724","0900-0959",2022-04-04,60,1,55,115
"26725","0900-0959",2022-04-05,52,2,53,105
"26726","0900-0959",2022-04-06,55,3,54,109
"26727","0900-0959",2022-04-07,61,4,56,117
"26728","0900-0959",2022-04-08,61,5,56,117
"26729","0900-0959",2022-04-09,51,6,52,103
"26730","0900-0959",2022-04-10,60,7,55,115
"26731","0900-0959",2022-04-11,60,1,57,117
"26732","0900-0959",2022-04-12,55,2,54,109
"26733","0900-0959",2022-04-13,55,3,55,110
"26734","0900-0959",2022-04-14,62,4,56,118
"26735","0900-0959",2022-04-15,62,5,56,118
"26736","0900-0959",2022-04-16,52,6,52,104
"26737","0900-0959",2022-04-17,61,7,54,115
"26738","0900-0959",2022-04-18,64,1,56,120
"26739","0900-0959",2022-04-19,56,2,58,114
"26740","0900-0959",2022-04-20,57,3,58,115
"26741","0900-0959",2022-04-21,65,4,61,126
"26742","0900-0959",2022-04-22,65,5,58,123
"26743","0900-0959",2022-04-23,53,6,53,106
"26744","0900-0959",2022-04-24,66,7,56,122
"26745","0900-0959",2022-04-25,66,1,59,125
"26746","0900-0959",2022-04-26,59,2,59,118
"26747","0900-0959",2022-04-27,58,3,58,116
"26748","0900-0959",2022-04-28,63,4,61,124
"26749","0900-0959",2022-04-29,64,5,59,123
"26750","0900-0959",2022-04-30,53,6,53,106
"26751","1000-1059",2022-04-01,69,5,60,129
"26752","1000-1059",2022-04-02,60,6,57,117
"26753","1000-1059",2022-04-03,71,7,60,131
"26754","1000-1059",2022-04-04,70,1,59,129
"26755","1000-1059",2022-04-05,70,2,45,115
"26756","1000-1059",2022-04-06,68,3,46,114
"26757","1000-1059",2022-04-07,68,4,51,119
"26758","1000-1059",2022-04-08,69,5,54,123
"26759","1000-1059",2022-04-09,63,6,49,112
"26760","1000-1059",2022-04-10,69,7,50,119
"26761","1000-1059",2022-04-11,69,1,55,124
"26762","1000-1059",2022-04-12,69,2,50,119
"26763","1000-1059",2022-04-13,68,3,47,115
"26764","1000-1059",2022-04-14,69,4,53,122
"26765","1000-1059",2022-04-15,70,5,55,125
"26766","1000-1059",2022-04-16,63,6,52,115
"26767","1000-1059",2022-04-17,69,7,52,121
"26768","1000-1059",2022-04-18,70,1,55,125
"26769","1000-1059",2022-04-19,66,2,52,118
"26770","1000-1059",2022-04-20,63,3,49,112
"26771","1000-1059",2022-04-21,65,4,53,118
"26772","1000-1059",2022-04-22,66,5,56,122
"26773","1000-1059",2022-04-23,60,6,53,113
"26774","1000-1059",2022-04-24,65,7,53,118
"26775","1000-1059",2022-04-25,66,1,55,121
"26776","1000-1059",2022-04-26,63,2,51,114
"26777","1000-1059",2022-04-27,64,3,48,112
"26778","1000-1059",2022-04-28,64,4,51,115
"26779","1000-1059",2022-04-29,64,5,53,117
"26780","1000-1059",2022-04-30,59,6,52,111
"26781","1100-1159",2022-04-01,55,5,61,116
"26782","1100-1159",2022-04-02,52,6,61,113
"26783","1100-1159",2022-04-03,55,7,59,114
"26784","1100-1159",2022-04-04,55,1,60,115
"26785","1100-1159",2022-04-05,51,2,59,110
"26786","1100-1159",2022-04-06,52,3,59,111
"26787","1100-1159",2022-04-07,55,4,62,117
"26788","1100-1159",2022-04-08,55,5,62,117
"26789","1100-1159",2022-04-09,46,6,61,107
"26790","1100-1159",2022-04-10,53,7,63,116
"26791","1100-1159",2022-04-11,55,1,62,117
"26792","1100-1159",2022-04-12,53,2,57,110
"26793","1100-1159",2022-04-13,52,3,58,110
"26794","1100-1159",2022-04-14,56,4,59,115
"26795","1100-1159",2022-04-15,54,5,60,114
"26796","1100-1159",2022-04-16,46,6,59,105
"26797","1100-1159",2022-04-17,54,7,61,115
"26798","1100-1159",2022-04-18,54,1,61,115
"26799","1100-1159",2022-04-19,56,2,54,110
"26800","1100-1159",2022-04-20,58,3,53,111
"26801","1100-1159",2022-04-21,61,4,56,117
"26802","1100-1159",2022-04-22,60,5,57,117
"26803","1100-1159",2022-04-23,52,6,55,107
"26804","1100-1159",2022-04-24,59,7,59,118
"26805","1100-1159",2022-04-25,59,1,58,117
"26806","1100-1159",2022-04-26,59,2,56,115
"26807","1100-1159",2022-04-27,58,3,56,114
"26808","1100-1159",2022-04-28,61,4,60,121
"26809","1100-1159",2022-04-29,60,5,58,118
"26810","1100-1159",2022-04-30,52,6,55,107
"26811","1200-1259",2022-04-01,65,5,46,111
"26812","1200-1259",2022-04-02,62,6,41,103
"26813","1200-1259",2022-04-03,69,7,50,119
"26814","1200-1259",2022-04-04,65,1,52,117
"26815","1200-1259",2022-04-05,56,2,53,109
"26816","1200-1259",2022-04-06,57,3,54,111
"26817","1200-1259",2022-04-07,59,4,55,114
"26818","1200-1259",2022-04-08,58,5,56,114
"26819","1200-1259",2022-04-09,57,6,43,100
"26820","1200-1259",2022-04-10,60,7,53,113
"26821","1200-1259",2022-04-11,58,1,56,114
"26822","1200-1259",2022-04-12,55,2,54,109
"26823","1200-1259",2022-04-13,55,3,54,109
"26824","1200-1259",2022-04-14,55,4,56,111
"26825","1200-1259",2022-04-15,57,5,55,112
"26826","1200-1259",2022-04-16,55,6,43,98
"26827","1200-1259",2022-04-17,57,7,52,109
"26828","1200-1259",2022-04-18,56,1,55,111
"26829","1200-1259",2022-04-19,51,2,52,103
"26830","1200-1259",2022-04-20,50,3,56,106
"26831","1200-1259",2022-04-21,52,4,54,106
"26832","1200-1259",2022-04-22,52,5,54,106
"26833","1200-1259",2022-04-23,49,6,45,94
"26834","1200-1259",2022-04-24,54,7,54,108
"26835","1200-1259",2022-04-25,51,1,54,105
"26836","1200-1259",2022-04-26,52,2,54,106
"26837","1200-1259",2022-04-27,51,3,54,105
"26838","1200-1259",2022-04-28,53,4,52,105
"26839","1200-1259",2022-04-29,54,5,55,109
"26840","1200-1259",2022-04-30,51,6,45,96
"26841","1300-1359",2022-04-01,57,5,60,117
"26842","1300-1359",2022-04-02,53,6,56,109
"26843","1300-1359",2022-04-03,67,7,62,129
"26844","1300-1359",2022-04-04,68,1,61,129
"26845","1300-1359",2022-04-05,71,2,56,127
"26846","1300-1359",2022-04-06,70,3,59,129
"26847","1300-1359",2022-04-07,77,4,65,142
"26848","1300-1359",2022-04-08,77,5,64,141
"26849","1300-1359",2022-04-09,55,6,59,114
"26850","1300-1359",2022-04-10,75,7,66,141
"26851","1300-1359",2022-04-11,74,1,65,139
"26852","1300-1359",2022-04-12,68,2,62,130
"26853","1300-1359",2022-04-13,69,3,60,129
"26854","1300-1359",2022-04-14,78,4,66,144
"26855","1300-1359",2022-04-15,76,5,65,141
"26856","1300-1359",2022-04-16,55,6,59,114
"26857","1300-1359",2022-04-17,75,7,67,142
"26858","1300-1359",2022-04-18,74,1,65,139
"26859","1300-1359",2022-04-19,68,2,65,133
"26860","1300-1359",2022-04-20,70,3,63,133
"26861","1300-1359",2022-04-21,78,4,68,146
"26862","1300-1359",2022-04-22,76,5,65,141
"26863","1300-1359",2022-04-23,56,6,63,119
"26864","1300-1359",2022-04-24,77,7,66,143
"26865","1300-1359",2022-04-25,75,1,65,140
"26866","1300-1359",2022-04-26,69,2,63,132
"26867","1300-1359",2022-04-27,70,3,64,134
"26868","1300-1359",2022-04-28,75,4,67,142
"26869","1300-1359",2022-04-29,74,5,65,139
"26870","1300-1359",2022-04-30,54,6,63,117
"26871","1400-1459",2022-04-01,44,5,56,100
"26872","1400-1459",2022-04-02,42,6,52,94
"26873","1400-1459",2022-04-03,47,7,54,101
"26874","1400-1459",2022-04-04,46,1,54,100
"26875","1400-1459",2022-04-05,41,2,47,88
"26876","1400-1459",2022-04-06,40,3,45,85
"26877","1400-1459",2022-04-07,45,4,46,91
"26878","1400-1459",2022-04-08,46,5,46,92
"26879","1400-1459",2022-04-09,40,6,43,83
"26880","1400-1459",2022-04-10,46,7,44,90
"26881","1400-1459",2022-04-11,49,1,45,94
"26882","1400-1459",2022-04-12,42,2,42,84
"26883","1400-1459",2022-04-13,43,3,43,86
"26884","1400-1459",2022-04-14,47,4,44,91
"26885","1400-1459",2022-04-15,48,5,46,94
"26886","1400-1459",2022-04-16,43,6,44,87
"26887","1400-1459",2022-04-17,47,7,42,89
"26888","1400-1459",2022-04-18,49,1,45,94
"26889","1400-1459",2022-04-19,41,2,42,83
"26890","1400-1459",2022-04-20,44,3,47,91
"26891","1400-1459",2022-04-21,43,4,46,89
"26892","1400-1459",2022-04-22,44,5,47,91
"26893","1400-1459",2022-04-23,43,6,43,86
"26894","1400-1459",2022-04-24,43,7,44,87
"26895","1400-1459",2022-04-25,45,1,45,90
"26896","1400-1459",2022-04-26,40,2,45,85
"26897","1400-1459",2022-04-27,43,3,46,89
"26898","1400-1459",2022-04-28,45,4,46,91
"26899","1400-1459",2022-04-29,42,5,46,88
"26900","1400-1459",2022-04-30,41,6,43,84
"26901","1500-1559",2022-04-01,55,5,56,111
"26902","1500-1559",2022-04-02,55,6,52,107
"26903","1500-1559",2022-04-03,57,7,62,119
"26904","1500-1559",2022-04-04,55,1,58,113
"26905","1500-1559",2022-04-05,50,2,58,108
"26906","1500-1559",2022-04-06,48,3,58,106
"26907","1500-1559",2022-04-07,57,4,60,117
"26908","1500-1559",2022-04-08,54,5,57,111
"26909","1500-1559",2022-04-09,47,6,47,94
"26910","1500-1559",2022-04-10,55,7,60,115
"26911","1500-1559",2022-04-11,53,1,57,110
"26912","1500-1559",2022-04-12,49,2,58,107
"26913","1500-1559",2022-04-13,48,3,59,107
"26914","1500-1559",2022-04-14,57,4,59,116
"26915","1500-1559",2022-04-15,56,5,58,114
"26916","1500-1559",2022-04-16,48,6,46,94
"26917","1500-1559",2022-04-17,57,7,59,116
"26918","1500-1559",2022-04-18,52,1,57,109
"26919","1500-1559",2022-04-19,54,2,56,110
"26920","1500-1559",2022-04-20,54,3,54,108
"26921","1500-1559",2022-04-21,61,4,56,117
"26922","1500-1559",2022-04-22,61,5,57,118
"26923","1500-1559",2022-04-23,49,6,46,95
"26924","1500-1559",2022-04-24,61,7,56,117
"26925","1500-1559",2022-04-25,60,1,55,115
"26926","1500-1559",2022-04-26,53,2,53,106
"26927","1500-1559",2022-04-27,54,3,54,108
"26928","1500-1559",2022-04-28,60,4,56,116
"26929","1500-1559",2022-04-29,60,5,58,118
"26930","1500-1559",2022-04-30,50,6,46,96
"26931","1600-1659",2022-04-01,60,5,65,125
"26932","1600-1659",2022-04-02,54,6,55,109
"26933","1600-1659",2022-04-03,65,7,66,131
"26934","1600-1659",2022-04-04,63,1,68,131
"26935","1600-1659",2022-04-05,60,2,58,118
"26936","1600-1659",2022-04-06,59,3,58,117
"26937","1600-1659",2022-04-07,64,4,66,130
"26938","1600-1659",2022-04-08,63,5,65,128
"26939","1600-1659",2022-04-09,48,6,55,103
"26940","1600-1659",2022-04-10,63,7,65,128
"26941","1600-1659",2022-04-11,63,1,66,129
"26942","1600-1659",2022-04-12,60,2,58,118
"26943","1600-1659",2022-04-13,59,3,56,115
"26944","1600-1659",2022-04-14,64,4,65,129
"26945","1600-1659",2022-04-15,63,5,65,128
"26946","1600-1659",2022-04-16,46,6,55,101
"26947","1600-1659",2022-04-17,61,7,63,124
"26948","1600-1659",2022-04-18,63,1,65,128
"26949","1600-1659",2022-04-19,56,2,57,113
"26950","1600-1659",2022-04-20,54,3,54,108
"26951","1600-1659",2022-04-21,57,4,63,120
"26952","1600-1659",2022-04-22,59,5,63,122
"26953","1600-1659",2022-04-23,43,6,52,95
"26954","1600-1659",2022-04-24,55,7,63,118
"26955","1600-1659",2022-04-25,57,1,63,120
"26956","1600-1659",2022-04-26,53,2,54,107
"26957","1600-1659",2022-04-27,52,3,55,107
"26958","1600-1659",2022-04-28,59,4,64,123
"26959","1600-1659",2022-04-29,59,5,59,118
"26960","1600-1659",2022-04-30,44,6,51,95
"26961","1700-1759",2022-04-01,65,5,53,118
"26962","1700-1759",2022-04-02,47,6,48,95
"26963","1700-1759",2022-04-03,63,7,58,121
"26964","1700-1759",2022-04-04,64,1,58,122
"26965","1700-1759",2022-04-05,61,2,57,118
"26966","1700-1759",2022-04-06,57,3,54,111
"26967","1700-1759",2022-04-07,66,4,56,122
"26968","1700-1759",2022-04-08,64,5,59,123
"26969","1700-1759",2022-04-09,52,6,43,95
"26970","1700-1759",2022-04-10,65,7,57,122
"26971","1700-1759",2022-04-11,63,1,60,123
"26972","1700-1759",2022-04-12,62,2,58,120
"26973","1700-1759",2022-04-13,58,3,58,116
"26974","1700-1759",2022-04-14,63,4,60,123
"26975","1700-1759",2022-04-15,63,5,60,123
"26976","1700-1759",2022-04-16,54,6,46,100
"26977","1700-1759",2022-04-17,64,7,61,125
"26978","1700-1759",2022-04-18,63,1,61,124
"26979","1700-1759",2022-04-19,61,2,60,121
"26980","1700-1759",2022-04-20,57,3,61,118
"26981","1700-1759",2022-04-21,63,4,62,125
"26982","1700-1759",2022-04-22,63,5,63,126
"26983","1700-1759",2022-04-23,52,6,53,105
"26984","1700-1759",2022-04-24,64,7,61,125
"26985","1700-1759",2022-04-25,63,1,63,126
"26986","1700-1759",2022-04-26,61,2,61,122
"26987","1700-1759",2022-04-27,59,3,62,121
"26988","1700-1759",2022-04-28,62,4,62,124
"26989","1700-1759",2022-04-29,62,5,65,127
"26990","1700-1759",2022-04-30,52,6,54,106
"26991","1800-1859",2022-04-01,56,5,69,125
"26992","1800-1859",2022-04-02,43,6,55,98
"26993","1800-1859",2022-04-03,60,7,71,131
"26994","1800-1859",2022-04-04,59,1,65,124
"26995","1800-1859",2022-04-05,54,2,65,119
"26996","1800-1859",2022-04-06,56,3,64,120
"26997","1800-1859",2022-04-07,61,4,73,134
"26998","1800-1859",2022-04-08,58,5,71,129
"26999","1800-1859",2022-04-09,46,6,56,102
"27000","1800-1859",2022-04-10,60,7,72,132
"27001","1800-1859",2022-04-11,61,1,66,127
"27002","1800-1859",2022-04-12,52,2,62,114
"27003","1800-1859",2022-04-13,54,3,62,116
"27004","1800-1859",2022-04-14,64,4,68,132
"27005","1800-1859",2022-04-15,61,5,67,128
"27006","1800-1859",2022-04-16,45,6,53,98
"27007","1800-1859",2022-04-17,63,7,67,130
"27008","1800-1859",2022-04-18,62,1,64,126
"27009","1800-1859",2022-04-19,55,2,60,115
"27010","1800-1859",2022-04-20,57,3,58,115
"27011","1800-1859",2022-04-21,63,4,68,131
"27012","1800-1859",2022-04-22,62,5,69,131
"27013","1800-1859",2022-04-23,48,6,52,100
"27014","1800-1859",2022-04-24,62,7,69,131
"27015","1800-1859",2022-04-25,65,1,67,132
"27016","1800-1859",2022-04-26,55,2,62,117
"27017","1800-1859",2022-04-27,57,3,60,117
"27018","1800-1859",2022-04-28,64,4,70,134
"27019","1800-1859",2022-04-29,60,5,69,129
"27020","1800-1859",2022-04-30,48,6,53,101
"27021","1900-1959",2022-04-01,70,5,51,121
"27022","1900-1959",2022-04-02,51,6,54,105
"27023","1900-1959",2022-04-03,67,7,52,119
"27024","1900-1959",2022-04-04,62,1,56,118
"27025","1900-1959",2022-04-05,55,2,56,111
"27026","1900-1959",2022-04-06,53,3,54,107
"27027","1900-1959",2022-04-07,65,4,57,122
"27028","1900-1959",2022-04-08,62,5,57,119
"27029","1900-1959",2022-04-09,50,6,53,103
"27030","1900-1959",2022-04-10,66,7,56,122
"27031","1900-1959",2022-04-11,58,1,60,118
"27032","1900-1959",2022-04-12,53,2,58,111
"27033","1900-1959",2022-04-13,52,3,56,108
"27034","1900-1959",2022-04-14,65,4,62,127
"27035","1900-1959",2022-04-15,61,5,61,122
"27036","1900-1959",2022-04-16,50,6,58,108
"27037","1900-1959",2022-04-17,61,7,59,120
"27038","1900-1959",2022-04-18,58,1,61,119
"27039","1900-1959",2022-04-19,55,2,61,116
"27040","1900-1959",2022-04-20,56,3,60,116
"27041","1900-1959",2022-04-21,64,4,63,127
"27042","1900-1959",2022-04-22,65,5,64,129
"27043","1900-1959",2022-04-23,52,6,59,111
"27044","1900-1959",2022-04-24,65,7,61,126
"27045","1900-1959",2022-04-25,63,1,64,127
"27046","1900-1959",2022-04-26,55,2,61,116
"27047","1900-1959",2022-04-27,55,3,58,113
"27048","1900-1959",2022-04-28,65,4,62,127
"27049","1900-1959",2022-04-29,65,5,62,127
"27050","1900-1959",2022-04-30,52,6,57,109
"27051","2000-2059",2022-04-01,42,5,72,114
"27052","2000-2059",2022-04-02,34,6,56,90
"27053","2000-2059",2022-04-03,41,7,73,114
"27054","2000-2059",2022-04-04,42,1,70,112
"27055","2000-2059",2022-04-05,33,2,77,110
"27056","2000-2059",2022-04-06,35,3,77,112
"27057","2000-2059",2022-04-07,39,4,83,122
"27058","2000-2059",2022-04-08,42,5,77,119
"27059","2000-2059",2022-04-09,31,6,71,102
"27060","2000-2059",2022-04-10,40,7,81,121
"27061","2000-2059",2022-04-11,43,1,74,117
"27062","2000-2059",2022-04-12,34,2,71,105
"27063","2000-2059",2022-04-13,36,3,72,108
"27064","2000-2059",2022-04-14,41,4,78,119
"27065","2000-2059",2022-04-15,41,5,75,116
"27066","2000-2059",2022-04-16,30,6,66,96
"27067","2000-2059",2022-04-17,41,7,78,119
"27068","2000-2059",2022-04-18,42,1,75,117
"27069","2000-2059",2022-04-19,34,2,71,105
"27070","2000-2059",2022-04-20,35,3,73,108
"27071","2000-2059",2022-04-21,44,4,77,121
"27072","2000-2059",2022-04-22,42,5,75,117
"27073","2000-2059",2022-04-23,26,6,62,88
"27074","2000-2059",2022-04-24,44,7,78,122
"27075","2000-2059",2022-04-25,41,1,75,116
"27076","2000-2059",2022-04-26,35,2,72,107
"27077","2000-2059",2022-04-27,34,3,75,109
"27078","2000-2059",2022-04-28,43,4,77,120
"27079","2000-2059",2022-04-29,39,5,74,113
"27080","2000-2059",2022-04-30,24,6,63,87
"27081","2100-2159",2022-04-01,48,5,71,119
"27082","2100-2159",2022-04-02,39,6,59,98
"27083","2100-2159",2022-04-03,50,7,77,127
"27084","2100-2159",2022-04-04,46,1,72,118
"27085","2100-2159",2022-04-05,44,2,52,96
"27086","2100-2159",2022-04-06,47,3,53,100
"27087","2100-2159",2022-04-07,52,4,65,117
"27088","2100-2159",2022-04-08,51,5,64,115
"27089","2100-2159",2022-04-09,39,6,48,87
"27090","2100-2159",2022-04-10,53,7,65,118
"27091","2100-2159",2022-04-11,50,1,66,116
"27092","2100-2159",2022-04-12,44,2,56,100
"27093","2100-2159",2022-04-13,47,3,57,104
"27094","2100-2159",2022-04-14,52,4,70,122
"27095","2100-2159",2022-04-15,52,5,66,118
"27096","2100-2159",2022-04-16,40,6,50,90
"27097","2100-2159",2022-04-17,54,7,67,121
"27098","2100-2159",2022-04-18,50,1,66,116
"27099","2100-2159",2022-04-19,43,2,57,100
"27100","2100-2159",2022-04-20,46,3,56,102
"27101","2100-2159",2022-04-21,48,4,72,120
"27102","2100-2159",2022-04-22,52,5,69,121
"27103","2100-2159",2022-04-23,40,6,49,89
"27104","2100-2159",2022-04-24,49,7,71,120
"27105","2100-2159",2022-04-25,50,1,70,120
"27106","2100-2159",2022-04-26,43,2,56,99
"27107","2100-2159",2022-04-27,46,3,55,101
"27108","2100-2159",2022-04-28,47,4,73,120
"27109","2100-2159",2022-04-29,53,5,69,122
"27110","2100-2159",2022-04-30,41,6,49,90
"27111","2200-2259",2022-04-01,47,5,67,114
"27112","2200-2259",2022-04-02,39,6,51,90
"27113","2200-2259",2022-04-03,49,7,66,115
"27114","2200-2259",2022-04-04,48,1,68,116
"27115","2200-2259",2022-04-05,39,2,54,93
"27116","2200-2259",2022-04-06,42,3,58,100
"27117","2200-2259",2022-04-07,50,4,65,115
"27118","2200-2259",2022-04-08,47,5,64,111
"27119","2200-2259",2022-04-09,35,6,48,83
"27120","2200-2259",2022-04-10,48,7,64,112
"27121","2200-2259",2022-04-11,49,1,59,108
"27122","2200-2259",2022-04-12,40,2,52,92
"27123","2200-2259",2022-04-13,42,3,55,97
"27124","2200-2259",2022-04-14,50,4,60,110
"27125","2200-2259",2022-04-15,48,5,59,107
"27126","2200-2259",2022-04-16,34,6,43,77
"27127","2200-2259",2022-04-17,47,7,60,107
"27128","2200-2259",2022-04-18,48,1,57,105
"27129","2200-2259",2022-04-19,38,2,49,87
"27130","2200-2259",2022-04-20,43,3,55,98
"27131","2200-2259",2022-04-21,52,4,56,108
"27132","2200-2259",2022-04-22,50,5,58,108
"27133","2200-2259",2022-04-23,34,6,40,74
"27134","2200-2259",2022-04-24,49,7,58,107
"27135","2200-2259",2022-04-25,48,1,57,105
"27136","2200-2259",2022-04-26,40,2,52,92
"27137","2200-2259",2022-04-27,42,3,52,94
"27138","2200-2259",2022-04-28,53,4,57,110
"27139","2200-2259",2022-04-29,48,5,54,102
"27140","2200-2259",2022-04-30,34,6,40,74
"27141","2300-2359",2022-04-01,21,5,60,81
"27142","2300-2359",2022-04-02,20,6,56,76
"27143","2300-2359",2022-04-03,22,7,62,84
"27144","2300-2359",2022-04-04,21,1,61,82
"27145","2300-2359",2022-04-05,18,2,61,79
"27146","2300-2359",2022-04-06,18,3,61,79
"27147","2300-2359",2022-04-07,19,4,64,83
"27148","2300-2359",2022-04-08,19,5,64,83
"27149","2300-2359",2022-04-09,18,6,53,71
"27150","2300-2359",2022-04-10,19,7,65,84
"27151","2300-2359",2022-04-11,18,1,70,88
"27152","2300-2359",2022-04-12,17,2,62,79
"27153","2300-2359",2022-04-13,18,3,62,80
"27154","2300-2359",2022-04-14,18,4,69,87
"27155","2300-2359",2022-04-15,17,5,70,87
"27156","2300-2359",2022-04-16,19,6,55,74
"27157","2300-2359",2022-04-17,19,7,69,88
"27158","2300-2359",2022-04-18,17,1,69,86
"27159","2300-2359",2022-04-19,17,2,62,79
"27160","2300-2359",2022-04-20,16,3,63,79
"27161","2300-2359",2022-04-21,16,4,66,82
"27162","2300-2359",2022-04-22,16,5,68,84
"27163","2300-2359",2022-04-23,17,6,56,73
"27164","2300-2359",2022-04-24,17,7,65,82
"27165","2300-2359",2022-04-25,16,1,69,85
"27166","2300-2359",2022-04-26,16,2,60,76
"27167","2300-2359",2022-04-27,15,3,62,77
"27168","2300-2359",2022-04-28,16,4,64,80
"27169","2300-2359",2022-04-29,17,5,68,85
"27170","2300-2359",2022-04-30,17,6,55,72
"27171","0001-0559",2022-05-01,27,7,52,79
"27172","0001-0559",2022-05-02,26,1,46,72
"27173","0001-0559",2022-05-03,27,2,39,66
"27174","0001-0559",2022-05-04,25,3,41,66
"27175","0001-0559",2022-05-05,27,4,53,80
"27176","0001-0559",2022-05-06,23,5,55,78
"27177","0001-0559",2022-05-07,14,6,38,52
"27178","0001-0559",2022-05-08,22,7,54,76
"27179","0001-0559",2022-05-09,24,1,53,77
"27180","0001-0559",2022-05-10,24,2,40,64
"27181","0001-0559",2022-05-11,24,3,44,68
"27182","0001-0559",2022-05-12,25,4,56,81
"27183","0001-0559",2022-05-13,25,5,56,81
"27184","0001-0559",2022-05-14,15,6,40,55
"27185","0001-0559",2022-05-15,23,7,56,79
"27186","0001-0559",2022-05-16,25,1,53,78
"27187","0001-0559",2022-05-17,25,2,41,66
"27188","0001-0559",2022-05-18,25,3,46,71
"27189","0001-0559",2022-05-19,25,4,54,79
"27190","0001-0559",2022-05-20,25,5,53,78
"27191","0001-0559",2022-05-21,15,6,38,53
"27192","0001-0559",2022-05-22,23,7,54,77
"27193","0001-0559",2022-05-23,25,1,52,77
"27194","0001-0559",2022-05-24,25,2,40,65
"27195","0001-0559",2022-05-25,26,3,46,72
"27196","0001-0559",2022-05-26,27,4,51,78
"27197","0001-0559",2022-05-27,28,5,52,80
"27198","0001-0559",2022-05-28,17,6,38,55
"27199","0001-0559",2022-05-29,25,7,50,75
"27200","0001-0559",2022-05-30,26,1,50,76
"27201","0001-0559",2022-05-31,27,2,42,69
"27202","0600-0659",2022-05-01,79,7,37,116
"27203","0600-0659",2022-05-02,83,1,38,121
"27204","0600-0659",2022-05-03,73,2,29,102
"27205","0600-0659",2022-05-04,77,3,30,107
"27206","0600-0659",2022-05-05,72,4,36,108
"27207","0600-0659",2022-05-06,74,5,32,106
"27208","0600-0659",2022-05-07,76,6,28,104
"27209","0600-0659",2022-05-08,73,7,33,106
"27210","0600-0659",2022-05-09,75,1,33,108
"27211","0600-0659",2022-05-10,70,2,26,96
"27212","0600-0659",2022-05-11,69,3,27,96
"27213","0600-0659",2022-05-12,74,4,34,108
"27214","0600-0659",2022-05-13,75,5,33,108
"27215","0600-0659",2022-05-14,77,6,29,106
"27216","0600-0659",2022-05-15,76,7,34,110
"27217","0600-0659",2022-05-16,76,1,34,110
"27218","0600-0659",2022-05-17,71,2,26,97
"27219","0600-0659",2022-05-18,71,3,28,99
"27220","0600-0659",2022-05-19,76,4,34,110
"27221","0600-0659",2022-05-20,78,5,33,111
"27222","0600-0659",2022-05-21,75,6,29,104
"27223","0600-0659",2022-05-22,78,7,33,111
"27224","0600-0659",2022-05-23,77,1,34,111
"27225","0600-0659",2022-05-24,72,2,26,98
"27226","0600-0659",2022-05-25,69,3,28,97
"27227","0600-0659",2022-05-26,76,4,36,112
"27228","0600-0659",2022-05-27,74,5,35,109
"27229","0600-0659",2022-05-28,73,6,28,101
"27230","0600-0659",2022-05-29,74,7,32,106
"27231","0600-0659",2022-05-30,72,1,35,107
"27232","0600-0659",2022-05-31,70,2,27,97
"27233","0700-0759",2022-05-01,76,7,49,125
"27234","0700-0759",2022-05-02,78,1,52,130
"27235","0700-0759",2022-05-03,77,2,50,127
"27236","0700-0759",2022-05-04,74,3,51,125
"27237","0700-0759",2022-05-05,84,4,52,136
"27238","0700-0759",2022-05-06,85,5,54,139
"27239","0700-0759",2022-05-07,79,6,48,127
"27240","0700-0759",2022-05-08,82,7,50,132
"27241","0700-0759",2022-05-09,86,1,55,141
"27242","0700-0759",2022-05-10,80,2,53,133
"27243","0700-0759",2022-05-11,79,3,52,131
"27244","0700-0759",2022-05-12,86,4,55,141
"27245","0700-0759",2022-05-13,87,5,56,143
"27246","0700-0759",2022-05-14,80,6,49,129
"27247","0700-0759",2022-05-15,82,7,53,135
"27248","0700-0759",2022-05-16,85,1,56,141
"27249","0700-0759",2022-05-17,80,2,54,134
"27250","0700-0759",2022-05-18,78,3,53,131
"27251","0700-0759",2022-05-19,91,4,57,148
"27252","0700-0759",2022-05-20,91,5,56,147
"27253","0700-0759",2022-05-21,82,6,49,131
"27254","0700-0759",2022-05-22,86,7,56,142
"27255","0700-0759",2022-05-23,92,1,56,148
"27256","0700-0759",2022-05-24,83,2,55,138
"27257","0700-0759",2022-05-25,81,3,52,133
"27258","0700-0759",2022-05-26,90,4,57,147
"27259","0700-0759",2022-05-27,92,5,55,147
"27260","0700-0759",2022-05-28,85,6,48,133
"27261","0700-0759",2022-05-29,85,7,54,139
"27262","0700-0759",2022-05-30,92,1,55,147
"27263","0700-0759",2022-05-31,82,2,52,134
"27264","0800-0859",2022-05-01,87,7,44,131
"27265","0800-0859",2022-05-02,92,1,44,136
"27266","0800-0859",2022-05-03,85,2,37,122
"27267","0800-0859",2022-05-04,85,3,38,123
"27268","0800-0859",2022-05-05,89,4,45,134
"27269","0800-0859",2022-05-06,97,5,45,142
"27270","0800-0859",2022-05-07,86,6,43,129
"27271","0800-0859",2022-05-08,97,7,45,142
"27272","0800-0859",2022-05-09,98,1,46,144
"27273","0800-0859",2022-05-10,98,2,43,141
"27274","0800-0859",2022-05-11,97,3,42,139
"27275","0800-0859",2022-05-12,97,4,45,142
"27276","0800-0859",2022-05-13,97,5,45,142
"27277","0800-0859",2022-05-14,87,6,43,130
"27278","0800-0859",2022-05-15,97,7,44,141
"27279","0800-0859",2022-05-16,98,1,45,143
"27280","0800-0859",2022-05-17,98,2,42,140
"27281","0800-0859",2022-05-18,97,3,41,138
"27282","0800-0859",2022-05-19,97,4,46,143
"27283","0800-0859",2022-05-20,99,5,48,147
"27284","0800-0859",2022-05-21,88,6,42,130
"27285","0800-0859",2022-05-22,95,7,45,140
"27286","0800-0859",2022-05-23,100,1,49,149
"27287","0800-0859",2022-05-24,99,2,44,143
"27288","0800-0859",2022-05-25,101,3,43,144
"27289","0800-0859",2022-05-26,96,4,47,143
"27290","0800-0859",2022-05-27,97,5,47,144
"27291","0800-0859",2022-05-28,88,6,44,132
"27292","0800-0859",2022-05-29,91,7,47,138
"27293","0800-0859",2022-05-30,96,1,44,140
"27294","0800-0859",2022-05-31,98,2,45,143
"27295","0900-0959",2022-05-01,64,7,59,123
"27296","0900-0959",2022-05-02,61,1,61,122
"27297","0900-0959",2022-05-03,56,2,60,116
"27298","0900-0959",2022-05-04,57,3,56,113
"27299","0900-0959",2022-05-05,64,4,59,123
"27300","0900-0959",2022-05-06,65,5,58,123
"27301","0900-0959",2022-05-07,57,6,47,104
"27302","0900-0959",2022-05-08,68,7,57,125
"27303","0900-0959",2022-05-09,66,1,58,124
"27304","0900-0959",2022-05-10,64,2,56,120
"27305","0900-0959",2022-05-11,64,3,54,118
"27306","0900-0959",2022-05-12,67,4,58,125
"27307","0900-0959",2022-05-13,65,5,60,125
"27308","0900-0959",2022-05-14,57,6,48,105
"27309","0900-0959",2022-05-15,68,7,58,126
"27310","0900-0959",2022-05-16,65,1,58,123
"27311","0900-0959",2022-05-17,64,2,57,121
"27312","0900-0959",2022-05-18,64,3,55,119
"27313","0900-0959",2022-05-19,65,4,55,120
"27314","0900-0959",2022-05-20,65,5,56,121
"27315","0900-0959",2022-05-21,56,6,46,102
"27316","0900-0959",2022-05-22,66,7,56,122
"27317","0900-0959",2022-05-23,66,1,54,120
"27318","0900-0959",2022-05-24,64,2,54,118
"27319","0900-0959",2022-05-25,63,3,54,117
"27320","0900-0959",2022-05-26,66,4,55,121
"27321","0900-0959",2022-05-27,65,5,56,121
"27322","0900-0959",2022-05-28,57,6,49,106
"27323","0900-0959",2022-05-29,69,7,52,121
"27324","0900-0959",2022-05-30,64,1,56,120
"27325","0900-0959",2022-05-31,63,2,56,119
"27326","1000-1059",2022-05-01,64,7,48,112
"27327","1000-1059",2022-05-02,63,1,50,113
"27328","1000-1059",2022-05-03,63,2,47,110
"27329","1000-1059",2022-05-04,65,3,46,111
"27330","1000-1059",2022-05-05,66,4,56,122
"27331","1000-1059",2022-05-06,65,5,63,128
"27332","1000-1059",2022-05-07,62,6,61,123
"27333","1000-1059",2022-05-08,65,7,62,127
"27334","1000-1059",2022-05-09,66,1,64,130
"27335","1000-1059",2022-05-10,65,2,60,125
"27336","1000-1059",2022-05-11,64,3,60,124
"27337","1000-1059",2022-05-12,66,4,62,128
"27338","1000-1059",2022-05-13,66,5,64,130
"27339","1000-1059",2022-05-14,62,6,61,123
"27340","1000-1059",2022-05-15,66,7,62,128
"27341","1000-1059",2022-05-16,67,1,64,131
"27342","1000-1059",2022-05-17,67,2,60,127
"27343","1000-1059",2022-05-18,67,3,60,127
"27344","1000-1059",2022-05-19,69,4,68,137
"27345","1000-1059",2022-05-20,69,5,70,139
"27346","1000-1059",2022-05-21,65,6,63,128
"27347","1000-1059",2022-05-22,69,7,64,133
"27348","1000-1059",2022-05-23,69,1,70,139
"27349","1000-1059",2022-05-24,68,2,63,131
"27350","1000-1059",2022-05-25,70,3,64,134
"27351","1000-1059",2022-05-26,72,4,69,141
"27352","1000-1059",2022-05-27,72,5,71,143
"27353","1000-1059",2022-05-28,67,6,60,127
"27354","1000-1059",2022-05-29,68,7,69,137
"27355","1000-1059",2022-05-30,73,1,69,142
"27356","1000-1059",2022-05-31,71,2,62,133
"27357","1100-1159",2022-05-01,58,7,61,119
"27358","1100-1159",2022-05-02,57,1,63,120
"27359","1100-1159",2022-05-03,55,2,57,112
"27360","1100-1159",2022-05-04,57,3,58,115
"27361","1100-1159",2022-05-05,61,4,61,122
"27362","1100-1159",2022-05-06,58,5,62,120
"27363","1100-1159",2022-05-07,51,6,54,105
"27364","1100-1159",2022-05-08,59,7,61,120
"27365","1100-1159",2022-05-09,59,1,63,122
"27366","1100-1159",2022-05-10,55,2,57,112
"27367","1100-1159",2022-05-11,55,3,58,113
"27368","1100-1159",2022-05-12,60,4,62,122
"27369","1100-1159",2022-05-13,60,5,61,121
"27370","1100-1159",2022-05-14,52,6,54,106
"27371","1100-1159",2022-05-15,60,7,61,121
"27372","1100-1159",2022-05-16,60,1,62,122
"27373","1100-1159",2022-05-17,56,2,58,114
"27374","1100-1159",2022-05-18,56,3,59,115
"27375","1100-1159",2022-05-19,60,4,62,122
"27376","1100-1159",2022-05-20,61,5,63,124
"27377","1100-1159",2022-05-21,53,6,55,108
"27378","1100-1159",2022-05-22,60,7,61,121
"27379","1100-1159",2022-05-23,59,1,64,123
"27380","1100-1159",2022-05-24,56,2,59,115
"27381","1100-1159",2022-05-25,55,3,63,118
"27382","1100-1159",2022-05-26,58,4,63,121
"27383","1100-1159",2022-05-27,59,5,66,125
"27384","1100-1159",2022-05-28,52,6,55,107
"27385","1100-1159",2022-05-29,60,7,59,119
"27386","1100-1159",2022-05-30,59,1,65,124
"27387","1100-1159",2022-05-31,54,2,60,114
"27388","1200-1259",2022-05-01,55,7,52,107
"27389","1200-1259",2022-05-02,56,1,53,109
"27390","1200-1259",2022-05-03,53,2,53,106
"27391","1200-1259",2022-05-04,54,3,55,109
"27392","1200-1259",2022-05-05,60,4,51,111
"27393","1200-1259",2022-05-06,60,5,55,115
"27394","1200-1259",2022-05-07,54,6,51,105
"27395","1200-1259",2022-05-08,61,7,57,118
"27396","1200-1259",2022-05-09,60,1,57,117
"27397","1200-1259",2022-05-10,59,2,61,120
"27398","1200-1259",2022-05-11,59,3,59,118
"27399","1200-1259",2022-05-12,61,4,56,117
"27400","1200-1259",2022-05-13,61,5,56,117
"27401","1200-1259",2022-05-14,54,6,51,105
"27402","1200-1259",2022-05-15,61,7,57,118
"27403","1200-1259",2022-05-16,60,1,57,117
"27404","1200-1259",2022-05-17,60,2,60,120
"27405","1200-1259",2022-05-18,61,3,59,120
"27406","1200-1259",2022-05-19,62,4,61,123
"27407","1200-1259",2022-05-20,64,5,58,122
"27408","1200-1259",2022-05-21,57,6,53,110
"27409","1200-1259",2022-05-22,62,7,62,124
"27410","1200-1259",2022-05-23,65,1,59,124
"27411","1200-1259",2022-05-24,63,2,62,125
"27412","1200-1259",2022-05-25,65,3,60,125
"27413","1200-1259",2022-05-26,63,4,61,124
"27414","1200-1259",2022-05-27,65,5,57,122
"27415","1200-1259",2022-05-28,55,6,55,110
"27416","1200-1259",2022-05-29,59,7,60,119
"27417","1200-1259",2022-05-30,64,1,58,122
"27418","1200-1259",2022-05-31,63,2,61,124
"27419","1300-1359",2022-05-01,71,7,68,139
"27420","1300-1359",2022-05-02,71,1,63,134
"27421","1300-1359",2022-05-03,67,2,61,128
"27422","1300-1359",2022-05-04,67,3,62,129
"27423","1300-1359",2022-05-05,73,4,57,130
"27424","1300-1359",2022-05-06,73,5,56,129
"27425","1300-1359",2022-05-07,58,6,58,116
"27426","1300-1359",2022-05-08,73,7,58,131
"27427","1300-1359",2022-05-09,73,1,56,129
"27428","1300-1359",2022-05-10,73,2,56,129
"27429","1300-1359",2022-05-11,74,3,57,131
"27430","1300-1359",2022-05-12,73,4,59,132
"27431","1300-1359",2022-05-13,72,5,57,129
"27432","1300-1359",2022-05-14,58,6,58,116
"27433","1300-1359",2022-05-15,73,7,59,132
"27434","1300-1359",2022-05-16,73,1,57,130
"27435","1300-1359",2022-05-17,72,2,58,130
"27436","1300-1359",2022-05-18,73,3,59,132
"27437","1300-1359",2022-05-19,78,4,60,138
"27438","1300-1359",2022-05-20,75,5,62,137
"27439","1300-1359",2022-05-21,59,6,62,121
"27440","1300-1359",2022-05-22,77,7,60,137
"27441","1300-1359",2022-05-23,76,1,62,138
"27442","1300-1359",2022-05-24,75,2,61,136
"27443","1300-1359",2022-05-25,75,3,62,137
"27444","1300-1359",2022-05-26,75,4,60,135
"27445","1300-1359",2022-05-27,76,5,63,139
"27446","1300-1359",2022-05-28,62,6,59,121
"27447","1300-1359",2022-05-29,74,7,60,134
"27448","1300-1359",2022-05-30,76,1,63,139
"27449","1300-1359",2022-05-31,74,2,62,136
"27450","1400-1459",2022-05-01,43,7,42,85
"27451","1400-1459",2022-05-02,42,1,45,87
"27452","1400-1459",2022-05-03,39,2,41,80
"27453","1400-1459",2022-05-04,43,3,45,88
"27454","1400-1459",2022-05-05,46,4,51,97
"27455","1400-1459",2022-05-06,46,5,50,96
"27456","1400-1459",2022-05-07,41,6,41,82
"27457","1400-1459",2022-05-08,47,7,51,98
"27458","1400-1459",2022-05-09,46,1,51,97
"27459","1400-1459",2022-05-10,42,2,47,89
"27460","1400-1459",2022-05-11,45,3,49,94
"27461","1400-1459",2022-05-12,48,4,52,100
"27462","1400-1459",2022-05-13,45,5,50,95
"27463","1400-1459",2022-05-14,41,6,40,81
"27464","1400-1459",2022-05-15,47,7,51,98
"27465","1400-1459",2022-05-16,46,1,51,97
"27466","1400-1459",2022-05-17,44,2,47,91
"27467","1400-1459",2022-05-18,44,3,48,92
"27468","1400-1459",2022-05-19,48,4,54,102
"27469","1400-1459",2022-05-20,50,5,52,102
"27470","1400-1459",2022-05-21,44,6,42,86
"27471","1400-1459",2022-05-22,48,7,53,101
"27472","1400-1459",2022-05-23,50,1,53,103
"27473","1400-1459",2022-05-24,47,2,50,97
"27474","1400-1459",2022-05-25,48,3,51,99
"27475","1400-1459",2022-05-26,50,4,53,103
"27476","1400-1459",2022-05-27,52,5,53,105
"27477","1400-1459",2022-05-28,44,6,44,88
"27478","1400-1459",2022-05-29,47,7,51,98
"27479","1400-1459",2022-05-30,52,1,53,105
"27480","1400-1459",2022-05-31,51,2,50,101
"27481","1500-1559",2022-05-01,57,7,57,114
"27482","1500-1559",2022-05-02,57,1,57,114
"27483","1500-1559",2022-05-03,52,2,54,106
"27484","1500-1559",2022-05-04,52,3,54,106
"27485","1500-1559",2022-05-05,62,4,63,125
"27486","1500-1559",2022-05-06,62,5,61,123
"27487","1500-1559",2022-05-07,48,6,51,99
"27488","1500-1559",2022-05-08,62,7,59,121
"27489","1500-1559",2022-05-09,62,1,60,122
"27490","1500-1559",2022-05-10,56,2,61,117
"27491","1500-1559",2022-05-11,57,3,58,115
"27492","1500-1559",2022-05-12,63,4,60,123
"27493","1500-1559",2022-05-13,62,5,60,122
"27494","1500-1559",2022-05-14,48,6,52,100
"27495","1500-1559",2022-05-15,62,7,60,122
"27496","1500-1559",2022-05-16,62,1,60,122
"27497","1500-1559",2022-05-17,55,2,61,116
"27498","1500-1559",2022-05-18,56,3,59,115
"27499","1500-1559",2022-05-19,61,4,61,122
"27500","1500-1559",2022-05-20,59,5,61,120
"27501","1500-1559",2022-05-21,47,6,51,98
"27502","1500-1559",2022-05-22,59,7,60,119
"27503","1500-1559",2022-05-23,59,1,62,121
"27504","1500-1559",2022-05-24,54,2,63,117
"27505","1500-1559",2022-05-25,53,3,58,111
"27506","1500-1559",2022-05-26,61,4,61,122
"27507","1500-1559",2022-05-27,59,5,61,120
"27508","1500-1559",2022-05-28,47,6,56,103
"27509","1500-1559",2022-05-29,56,7,58,114
"27510","1500-1559",2022-05-30,60,1,59,119
"27511","1500-1559",2022-05-31,53,2,61,114
"27512","1600-1659",2022-05-01,57,7,57,114
"27513","1600-1659",2022-05-02,58,1,56,114
"27514","1600-1659",2022-05-03,51,2,53,104
"27515","1600-1659",2022-05-04,50,3,53,103
"27516","1600-1659",2022-05-05,60,4,60,120
"27517","1600-1659",2022-05-06,57,5,62,119
"27518","1600-1659",2022-05-07,48,6,55,103
"27519","1600-1659",2022-05-08,56,7,62,118
"27520","1600-1659",2022-05-09,60,1,62,122
"27521","1600-1659",2022-05-10,54,2,59,113
"27522","1600-1659",2022-05-11,55,3,60,115
"27523","1600-1659",2022-05-12,58,4,61,119
"27524","1600-1659",2022-05-13,56,5,62,118
"27525","1600-1659",2022-05-14,48,6,56,104
"27526","1600-1659",2022-05-15,57,7,61,118
"27527","1600-1659",2022-05-16,60,1,62,122
"27528","1600-1659",2022-05-17,55,2,60,115
"27529","1600-1659",2022-05-18,55,3,60,115
"27530","1600-1659",2022-05-19,60,4,62,122
"27531","1600-1659",2022-05-20,59,5,64,123
"27532","1600-1659",2022-05-21,47,6,60,107
"27533","1600-1659",2022-05-22,58,7,62,120
"27534","1600-1659",2022-05-23,61,1,63,124
"27535","1600-1659",2022-05-24,58,2,61,119
"27536","1600-1659",2022-05-25,54,3,62,116
"27537","1600-1659",2022-05-26,58,4,62,120
"27538","1600-1659",2022-05-27,59,5,63,122
"27539","1600-1659",2022-05-28,48,6,58,106
"27540","1600-1659",2022-05-29,52,7,62,114
"27541","1600-1659",2022-05-30,59,1,63,122
"27542","1600-1659",2022-05-31,54,2,59,113
"27543","1700-1759",2022-05-01,62,7,61,123
"27544","1700-1759",2022-05-02,62,1,62,124
"27545","1700-1759",2022-05-03,61,2,59,120
"27546","1700-1759",2022-05-04,58,3,63,121
"27547","1700-1759",2022-05-05,63,4,69,132
"27548","1700-1759",2022-05-06,64,5,67,131
"27549","1700-1759",2022-05-07,51,6,53,104
"27550","1700-1759",2022-05-08,65,7,67,132
"27551","1700-1759",2022-05-09,62,1,67,129
"27552","1700-1759",2022-05-10,59,2,62,121
"27553","1700-1759",2022-05-11,59,3,65,124
"27554","1700-1759",2022-05-12,64,4,68,132
"27555","1700-1759",2022-05-13,64,5,65,129
"27556","1700-1759",2022-05-14,51,6,52,103
"27557","1700-1759",2022-05-15,64,7,67,131
"27558","1700-1759",2022-05-16,62,1,66,128
"27559","1700-1759",2022-05-17,58,2,61,119
"27560","1700-1759",2022-05-18,58,3,63,121
"27561","1700-1759",2022-05-19,67,4,66,133
"27562","1700-1759",2022-05-20,66,5,68,134
"27563","1700-1759",2022-05-21,52,6,51,103
"27564","1700-1759",2022-05-22,66,7,65,131
"27565","1700-1759",2022-05-23,65,1,67,132
"27566","1700-1759",2022-05-24,58,2,63,121
"27567","1700-1759",2022-05-25,58,3,63,121
"27568","1700-1759",2022-05-26,68,4,66,134
"27569","1700-1759",2022-05-27,66,5,66,132
"27570","1700-1759",2022-05-28,52,6,51,103
"27571","1700-1759",2022-05-29,64,7,63,127
"27572","1700-1759",2022-05-30,64,1,66,130
"27573","1700-1759",2022-05-31,59,2,64,123
"27574","1800-1859",2022-05-01,57,7,69,126
"27575","1800-1859",2022-05-02,63,1,69,132
"27576","1800-1859",2022-05-03,54,2,60,114
"27577","1800-1859",2022-05-04,59,3,59,118
"27578","1800-1859",2022-05-05,68,4,73,141
"27579","1800-1859",2022-05-06,73,5,70,143
"27580","1800-1859",2022-05-07,58,6,54,112
"27581","1800-1859",2022-05-08,71,7,70,141
"27582","1800-1859",2022-05-09,73,1,69,142
"27583","1800-1859",2022-05-10,66,2,62,128
"27584","1800-1859",2022-05-11,65,3,66,131
"27585","1800-1859",2022-05-12,72,4,70,142
"27586","1800-1859",2022-05-13,73,5,69,142
"27587","1800-1859",2022-05-14,59,6,53,112
"27588","1800-1859",2022-05-15,71,7,70,141
"27589","1800-1859",2022-05-16,73,1,69,142
"27590","1800-1859",2022-05-17,66,2,63,129
"27591","1800-1859",2022-05-18,65,3,65,130
"27592","1800-1859",2022-05-19,71,4,69,140
"27593","1800-1859",2022-05-20,74,5,68,142
"27594","1800-1859",2022-05-21,58,6,51,109
"27595","1800-1859",2022-05-22,71,7,68,139
"27596","1800-1859",2022-05-23,73,1,68,141
"27597","1800-1859",2022-05-24,65,2,61,126
"27598","1800-1859",2022-05-25,63,3,63,126
"27599","1800-1859",2022-05-26,72,4,69,141
"27600","1800-1859",2022-05-27,74,5,70,144
"27601","1800-1859",2022-05-28,56,6,52,108
"27602","1800-1859",2022-05-29,68,7,59,127
"27603","1800-1859",2022-05-30,73,1,70,143
"27604","1800-1859",2022-05-31,64,2,62,126
"27605","1900-1959",2022-05-01,63,7,58,121
"27606","1900-1959",2022-05-02,61,1,61,122
"27607","1900-1959",2022-05-03,52,2,60,112
"27608","1900-1959",2022-05-04,47,3,57,104
"27609","1900-1959",2022-05-05,62,4,61,123
"27610","1900-1959",2022-05-06,60,5,61,121
"27611","1900-1959",2022-05-07,50,6,56,106
"27612","1900-1959",2022-05-08,62,7,64,126
"27613","1900-1959",2022-05-09,62,1,64,126
"27614","1900-1959",2022-05-10,52,2,60,112
"27615","1900-1959",2022-05-11,53,3,56,109
"27616","1900-1959",2022-05-12,62,4,63,125
"27617","1900-1959",2022-05-13,60,5,62,122
"27618","1900-1959",2022-05-14,50,6,56,106
"27619","1900-1959",2022-05-15,63,7,63,126
"27620","1900-1959",2022-05-16,62,1,64,126
"27621","1900-1959",2022-05-17,52,2,59,111
"27622","1900-1959",2022-05-18,53,3,57,110
"27623","1900-1959",2022-05-19,62,4,67,129
"27624","1900-1959",2022-05-20,62,5,66,128
"27625","1900-1959",2022-05-21,51,6,56,107
"27626","1900-1959",2022-05-22,64,7,66,130
"27627","1900-1959",2022-05-23,63,1,68,131
"27628","1900-1959",2022-05-24,53,2,59,112
"27629","1900-1959",2022-05-25,56,3,55,111
"27630","1900-1959",2022-05-26,60,4,67,127
"27631","1900-1959",2022-05-27,61,5,66,127
"27632","1900-1959",2022-05-28,49,6,59,108
"27633","1900-1959",2022-05-29,50,7,65,115
"27634","1900-1959",2022-05-30,62,1,66,128
"27635","1900-1959",2022-05-31,54,2,60,114
"27636","2000-2059",2022-05-01,43,7,76,119
"27637","2000-2059",2022-05-02,42,1,75,117
"27638","2000-2059",2022-05-03,34,2,69,103
"27639","2000-2059",2022-05-04,38,3,74,112
"27640","2000-2059",2022-05-05,40,4,74,114
"27641","2000-2059",2022-05-06,43,5,78,121
"27642","2000-2059",2022-05-07,30,6,68,98
"27643","2000-2059",2022-05-08,42,7,77,119
"27644","2000-2059",2022-05-09,41,1,78,119
"27645","2000-2059",2022-05-10,34,2,75,109
"27646","2000-2059",2022-05-11,34,3,77,111
"27647","2000-2059",2022-05-12,42,4,80,122
"27648","2000-2059",2022-05-13,42,5,79,121
"27649","2000-2059",2022-05-14,30,6,70,100
"27650","2000-2059",2022-05-15,42,7,77,119
"27651","2000-2059",2022-05-16,42,1,79,121
"27652","2000-2059",2022-05-17,35,2,76,111
"27653","2000-2059",2022-05-18,35,3,78,113
"27654","2000-2059",2022-05-19,43,4,83,126
"27655","2000-2059",2022-05-20,44,5,84,128
"27656","2000-2059",2022-05-21,28,6,72,100
"27657","2000-2059",2022-05-22,43,7,82,125
"27658","2000-2059",2022-05-23,43,1,83,126
"27659","2000-2059",2022-05-24,31,2,79,110
"27660","2000-2059",2022-05-25,34,3,83,117
"27661","2000-2059",2022-05-26,43,4,82,125
"27662","2000-2059",2022-05-27,44,5,84,128
"27663","2000-2059",2022-05-28,31,6,70,101
"27664","2000-2059",2022-05-29,39,7,78,117
"27665","2000-2059",2022-05-30,42,1,83,125
"27666","2000-2059",2022-05-31,34,2,79,113
"27667","2100-2159",2022-05-01,51,7,71,122
"27668","2100-2159",2022-05-02,49,1,70,119
"27669","2100-2159",2022-05-03,41,2,58,99
"27670","2100-2159",2022-05-04,42,3,57,99
"27671","2100-2159",2022-05-05,47,4,73,120
"27672","2100-2159",2022-05-06,50,5,74,124
"27673","2100-2159",2022-05-07,34,6,55,89
"27674","2100-2159",2022-05-08,49,7,77,126
"27675","2100-2159",2022-05-09,50,1,74,124
"27676","2100-2159",2022-05-10,38,2,65,103
"27677","2100-2159",2022-05-11,41,3,65,106
"27678","2100-2159",2022-05-12,49,4,76,125
"27679","2100-2159",2022-05-13,52,5,75,127
"27680","2100-2159",2022-05-14,36,6,57,93
"27681","2100-2159",2022-05-15,50,7,79,129
"27682","2100-2159",2022-05-16,50,1,75,125
"27683","2100-2159",2022-05-17,39,2,66,105
"27684","2100-2159",2022-05-18,42,3,66,108
"27685","2100-2159",2022-05-19,52,4,74,126
"27686","2100-2159",2022-05-20,50,5,74,124
"27687","2100-2159",2022-05-21,37,6,54,91
"27688","2100-2159",2022-05-22,51,7,75,126
"27689","2100-2159",2022-05-23,50,1,74,124
"27690","2100-2159",2022-05-24,42,2,62,104
"27691","2100-2159",2022-05-25,46,3,59,105
"27692","2100-2159",2022-05-26,54,4,70,124
"27693","2100-2159",2022-05-27,49,5,71,120
"27694","2100-2159",2022-05-28,39,6,52,91
"27695","2100-2159",2022-05-29,48,7,63,111
"27696","2100-2159",2022-05-30,52,1,72,124
"27697","2100-2159",2022-05-31,44,2,60,104
"27698","2200-2259",2022-05-01,48,7,53,101
"27699","2200-2259",2022-05-02,49,1,52,101
"27700","2200-2259",2022-05-03,39,2,49,88
"27701","2200-2259",2022-05-04,43,3,48,91
"27702","2200-2259",2022-05-05,45,4,61,106
"27703","2200-2259",2022-05-06,41,5,62,103
"27704","2200-2259",2022-05-07,29,6,43,72
"27705","2200-2259",2022-05-08,42,7,60,102
"27706","2200-2259",2022-05-09,42,1,63,105
"27707","2200-2259",2022-05-10,36,2,54,90
"27708","2200-2259",2022-05-11,38,3,55,93
"27709","2200-2259",2022-05-12,43,4,61,104
"27710","2200-2259",2022-05-13,42,5,60,102
"27711","2200-2259",2022-05-14,30,6,42,72
"27712","2200-2259",2022-05-15,43,7,59,102
"27713","2200-2259",2022-05-16,44,1,62,106
"27714","2200-2259",2022-05-17,37,2,53,90
"27715","2200-2259",2022-05-18,42,3,53,95
"27716","2200-2259",2022-05-19,45,4,61,106
"27717","2200-2259",2022-05-20,44,5,63,107
"27718","2200-2259",2022-05-21,31,6,44,75
"27719","2200-2259",2022-05-22,44,7,61,105
"27720","2200-2259",2022-05-23,45,1,63,108
"27721","2200-2259",2022-05-24,37,2,54,91
"27722","2200-2259",2022-05-25,40,3,55,95
"27723","2200-2259",2022-05-26,44,4,63,107
"27724","2200-2259",2022-05-27,44,5,62,106
"27725","2200-2259",2022-05-28,30,6,43,73
"27726","2200-2259",2022-05-29,42,7,54,96
"27727","2200-2259",2022-05-30,44,1,62,106
"27728","2200-2259",2022-05-31,36,2,55,91
"27729","2300-2359",2022-05-01,17,7,65,82
"27730","2300-2359",2022-05-02,16,1,69,85
"27731","2300-2359",2022-05-03,15,2,58,73
"27732","2300-2359",2022-05-04,14,3,60,74
"27733","2300-2359",2022-05-05,21,4,55,76
"27734","2300-2359",2022-05-06,25,5,56,81
"27735","2300-2359",2022-05-07,23,6,45,68
"27736","2300-2359",2022-05-08,22,7,54,76
"27737","2300-2359",2022-05-09,23,1,55,78
"27738","2300-2359",2022-05-10,20,2,48,68
"27739","2300-2359",2022-05-11,21,3,49,70
"27740","2300-2359",2022-05-12,22,4,54,76
"27741","2300-2359",2022-05-13,25,5,59,84
"27742","2300-2359",2022-05-14,23,6,47,70
"27743","2300-2359",2022-05-15,23,7,57,80
"27744","2300-2359",2022-05-16,22,1,58,80
"27745","2300-2359",2022-05-17,19,2,51,70
"27746","2300-2359",2022-05-18,20,3,53,73
"27747","2300-2359",2022-05-19,22,4,60,82
"27748","2300-2359",2022-05-20,23,5,59,82
"27749","2300-2359",2022-05-21,22,6,49,71
"27750","2300-2359",2022-05-22,24,7,61,85
"27751","2300-2359",2022-05-23,21,1,58,79
"27752","2300-2359",2022-05-24,19,2,53,72
"27753","2300-2359",2022-05-25,20,3,56,76
"27754","2300-2359",2022-05-26,21,4,62,83
"27755","2300-2359",2022-05-27,22,5,60,82
"27756","2300-2359",2022-05-28,20,6,51,71
"27757","2300-2359",2022-05-29,23,7,58,81
"27758","2300-2359",2022-05-30,20,1,61,81
"27759","2300-2359",2022-05-31,19,2,53,72
"27760","0001-0559",2022-06-01,25,3,44,69
"27761","0001-0559",2022-06-02,25,4,49,74
"27762","0001-0559",2022-06-03,28,5,51,79
"27763","0001-0559",2022-06-04,19,6,35,54
"27764","0001-0559",2022-06-05,28,7,55,83
"27765","0001-0559",2022-06-06,28,1,50,78
"27766","0001-0559",2022-06-07,28,2,44,72
"27767","0001-0559",2022-06-08,28,3,47,75
"27768","0001-0559",2022-06-09,31,4,53,84
"27769","0001-0559",2022-06-10,30,5,52,82
"27770","0001-0559",2022-06-11,22,6,39,61
"27771","0001-0559",2022-06-12,30,7,54,84
"27772","0001-0559",2022-06-13,29,1,52,81
"27773","0001-0559",2022-06-14,30,2,46,76
"27774","0001-0559",2022-06-15,30,3,50,80
"27775","0001-0559",2022-06-16,30,4,55,85
"27776","0001-0559",2022-06-17,31,5,55,86
"27777","0001-0559",2022-06-18,23,6,41,64
"27778","0001-0559",2022-06-19,31,7,55,86
"27779","0001-0559",2022-06-20,31,1,54,85
"27780","0001-0559",2022-06-21,30,2,48,78
"27781","0001-0559",2022-06-22,30,3,52,82
"27782","0001-0559",2022-06-23,31,4,57,88
"27783","0001-0559",2022-06-24,30,5,59,89
"27784","0001-0559",2022-06-25,22,6,45,67
"27785","0001-0559",2022-06-26,29,7,60,89
"27786","0001-0559",2022-06-27,30,1,59,89
"27787","0001-0559",2022-06-28,29,2,53,82
"27788","0001-0559",2022-06-29,29,3,57,86
"27789","0001-0559",2022-06-30,30,4,60,90
"27790","0600-0659",2022-06-01,70,3,28,98
"27791","0600-0659",2022-06-02,75,4,34,109
"27792","0600-0659",2022-06-03,66,5,37,103
"27793","0600-0659",2022-06-04,66,6,30,96
"27794","0600-0659",2022-06-05,66,7,39,105
"27795","0600-0659",2022-06-06,65,1,35,100
"27796","0600-0659",2022-06-07,63,2,33,96
"27797","0600-0659",2022-06-08,64,3,33,97
"27798","0600-0659",2022-06-09,68,4,36,104
"27799","0600-0659",2022-06-10,67,5,35,102
"27800","0600-0659",2022-06-11,68,6,33,101
"27801","0600-0659",2022-06-12,65,7,36,101
"27802","0600-0659",2022-06-13,66,1,35,101
"27803","0600-0659",2022-06-14,64,2,33,97
"27804","0600-0659",2022-06-15,63,3,33,96
"27805","0600-0659",2022-06-16,66,4,36,102
"27806","0600-0659",2022-06-17,66,5,35,101
"27807","0600-0659",2022-06-18,68,6,33,101
"27808","0600-0659",2022-06-19,65,7,36,101
"27809","0600-0659",2022-06-20,67,1,35,102
"27810","0600-0659",2022-06-21,64,2,33,97
"27811","0600-0659",2022-06-22,64,3,33,97
"27812","0600-0659",2022-06-23,66,4,36,102
"27813","0600-0659",2022-06-24,68,5,35,103
"27814","0600-0659",2022-06-25,71,6,31,102
"27815","0600-0659",2022-06-26,68,7,34,102
"27816","0600-0659",2022-06-27,70,1,34,104
"27817","0600-0659",2022-06-28,67,2,32,99
"27818","0600-0659",2022-06-29,66,3,32,98
"27819","0600-0659",2022-06-30,69,4,35,104
"27820","0700-0759",2022-06-01,80,3,53,133
"27821","0700-0759",2022-06-02,85,4,54,139
"27822","0700-0759",2022-06-03,84,5,52,136
"27823","0700-0759",2022-06-04,85,6,46,131
"27824","0700-0759",2022-06-05,83,7,47,130
"27825","0700-0759",2022-06-06,89,1,53,142
"27826","0700-0759",2022-06-07,85,2,49,134
"27827","0700-0759",2022-06-08,85,3,50,135
"27828","0700-0759",2022-06-09,88,4,54,142
"27829","0700-0759",2022-06-10,90,5,52,142
"27830","0700-0759",2022-06-11,80,6,45,125
"27831","0700-0759",2022-06-12,85,7,49,134
"27832","0700-0759",2022-06-13,90,1,52,142
"27833","0700-0759",2022-06-14,87,2,49,136
"27834","0700-0759",2022-06-15,86,3,50,136
"27835","0700-0759",2022-06-16,87,4,51,138
"27836","0700-0759",2022-06-17,88,5,52,140
"27837","0700-0759",2022-06-18,77,6,47,124
"27838","0700-0759",2022-06-19,83,7,49,132
"27839","0700-0759",2022-06-20,87,1,52,139
"27840","0700-0759",2022-06-21,84,2,48,132
"27841","0700-0759",2022-06-22,83,3,49,132
"27842","0700-0759",2022-06-23,86,4,52,138
"27843","0700-0759",2022-06-24,84,5,54,138
"27844","0700-0759",2022-06-25,75,6,51,126
"27845","0700-0759",2022-06-26,79,7,54,133
"27846","0700-0759",2022-06-27,83,1,56,139
"27847","0700-0759",2022-06-28,81,2,52,133
"27848","0700-0759",2022-06-29,81,3,53,134
"27849","0700-0759",2022-06-30,84,4,56,140
"27850","0800-0859",2022-06-01,95,3,40,135
"27851","0800-0859",2022-06-02,91,4,47,138
"27852","0800-0859",2022-06-03,90,5,45,135
"27853","0800-0859",2022-06-04,80,6,43,123
"27854","0800-0859",2022-06-05,86,7,39,125
"27855","0800-0859",2022-06-06,93,1,41,134
"27856","0800-0859",2022-06-07,90,2,40,130
"27857","0800-0859",2022-06-08,88,3,39,127
"27858","0800-0859",2022-06-09,89,4,41,130
"27859","0800-0859",2022-06-10,91,5,41,132
"27860","0800-0859",2022-06-11,79,6,41,120
"27861","0800-0859",2022-06-12,87,7,40,127
"27862","0800-0859",2022-06-13,91,1,41,132
"27863","0800-0859",2022-06-14,89,2,40,129
"27864","0800-0859",2022-06-15,88,3,39,127
"27865","0800-0859",2022-06-16,87,4,41,128
"27866","0800-0859",2022-06-17,89,5,42,131
"27867","0800-0859",2022-06-18,79,6,40,119
"27868","0800-0859",2022-06-19,86,7,40,126
"27869","0800-0859",2022-06-20,89,1,42,131
"27870","0800-0859",2022-06-21,87,2,41,128
"27871","0800-0859",2022-06-22,89,3,40,129
"27872","0800-0859",2022-06-23,89,4,41,130
"27873","0800-0859",2022-06-24,89,5,41,130
"27874","0800-0859",2022-06-25,80,6,39,119
"27875","0800-0859",2022-06-26,89,7,38,127
"27876","0800-0859",2022-06-27,89,1,41,130
"27877","0800-0859",2022-06-28,87,2,40,127
"27878","0800-0859",2022-06-29,88,3,39,127
"27879","0800-0859",2022-06-30,88,4,41,129
"27880","0900-0959",2022-06-01,63,3,55,118
"27881","0900-0959",2022-06-02,66,4,52,118
"27882","0900-0959",2022-06-03,67,5,58,125
"27883","0900-0959",2022-06-04,56,6,52,108
"27884","0900-0959",2022-06-05,61,7,58,119
"27885","0900-0959",2022-06-06,56,1,63,119
"27886","0900-0959",2022-06-07,56,2,62,118
"27887","0900-0959",2022-06-08,56,3,62,118
"27888","0900-0959",2022-06-09,55,4,66,121
"27889","0900-0959",2022-06-10,55,5,67,122
"27890","0900-0959",2022-06-11,49,6,61,110
"27891","0900-0959",2022-06-12,55,7,65,120
"27892","0900-0959",2022-06-13,56,1,67,123
"27893","0900-0959",2022-06-14,56,2,66,122
"27894","0900-0959",2022-06-15,55,3,66,121
"27895","0900-0959",2022-06-16,57,4,67,124
"27896","0900-0959",2022-06-17,57,5,66,123
"27897","0900-0959",2022-06-18,48,6,62,110
"27898","0900-0959",2022-06-19,57,7,66,123
"27899","0900-0959",2022-06-20,57,1,66,123
"27900","0900-0959",2022-06-21,58,2,66,124
"27901","0900-0959",2022-06-22,56,3,67,123
"27902","0900-0959",2022-06-23,57,4,67,124
"27903","0900-0959",2022-06-24,58,5,65,123
"27904","0900-0959",2022-06-25,51,6,62,113
"27905","0900-0959",2022-06-26,57,7,66,123
"27906","0900-0959",2022-06-27,59,1,65,124
"27907","0900-0959",2022-06-28,62,2,65,127
"27908","0900-0959",2022-06-29,59,3,66,125
"27909","0900-0959",2022-06-30,60,4,65,125
"27910","1000-1059",2022-06-01,71,3,62,133
"27911","1000-1059",2022-06-02,72,4,66,138
"27912","1000-1059",2022-06-03,71,5,58,129
"27913","1000-1059",2022-06-04,61,6,50,111
"27914","1000-1059",2022-06-05,74,7,48,122
"27915","1000-1059",2022-06-06,82,1,46,128
"27916","1000-1059",2022-06-07,79,2,44,123
"27917","1000-1059",2022-06-08,79,3,43,122
"27918","1000-1059",2022-06-09,79,4,44,123
"27919","1000-1059",2022-06-10,79,5,44,123
"27920","1000-1059",2022-06-11,64,6,42,106
"27921","1000-1059",2022-06-12,78,7,41,119
"27922","1000-1059",2022-06-13,79,1,44,123
"27923","1000-1059",2022-06-14,77,2,43,120
"27924","1000-1059",2022-06-15,77,3,41,118
"27925","1000-1059",2022-06-16,81,4,41,122
"27926","1000-1059",2022-06-17,82,5,42,124
"27927","1000-1059",2022-06-18,69,6,39,108
"27928","1000-1059",2022-06-19,82,7,40,122
"27929","1000-1059",2022-06-20,82,1,42,124
"27930","1000-1059",2022-06-21,82,2,41,123
"27931","1000-1059",2022-06-22,82,3,40,122
"27932","1000-1059",2022-06-23,82,4,42,124
"27933","1000-1059",2022-06-24,84,5,42,126
"27934","1000-1059",2022-06-25,73,6,41,114
"27935","1000-1059",2022-06-26,83,7,40,123
"27936","1000-1059",2022-06-27,84,1,42,126
"27937","1000-1059",2022-06-28,81,2,41,122
"27938","1000-1059",2022-06-29,82,3,40,122
"27939","1000-1059",2022-06-30,82,4,42,124
"27940","1100-1159",2022-06-01,54,3,63,117
"27941","1100-1159",2022-06-02,57,4,61,118
"27942","1100-1159",2022-06-03,53,5,63,116
"27943","1100-1159",2022-06-04,52,6,54,106
"27944","1100-1159",2022-06-05,53,7,65,118
"27945","1100-1159",2022-06-06,50,1,66,116
"27946","1100-1159",2022-06-07,50,2,62,112
"27947","1100-1159",2022-06-08,51,3,64,115
"27948","1100-1159",2022-06-09,53,4,60,113
"27949","1100-1159",2022-06-10,52,5,64,116
"27950","1100-1159",2022-06-11,48,6,52,100
"27951","1100-1159",2022-06-12,53,7,63,116
"27952","1100-1159",2022-06-13,52,1,64,116
"27953","1100-1159",2022-06-14,52,2,60,112
"27954","1100-1159",2022-06-15,52,3,62,114
"27955","1100-1159",2022-06-16,51,4,62,113
"27956","1100-1159",2022-06-17,51,5,64,115
"27957","1100-1159",2022-06-18,47,6,53,100
"27958","1100-1159",2022-06-19,51,7,64,115
"27959","1100-1159",2022-06-20,51,1,65,116
"27960","1100-1159",2022-06-21,51,2,61,112
"27961","1100-1159",2022-06-22,51,3,64,115
"27962","1100-1159",2022-06-23,52,4,62,114
"27963","1100-1159",2022-06-24,52,5,66,118
"27964","1100-1159",2022-06-25,46,6,55,101
"27965","1100-1159",2022-06-26,52,7,65,117
"27966","1100-1159",2022-06-27,51,1,67,118
"27967","1100-1159",2022-06-28,50,2,62,112
"27968","1100-1159",2022-06-29,50,3,64,114
"27969","1100-1159",2022-06-30,52,4,63,115
"27970","1200-1259",2022-06-01,64,3,60,124
"27971","1200-1259",2022-06-02,62,4,61,123
"27972","1200-1259",2022-06-03,65,5,58,123
"27973","1200-1259",2022-06-04,54,6,55,109
"27974","1200-1259",2022-06-05,60,7,61,121
"27975","1200-1259",2022-06-06,65,1,62,127
"27976","1200-1259",2022-06-07,62,2,60,122
"27977","1200-1259",2022-06-08,63,3,58,121
"27978","1200-1259",2022-06-09,62,4,62,124
"27979","1200-1259",2022-06-10,63,5,61,124
"27980","1200-1259",2022-06-11,59,6,49,108
"27981","1200-1259",2022-06-12,61,7,60,121
"27982","1200-1259",2022-06-13,64,1,61,125
"27983","1200-1259",2022-06-14,61,2,60,121
"27984","1200-1259",2022-06-15,62,3,58,120
"27985","1200-1259",2022-06-16,67,4,62,129
"27986","1200-1259",2022-06-17,67,5,62,129
"27987","1200-1259",2022-06-18,62,6,50,112
"27988","1200-1259",2022-06-19,65,7,61,126
"27989","1200-1259",2022-06-20,67,1,60,127
"27990","1200-1259",2022-06-21,64,2,60,124
"27991","1200-1259",2022-06-22,65,3,58,123
"27992","1200-1259",2022-06-23,66,4,62,128
"27993","1200-1259",2022-06-24,64,5,61,125
"27994","1200-1259",2022-06-25,60,6,50,110
"27995","1200-1259",2022-06-26,62,7,61,123
"27996","1200-1259",2022-06-27,64,1,61,125
"27997","1200-1259",2022-06-28,61,2,61,122
"27998","1200-1259",2022-06-29,62,3,59,121
"27999","1200-1259",2022-06-30,64,4,63,127
"28000","1300-1359",2022-06-01,75,3,61,136
"28001","1300-1359",2022-06-02,74,4,57,131
"28002","1300-1359",2022-06-03,76,5,60,136
"28003","1300-1359",2022-06-04,61,6,56,117
"28004","1300-1359",2022-06-05,73,7,62,135
"28005","1300-1359",2022-06-06,73,1,60,133
"28006","1300-1359",2022-06-07,69,2,59,128
"28007","1300-1359",2022-06-08,73,3,61,134
"28008","1300-1359",2022-06-09,70,4,60,130
"28009","1300-1359",2022-06-10,72,5,61,133
"28010","1300-1359",2022-06-11,55,6,55,110
"28011","1300-1359",2022-06-12,70,7,58,128
"28012","1300-1359",2022-06-13,71,1,61,132
"28013","1300-1359",2022-06-14,68,2,60,128
"28014","1300-1359",2022-06-15,70,3,62,132
"28015","1300-1359",2022-06-16,66,4,63,129
"28016","1300-1359",2022-06-17,67,5,63,130
"28017","1300-1359",2022-06-18,49,6,55,104
"28018","1300-1359",2022-06-19,66,7,61,127
"28019","1300-1359",2022-06-20,66,1,64,130
"28020","1300-1359",2022-06-21,62,2,61,123
"28021","1300-1359",2022-06-22,65,3,63,128
"28022","1300-1359",2022-06-23,66,4,62,128
"28023","1300-1359",2022-06-24,69,5,65,134
"28024","1300-1359",2022-06-25,51,6,58,109
"28025","1300-1359",2022-06-26,68,7,61,129
"28026","1300-1359",2022-06-27,70,1,64,134
"28027","1300-1359",2022-06-28,65,2,62,127
"28028","1300-1359",2022-06-29,68,3,64,132
"28029","1300-1359",2022-06-30,68,4,65,133
"28030","1400-1459",2022-06-01,48,3,48,96
"28031","1400-1459",2022-06-02,50,4,54,104
"28032","1400-1459",2022-06-03,49,5,56,105
"28033","1400-1459",2022-06-04,44,6,46,90
"28034","1400-1459",2022-06-05,47,7,57,104
"28035","1400-1459",2022-06-06,45,1,66,111
"28036","1400-1459",2022-06-07,43,2,60,103
"28037","1400-1459",2022-06-08,43,3,62,105
"28038","1400-1459",2022-06-09,47,4,64,111
"28039","1400-1459",2022-06-10,46,5,64,110
"28040","1400-1459",2022-06-11,43,6,54,97
"28041","1400-1459",2022-06-12,46,7,64,110
"28042","1400-1459",2022-06-13,47,1,64,111
"28043","1400-1459",2022-06-14,44,2,61,105
"28044","1400-1459",2022-06-15,46,3,60,106
"28045","1400-1459",2022-06-16,52,4,62,114
"28046","1400-1459",2022-06-17,51,5,65,116
"28047","1400-1459",2022-06-18,47,6,56,103
"28048","1400-1459",2022-06-19,50,7,61,111
"28049","1400-1459",2022-06-20,51,1,65,116
"28050","1400-1459",2022-06-21,47,2,63,110
"28051","1400-1459",2022-06-22,50,3,63,113
"28052","1400-1459",2022-06-23,52,4,63,115
"28053","1400-1459",2022-06-24,54,5,64,118
"28054","1400-1459",2022-06-25,51,6,54,105
"28055","1400-1459",2022-06-26,51,7,64,115
"28056","1400-1459",2022-06-27,53,1,65,118
"28057","1400-1459",2022-06-28,49,2,63,112
"28058","1400-1459",2022-06-29,52,3,64,116
"28059","1400-1459",2022-06-30,55,4,63,118
"28060","1500-1559",2022-06-01,53,3,58,111
"28061","1500-1559",2022-06-02,60,4,58,118
"28062","1500-1559",2022-06-03,62,5,68,130
"28063","1500-1559",2022-06-04,45,6,58,103
"28064","1500-1559",2022-06-05,61,7,62,123
"28065","1500-1559",2022-06-06,65,1,57,122
"28066","1500-1559",2022-06-07,60,2,58,118
"28067","1500-1559",2022-06-08,60,3,58,118
"28068","1500-1559",2022-06-09,63,4,58,121
"28069","1500-1559",2022-06-10,65,5,59,124
"28070","1500-1559",2022-06-11,52,6,49,101
"28071","1500-1559",2022-06-12,62,7,59,121
"28072","1500-1559",2022-06-13,64,1,60,124
"28073","1500-1559",2022-06-14,60,2,59,119
"28074","1500-1559",2022-06-15,59,3,60,119
"28075","1500-1559",2022-06-16,60,4,59,119
"28076","1500-1559",2022-06-17,62,5,58,120
"28077","1500-1559",2022-06-18,52,6,47,99
"28078","1500-1559",2022-06-19,60,7,60,120
"28079","1500-1559",2022-06-20,62,1,57,119
"28080","1500-1559",2022-06-21,58,2,55,113
"28081","1500-1559",2022-06-22,57,3,56,113
"28082","1500-1559",2022-06-23,60,4,59,119
"28083","1500-1559",2022-06-24,59,5,57,116
"28084","1500-1559",2022-06-25,48,6,49,97
"28085","1500-1559",2022-06-26,59,7,57,116
"28086","1500-1559",2022-06-27,59,1,57,116
"28087","1500-1559",2022-06-28,55,2,54,109
"28088","1500-1559",2022-06-29,55,3,54,109
"28089","1500-1559",2022-06-30,57,4,58,115
"28090","1600-1659",2022-06-01,55,3,61,116
"28091","1600-1659",2022-06-02,58,4,64,122
"28092","1600-1659",2022-06-03,67,5,57,124
"28093","1600-1659",2022-06-04,57,6,53,110
"28094","1600-1659",2022-06-05,65,7,56,121
"28095","1600-1659",2022-06-06,66,1,59,125
"28096","1600-1659",2022-06-07,58,2,58,116
"28097","1600-1659",2022-06-08,60,3,57,117
"28098","1600-1659",2022-06-09,66,4,60,126
"28099","1600-1659",2022-06-10,66,5,60,126
"28100","1600-1659",2022-06-11,55,6,52,107
"28101","1600-1659",2022-06-12,66,7,59,125
"28102","1600-1659",2022-06-13,67,1,59,126
"28103","1600-1659",2022-06-14,60,2,59,119
"28104","1600-1659",2022-06-15,62,3,57,119
"28105","1600-1659",2022-06-16,66,4,61,127
"28106","1600-1659",2022-06-17,66,5,60,126
"28107","1600-1659",2022-06-18,56,6,51,107
"28108","1600-1659",2022-06-19,67,7,60,127
"28109","1600-1659",2022-06-20,66,1,61,127
"28110","1600-1659",2022-06-21,58,2,60,118
"28111","1600-1659",2022-06-22,60,3,58,118
"28112","1600-1659",2022-06-23,65,4,62,127
"28113","1600-1659",2022-06-24,65,5,62,127
"28114","1600-1659",2022-06-25,56,6,52,108
"28115","1600-1659",2022-06-26,66,7,62,128
"28116","1600-1659",2022-06-27,67,1,62,129
"28117","1600-1659",2022-06-28,59,2,62,121
"28118","1600-1659",2022-06-29,60,3,59,119
"28119","1600-1659",2022-06-30,67,4,63,130
"28120","1700-1759",2022-06-01,56,3,63,119
"28121","1700-1759",2022-06-02,65,4,66,131
"28122","1700-1759",2022-06-03,67,5,63,130
"28123","1700-1759",2022-06-04,53,6,47,100
"28124","1700-1759",2022-06-05,66,7,61,127
"28125","1700-1759",2022-06-06,66,1,58,124
"28126","1700-1759",2022-06-07,59,2,53,112
"28127","1700-1759",2022-06-08,58,3,52,110
"28128","1700-1759",2022-06-09,66,4,57,123
"28129","1700-1759",2022-06-10,67,5,57,124
"28130","1700-1759",2022-06-11,49,6,46,95
"28131","1700-1759",2022-06-12,65,7,56,121
"28132","1700-1759",2022-06-13,66,1,57,123
"28133","1700-1759",2022-06-14,60,2,52,112
"28134","1700-1759",2022-06-15,58,3,51,109
"28135","1700-1759",2022-06-16,66,4,58,124
"28136","1700-1759",2022-06-17,66,5,60,126
"28137","1700-1759",2022-06-18,50,6,49,99
"28138","1700-1759",2022-06-19,66,7,57,123
"28139","1700-1759",2022-06-20,67,1,59,126
"28140","1700-1759",2022-06-21,62,2,53,115
"28141","1700-1759",2022-06-22,62,3,53,115
"28142","1700-1759",2022-06-23,66,4,59,125
"28143","1700-1759",2022-06-24,66,5,56,122
"28144","1700-1759",2022-06-25,49,6,46,95
"28145","1700-1759",2022-06-26,66,7,55,121
"28146","1700-1759",2022-06-27,65,1,56,121
"28147","1700-1759",2022-06-28,62,2,49,111
"28148","1700-1759",2022-06-29,62,3,50,112
"28149","1700-1759",2022-06-30,65,4,56,121
"28150","1800-1859",2022-06-01,59,3,62,121
"28151","1800-1859",2022-06-02,69,4,67,136
"28152","1800-1859",2022-06-03,75,5,68,143
"28153","1800-1859",2022-06-04,55,6,54,109
"28154","1800-1859",2022-06-05,65,7,67,132
"28155","1800-1859",2022-06-06,66,1,78,144
"28156","1800-1859",2022-06-07,61,2,73,134
"28157","1800-1859",2022-06-08,61,3,77,138
"28158","1800-1859",2022-06-09,67,4,81,148
"28159","1800-1859",2022-06-10,66,5,80,146
"28160","1800-1859",2022-06-11,57,6,66,123
"28161","1800-1859",2022-06-12,66,7,79,145
"28162","1800-1859",2022-06-13,65,1,80,145
"28163","1800-1859",2022-06-14,60,2,75,135
"28164","1800-1859",2022-06-15,57,3,77,134
"28165","1800-1859",2022-06-16,67,4,81,148
"28166","1800-1859",2022-06-17,67,5,80,147
"28167","1800-1859",2022-06-18,58,6,69,127
"28168","1800-1859",2022-06-19,66,7,82,148
"28169","1800-1859",2022-06-20,66,1,81,147
"28170","1800-1859",2022-06-21,61,2,75,136
"28171","1800-1859",2022-06-22,61,3,78,139
"28172","1800-1859",2022-06-23,69,4,81,150
"28173","1800-1859",2022-06-24,68,5,82,150
"28174","1800-1859",2022-06-25,61,6,73,134
"28175","1800-1859",2022-06-26,71,7,84,155
"28176","1800-1859",2022-06-27,69,1,82,151
"28177","1800-1859",2022-06-28,63,2,77,140
"28178","1800-1859",2022-06-29,63,3,80,143
"28179","1800-1859",2022-06-30,71,4,82,153
"28180","1900-1959",2022-06-01,54,3,57,111
"28181","1900-1959",2022-06-02,61,4,63,124
"28182","1900-1959",2022-06-03,61,5,73,134
"28183","1900-1959",2022-06-04,49,6,68,117
"28184","1900-1959",2022-06-05,67,7,64,131
"28185","1900-1959",2022-06-06,64,1,56,120
"28186","1900-1959",2022-06-07,58,2,51,109
"28187","1900-1959",2022-06-08,58,3,52,110
"28188","1900-1959",2022-06-09,69,4,57,126
"28189","1900-1959",2022-06-10,70,5,60,130
"28190","1900-1959",2022-06-11,61,6,54,115
"28191","1900-1959",2022-06-12,70,7,57,127
"28192","1900-1959",2022-06-13,70,1,58,128
"28193","1900-1959",2022-06-14,61,2,53,114
"28194","1900-1959",2022-06-15,64,3,54,118
"28195","1900-1959",2022-06-16,69,4,59,128
"28196","1900-1959",2022-06-17,68,5,58,126
"28197","1900-1959",2022-06-18,60,6,53,113
"28198","1900-1959",2022-06-19,70,7,59,129
"28199","1900-1959",2022-06-20,68,1,57,125
"28200","1900-1959",2022-06-21,62,2,52,114
"28201","1900-1959",2022-06-22,62,3,54,116
"28202","1900-1959",2022-06-23,68,4,58,126
"28203","1900-1959",2022-06-24,69,5,54,123
"28204","1900-1959",2022-06-25,62,6,48,110
"28205","1900-1959",2022-06-26,70,7,55,125
"28206","1900-1959",2022-06-27,69,1,55,124
"28207","1900-1959",2022-06-28,63,2,49,112
"28208","1900-1959",2022-06-29,62,3,51,113
"28209","1900-1959",2022-06-30,69,4,56,125
"28210","2000-2059",2022-06-01,35,3,75,110
"28211","2000-2059",2022-06-02,38,4,78,116
"28212","2000-2059",2022-06-03,43,5,78,121
"28213","2000-2059",2022-06-04,33,6,59,92
"28214","2000-2059",2022-06-05,41,7,74,115
"28215","2000-2059",2022-06-06,44,1,77,121
"28216","2000-2059",2022-06-07,41,2,69,110
"28217","2000-2059",2022-06-08,46,3,70,116
"28218","2000-2059",2022-06-09,45,4,76,121
"28219","2000-2059",2022-06-10,44,5,76,120
"28220","2000-2059",2022-06-11,43,6,68,111
"28221","2000-2059",2022-06-12,46,7,76,122
"28222","2000-2059",2022-06-13,45,1,76,121
"28223","2000-2059",2022-06-14,41,2,69,110
"28224","2000-2059",2022-06-15,44,3,68,112
"28225","2000-2059",2022-06-16,51,4,71,122
"28226","2000-2059",2022-06-17,48,5,72,120
"28227","2000-2059",2022-06-18,46,6,66,112
"28228","2000-2059",2022-06-19,51,7,71,122
"28229","2000-2059",2022-06-20,47,1,73,120
"28230","2000-2059",2022-06-21,43,2,69,112
"28231","2000-2059",2022-06-22,48,3,71,119
"28232","2000-2059",2022-06-23,50,4,72,122
"28233","2000-2059",2022-06-24,48,5,76,124
"28234","2000-2059",2022-06-25,45,6,69,114
"28235","2000-2059",2022-06-26,48,7,74,122
"28236","2000-2059",2022-06-27,48,1,75,123
"28237","2000-2059",2022-06-28,41,2,72,113
"28238","2000-2059",2022-06-29,46,3,73,119
"28239","2000-2059",2022-06-30,48,4,73,121
"28240","2100-2159",2022-06-01,43,3,60,103
"28241","2100-2159",2022-06-02,49,4,70,119
"28242","2100-2159",2022-06-03,43,5,78,121
"28243","2100-2159",2022-06-04,35,6,66,101
"28244","2100-2159",2022-06-05,51,7,81,132
"28245","2100-2159",2022-06-06,44,1,83,127
"28246","2100-2159",2022-06-07,40,2,74,114
"28247","2100-2159",2022-06-08,41,3,77,118
"28248","2100-2159",2022-06-09,47,4,85,132
"28249","2100-2159",2022-06-10,43,5,85,128
"28250","2100-2159",2022-06-11,31,6,73,104
"28251","2100-2159",2022-06-12,47,7,85,132
"28252","2100-2159",2022-06-13,44,1,86,130
"28253","2100-2159",2022-06-14,41,2,75,116
"28254","2100-2159",2022-06-15,41,3,77,118
"28255","2100-2159",2022-06-16,42,4,85,127
"28256","2100-2159",2022-06-17,41,5,86,127
"28257","2100-2159",2022-06-18,27,6,75,102
"28258","2100-2159",2022-06-19,42,7,85,127
"28259","2100-2159",2022-06-20,42,1,85,127
"28260","2100-2159",2022-06-21,37,2,77,114
"28261","2100-2159",2022-06-22,38,3,78,116
"28262","2100-2159",2022-06-23,42,4,84,126
"28263","2100-2159",2022-06-24,43,5,86,129
"28264","2100-2159",2022-06-25,29,6,73,102
"28265","2100-2159",2022-06-26,44,7,85,129
"28266","2100-2159",2022-06-27,42,1,86,128
"28267","2100-2159",2022-06-28,38,2,78,116
"28268","2100-2159",2022-06-29,39,3,79,118
"28269","2100-2159",2022-06-30,44,4,86,130
"28270","2200-2259",2022-06-01,40,3,56,96
"28271","2200-2259",2022-06-02,49,4,64,113
"28272","2200-2259",2022-06-03,58,5,58,116
"28273","2200-2259",2022-06-04,43,6,40,83
"28274","2200-2259",2022-06-05,56,7,63,119
"28275","2200-2259",2022-06-06,53,1,62,115
"28276","2200-2259",2022-06-07,47,2,58,105
"28277","2200-2259",2022-06-08,49,3,57,106
"28278","2200-2259",2022-06-09,51,4,62,113
"28279","2200-2259",2022-06-10,50,5,60,110
"28280","2200-2259",2022-06-11,46,6,48,94
"28281","2200-2259",2022-06-12,50,7,62,112
"28282","2200-2259",2022-06-13,51,1,59,110
"28283","2200-2259",2022-06-14,46,2,56,102
"28284","2200-2259",2022-06-15,50,3,59,109
"28285","2200-2259",2022-06-16,50,4,65,115
"28286","2200-2259",2022-06-17,51,5,62,113
"28287","2200-2259",2022-06-18,46,6,48,94
"28288","2200-2259",2022-06-19,49,7,64,113
"28289","2200-2259",2022-06-20,49,1,62,111
"28290","2200-2259",2022-06-21,45,2,57,102
"28291","2200-2259",2022-06-22,49,3,59,108
"28292","2200-2259",2022-06-23,50,4,65,115
"28293","2200-2259",2022-06-24,52,5,67,119
"28294","2200-2259",2022-06-25,45,6,53,98
"28295","2200-2259",2022-06-26,50,7,66,116
"28296","2200-2259",2022-06-27,50,1,67,117
"28297","2200-2259",2022-06-28,46,2,58,104
"28298","2200-2259",2022-06-29,50,3,59,109
"28299","2200-2259",2022-06-30,51,4,66,117
"28300","2300-2359",2022-06-01,21,3,55,76
"28301","2300-2359",2022-06-02,20,4,61,81
"28302","2300-2359",2022-06-03,21,5,65,86
"28303","2300-2359",2022-06-04,20,6,56,76
"28304","2300-2359",2022-06-05,20,7,64,84
"28305","2300-2359",2022-06-06,20,1,62,82
"28306","2300-2359",2022-06-07,18,2,60,78
"28307","2300-2359",2022-06-08,18,3,62,80
"28308","2300-2359",2022-06-09,21,4,61,82
"28309","2300-2359",2022-06-10,21,5,59,80
"28310","2300-2359",2022-06-11,21,6,55,76
"28311","2300-2359",2022-06-12,22,7,61,83
"28312","2300-2359",2022-06-13,21,1,62,83
"28313","2300-2359",2022-06-14,18,2,59,77
"28314","2300-2359",2022-06-15,18,3,58,76
"28315","2300-2359",2022-06-16,21,4,57,78
"28316","2300-2359",2022-06-17,21,5,57,78
"28317","2300-2359",2022-06-18,21,6,51,72
"28318","2300-2359",2022-06-19,21,7,57,78
"28319","2300-2359",2022-06-20,21,1,56,77
"28320","2300-2359",2022-06-21,18,2,53,71
"28321","2300-2359",2022-06-22,18,3,54,72
"28322","2300-2359",2022-06-23,22,4,55,77
"28323","2300-2359",2022-06-24,23,5,53,76
"28324","2300-2359",2022-06-25,22,6,48,70
"28325","2300-2359",2022-06-26,24,7,55,79
"28326","2300-2359",2022-06-27,24,1,52,76
"28327","2300-2359",2022-06-28,21,2,50,71
"28328","2300-2359",2022-06-29,21,3,52,73
"28329","2300-2359",2022-06-30,24,4,55,79
"28330","0001-0559",2022-07-01,32,5,62,94
"28331","0001-0559",2022-07-02,20,6,41,61
"28332","0001-0559",2022-07-03,25,7,49,74
"28333","0001-0559",2022-07-04,25,1,50,75
"28334","0001-0559",2022-07-05,27,2,54,81
"28335","0001-0559",2022-07-06,27,3,52,79
"28336","0001-0559",2022-07-07,27,4,54,81
"28337","0001-0559",2022-07-08,27,5,53,80
"28338","0001-0559",2022-07-09,18,6,42,60
"28339","0001-0559",2022-07-10,24,7,60,84
"28340","0001-0559",2022-07-11,26,1,56,82
"28341","0001-0559",2022-07-12,26,2,49,75
"28342","0001-0559",2022-07-13,26,3,52,78
"28343","0001-0559",2022-07-14,26,4,57,83
"28344","0001-0559",2022-07-15,26,5,56,82
"28345","0001-0559",2022-07-16,17,6,38,55
"28346","0001-0559",2022-07-17,23,7,56,79
"28347","0001-0559",2022-07-18,27,1,55,82
"28348","0001-0559",2022-07-19,26,2,48,74
"28349","0001-0559",2022-07-20,26,3,51,77
"28350","0001-0559",2022-07-21,26,4,56,82
"28351","0001-0559",2022-07-22,26,5,55,81
"28352","0001-0559",2022-07-23,17,6,38,55
"28353","0001-0559",2022-07-24,23,7,56,79
"28354","0001-0559",2022-07-25,26,1,55,81
"28355","0001-0559",2022-07-26,26,2,48,74
"28356","0001-0559",2022-07-27,26,3,51,77
"28357","0001-0559",2022-07-28,26,4,56,82
"28358","0001-0559",2022-07-29,26,5,55,81
"28359","0001-0559",2022-07-30,17,6,38,55
"28360","0001-0559",2022-07-31,23,7,56,79
"28361","0600-0659",2022-07-01,66,5,37,103
"28362","0600-0659",2022-07-02,67,6,32,99
"28363","0600-0659",2022-07-03,66,7,27,93
"28364","0600-0659",2022-07-04,62,1,29,91
"28365","0600-0659",2022-07-05,63,2,31,94
"28366","0600-0659",2022-07-06,63,3,31,94
"28367","0600-0659",2022-07-07,66,4,32,98
"28368","0600-0659",2022-07-08,67,5,33,100
"28369","0600-0659",2022-07-09,65,6,31,96
"28370","0600-0659",2022-07-10,67,7,32,99
"28371","0600-0659",2022-07-11,71,1,34,105
"28372","0600-0659",2022-07-12,67,2,32,99
"28373","0600-0659",2022-07-13,67,3,35,102
"28374","0600-0659",2022-07-14,70,4,35,105
"28375","0600-0659",2022-07-15,71,5,36,107
"28376","0600-0659",2022-07-16,69,6,34,103
"28377","0600-0659",2022-07-17,68,7,33,101
"28378","0600-0659",2022-07-18,71,1,34,105
"28379","0600-0659",2022-07-19,67,2,32,99
"28380","0600-0659",2022-07-20,67,3,35,102
"28381","0600-0659",2022-07-21,70,4,35,105
"28382","0600-0659",2022-07-22,71,5,36,107
"28383","0600-0659",2022-07-23,69,6,35,104
"28384","0600-0659",2022-07-24,68,7,33,101
"28385","0600-0659",2022-07-25,71,1,34,105
"28386","0600-0659",2022-07-26,67,2,32,99
"28387","0600-0659",2022-07-27,67,3,35,102
"28388","0600-0659",2022-07-28,70,4,35,105
"28389","0600-0659",2022-07-29,71,5,36,107
"28390","0600-0659",2022-07-30,68,6,34,102
"28391","0600-0659",2022-07-31,68,7,34,102
"28392","0700-0759",2022-07-01,85,5,54,139
"28393","0700-0759",2022-07-02,76,6,46,122
"28394","0700-0759",2022-07-03,81,7,52,133
"28395","0700-0759",2022-07-04,87,1,51,138
"28396","0700-0759",2022-07-05,82,2,52,134
"28397","0700-0759",2022-07-06,82,3,53,135
"28398","0700-0759",2022-07-07,89,4,54,143
"28399","0700-0759",2022-07-08,89,5,55,144
"28400","0700-0759",2022-07-09,74,6,45,119
"28401","0700-0759",2022-07-10,82,7,55,137
"28402","0700-0759",2022-07-11,90,1,57,147
"28403","0700-0759",2022-07-12,82,2,54,136
"28404","0700-0759",2022-07-13,81,3,54,135
"28405","0700-0759",2022-07-14,88,4,56,144
"28406","0700-0759",2022-07-15,90,5,56,146
"28407","0700-0759",2022-07-16,74,6,46,120
"28408","0700-0759",2022-07-17,83,7,55,138
"28409","0700-0759",2022-07-18,90,1,57,147
"28410","0700-0759",2022-07-19,82,2,54,136
"28411","0700-0759",2022-07-20,82,3,54,136
"28412","0700-0759",2022-07-21,88,4,56,144
"28413","0700-0759",2022-07-22,90,5,56,146
"28414","0700-0759",2022-07-23,74,6,45,119
"28415","0700-0759",2022-07-24,83,7,55,138
"28416","0700-0759",2022-07-25,90,1,57,147
"28417","0700-0759",2022-07-26,82,2,54,136
"28418","0700-0759",2022-07-27,82,3,54,136
"28419","0700-0759",2022-07-28,88,4,56,144
"28420","0700-0759",2022-07-29,90,5,56,146
"28421","0700-0759",2022-07-30,74,6,45,119
"28422","0700-0759",2022-07-31,83,7,54,137
"28423","0800-0859",2022-07-01,90,5,43,133
"28424","0800-0859",2022-07-02,83,6,40,123
"28425","0800-0859",2022-07-03,90,7,42,132
"28426","0800-0859",2022-07-04,91,1,40,131
"28427","0800-0859",2022-07-05,91,2,39,130
"28428","0800-0859",2022-07-06,92,3,40,132
"28429","0800-0859",2022-07-07,93,4,43,136
"28430","0800-0859",2022-07-08,95,5,43,138
"28431","0800-0859",2022-07-09,84,6,40,124
"28432","0800-0859",2022-07-10,95,7,38,133
"28433","0800-0859",2022-07-11,93,1,44,137
"28434","0800-0859",2022-07-12,91,2,42,133
"28435","0800-0859",2022-07-13,91,3,40,131
"28436","0800-0859",2022-07-14,94,4,44,138
"28437","0800-0859",2022-07-15,92,5,44,136
"28438","0800-0859",2022-07-16,84,6,40,124
"28439","0800-0859",2022-07-17,93,7,39,132
"28440","0800-0859",2022-07-18,94,1,45,139
"28441","0800-0859",2022-07-19,90,2,42,132
"28442","0800-0859",2022-07-20,91,3,40,131
"28443","0800-0859",2022-07-21,93,4,44,137
"28444","0800-0859",2022-07-22,94,5,44,138
"28445","0800-0859",2022-07-23,82,6,40,122
"28446","0800-0859",2022-07-24,94,7,39,133
"28447","0800-0859",2022-07-25,93,1,44,137
"28448","0800-0859",2022-07-26,91,2,42,133
"28449","0800-0859",2022-07-27,91,3,40,131
"28450","0800-0859",2022-07-28,94,4,44,138
"28451","0800-0859",2022-07-29,92,5,44,136
"28452","0800-0859",2022-07-30,84,6,40,124
"28453","0800-0859",2022-07-31,93,7,39,132
"28454","0900-0959",2022-07-01,56,5,67,123
"28455","0900-0959",2022-07-02,47,6,62,109
"28456","0900-0959",2022-07-03,53,7,60,113
"28457","0900-0959",2022-07-04,54,1,66,120
"28458","0900-0959",2022-07-05,55,2,66,121
"28459","0900-0959",2022-07-06,53,3,65,118
"28460","0900-0959",2022-07-07,55,4,67,122
"28461","0900-0959",2022-07-08,54,5,68,122
"28462","0900-0959",2022-07-09,50,6,62,112
"28463","0900-0959",2022-07-10,52,7,66,118
"28464","0900-0959",2022-07-11,53,1,68,121
"28465","0900-0959",2022-07-12,53,2,64,117
"28466","0900-0959",2022-07-13,52,3,65,117
"28467","0900-0959",2022-07-14,56,4,67,123
"28468","0900-0959",2022-07-15,54,5,68,122
"28469","0900-0959",2022-07-16,50,6,62,112
"28470","0900-0959",2022-07-17,53,7,66,119
"28471","0900-0959",2022-07-18,54,1,68,122
"28472","0900-0959",2022-07-19,54,2,64,118
"28473","0900-0959",2022-07-20,53,3,64,117
"28474","0900-0959",2022-07-21,56,4,67,123
"28475","0900-0959",2022-07-22,54,5,68,122
"28476","0900-0959",2022-07-23,50,6,62,112
"28477","0900-0959",2022-07-24,53,7,66,119
"28478","0900-0959",2022-07-25,54,1,68,122
"28479","0900-0959",2022-07-26,54,2,64,118
"28480","0900-0959",2022-07-27,53,3,65,118
"28481","0900-0959",2022-07-28,56,4,67,123
"28482","0900-0959",2022-07-29,54,5,68,122
"28483","0900-0959",2022-07-30,49,6,62,111
"28484","0900-0959",2022-07-31,53,7,66,119
"28485","1000-1059",2022-07-01,83,5,38,121
"28486","1000-1059",2022-07-02,73,6,42,115
"28487","1000-1059",2022-07-03,78,7,38,116
"28488","1000-1059",2022-07-04,82,1,39,121
"28489","1000-1059",2022-07-05,83,2,41,124
"28490","1000-1059",2022-07-06,84,3,41,125
"28491","1000-1059",2022-07-07,84,4,42,126
"28492","1000-1059",2022-07-08,84,5,42,126
"28493","1000-1059",2022-07-09,74,6,42,116
"28494","1000-1059",2022-07-10,83,7,41,124
"28495","1000-1059",2022-07-11,87,1,42,129
"28496","1000-1059",2022-07-12,85,2,41,126
"28497","1000-1059",2022-07-13,86,3,41,127
"28498","1000-1059",2022-07-14,85,4,41,126
"28499","1000-1059",2022-07-15,87,5,42,129
"28500","1000-1059",2022-07-16,77,6,42,119
"28501","1000-1059",2022-07-17,85,7,40,125
"28502","1000-1059",2022-07-18,87,1,42,129
"28503","1000-1059",2022-07-19,85,2,41,126
"28504","1000-1059",2022-07-20,85,3,41,126
"28505","1000-1059",2022-07-21,86,4,41,127
"28506","1000-1059",2022-07-22,87,5,42,129
"28507","1000-1059",2022-07-23,77,6,42,119
"28508","1000-1059",2022-07-24,85,7,40,125
"28509","1000-1059",2022-07-25,87,1,42,129
"28510","1000-1059",2022-07-26,85,2,41,126
"28511","1000-1059",2022-07-27,86,3,41,127
"28512","1000-1059",2022-07-28,86,4,41,127
"28513","1000-1059",2022-07-29,87,5,43,130
"28514","1000-1059",2022-07-30,77,6,41,118
"28515","1000-1059",2022-07-31,85,7,40,125
"28516","1100-1159",2022-07-01,51,5,65,116
"28517","1100-1159",2022-07-02,47,6,54,101
"28518","1100-1159",2022-07-03,51,7,64,115
"28519","1100-1159",2022-07-04,52,1,67,119
"28520","1100-1159",2022-07-05,52,2,65,117
"28521","1100-1159",2022-07-06,52,3,69,121
"28522","1100-1159",2022-07-07,54,4,67,121
"28523","1100-1159",2022-07-08,54,5,70,124
"28524","1100-1159",2022-07-09,46,6,55,101
"28525","1100-1159",2022-07-10,54,7,66,120
"28526","1100-1159",2022-07-11,53,1,69,122
"28527","1100-1159",2022-07-12,52,2,66,118
"28528","1100-1159",2022-07-13,51,3,68,119
"28529","1100-1159",2022-07-14,53,4,69,122
"28530","1100-1159",2022-07-15,53,5,69,122
"28531","1100-1159",2022-07-16,45,6,56,101
"28532","1100-1159",2022-07-17,53,7,67,120
"28533","1100-1159",2022-07-18,52,1,70,122
"28534","1100-1159",2022-07-19,51,2,65,116
"28535","1100-1159",2022-07-20,51,3,69,120
"28536","1100-1159",2022-07-21,53,4,68,121
"28537","1100-1159",2022-07-22,52,5,70,122
"28538","1100-1159",2022-07-23,45,6,55,100
"28539","1100-1159",2022-07-24,53,7,68,121
"28540","1100-1159",2022-07-25,52,1,69,121
"28541","1100-1159",2022-07-26,51,2,66,117
"28542","1100-1159",2022-07-27,51,3,68,119
"28543","1100-1159",2022-07-28,53,4,69,122
"28544","1100-1159",2022-07-29,53,5,69,122
"28545","1100-1159",2022-07-30,45,6,56,101
"28546","1100-1159",2022-07-31,53,7,67,120
"28547","1200-1259",2022-07-01,64,5,61,125
"28548","1200-1259",2022-07-02,57,6,50,107
"28549","1200-1259",2022-07-03,60,7,55,115
"28550","1200-1259",2022-07-04,60,1,60,120
"28551","1200-1259",2022-07-05,56,2,61,117
"28552","1200-1259",2022-07-06,59,3,56,115
"28553","1200-1259",2022-07-07,62,4,62,124
"28554","1200-1259",2022-07-08,62,5,59,121
"28555","1200-1259",2022-07-09,57,6,51,108
"28556","1200-1259",2022-07-10,60,7,62,122
"28557","1200-1259",2022-07-11,62,1,60,122
"28558","1200-1259",2022-07-12,56,2,60,116
"28559","1200-1259",2022-07-13,60,3,57,117
"28560","1200-1259",2022-07-14,62,4,61,123
"28561","1200-1259",2022-07-15,62,5,59,121
"28562","1200-1259",2022-07-16,58,6,51,109
"28563","1200-1259",2022-07-17,59,7,60,119
"28564","1200-1259",2022-07-18,63,1,59,122
"28565","1200-1259",2022-07-19,56,2,59,115
"28566","1200-1259",2022-07-20,60,3,58,118
"28567","1200-1259",2022-07-21,62,4,61,123
"28568","1200-1259",2022-07-22,62,5,59,121
"28569","1200-1259",2022-07-23,58,6,51,109
"28570","1200-1259",2022-07-24,59,7,60,119
"28571","1200-1259",2022-07-25,62,1,59,121
"28572","1200-1259",2022-07-26,56,2,59,115
"28573","1200-1259",2022-07-27,60,3,58,118
"28574","1200-1259",2022-07-28,62,4,61,123
"28575","1200-1259",2022-07-29,62,5,59,121
"28576","1200-1259",2022-07-30,58,6,51,109
"28577","1200-1259",2022-07-31,59,7,60,119
"28578","1300-1359",2022-07-01,72,5,65,137
"28579","1300-1359",2022-07-02,53,6,57,110
"28580","1300-1359",2022-07-03,63,7,63,126
"28581","1300-1359",2022-07-04,71,1,62,133
"28582","1300-1359",2022-07-05,70,2,59,129
"28583","1300-1359",2022-07-06,69,3,64,133
"28584","1300-1359",2022-07-07,72,4,64,136
"28585","1300-1359",2022-07-08,71,5,67,138
"28586","1300-1359",2022-07-09,57,6,57,114
"28587","1300-1359",2022-07-10,70,7,62,132
"28588","1300-1359",2022-07-11,72,1,66,138
"28589","1300-1359",2022-07-12,67,2,58,125
"28590","1300-1359",2022-07-13,68,3,62,130
"28591","1300-1359",2022-07-14,70,4,64,134
"28592","1300-1359",2022-07-15,71,5,65,136
"28593","1300-1359",2022-07-16,54,6,57,111
"28594","1300-1359",2022-07-17,70,7,62,132
"28595","1300-1359",2022-07-18,70,1,65,135
"28596","1300-1359",2022-07-19,67,2,57,124
"28597","1300-1359",2022-07-20,68,3,61,129
"28598","1300-1359",2022-07-21,70,4,64,134
"28599","1300-1359",2022-07-22,70,5,65,135
"28600","1300-1359",2022-07-23,55,6,57,112
"28601","1300-1359",2022-07-24,68,7,62,130
"28602","1300-1359",2022-07-25,71,1,65,136
"28603","1300-1359",2022-07-26,66,2,57,123
"28604","1300-1359",2022-07-27,69,3,61,130
"28605","1300-1359",2022-07-28,70,4,64,134
"28606","1300-1359",2022-07-29,72,5,65,137
"28607","1300-1359",2022-07-30,54,6,57,111
"28608","1300-1359",2022-07-31,70,7,62,132
"28609","1400-1459",2022-07-01,55,5,64,119
"28610","1400-1459",2022-07-02,52,6,52,104
"28611","1400-1459",2022-07-03,52,7,64,116
"28612","1400-1459",2022-07-04,54,1,65,119
"28613","1400-1459",2022-07-05,51,2,64,115
"28614","1400-1459",2022-07-06,51,3,64,115
"28615","1400-1459",2022-07-07,56,4,67,123
"28616","1400-1459",2022-07-08,55,5,66,121
"28617","1400-1459",2022-07-09,53,6,53,106
"28618","1400-1459",2022-07-10,57,7,64,121
"28619","1400-1459",2022-07-11,56,1,66,122
"28620","1400-1459",2022-07-12,50,2,65,115
"28621","1400-1459",2022-07-13,52,3,65,117
"28622","1400-1459",2022-07-14,57,4,67,124
"28623","1400-1459",2022-07-15,56,5,67,123
"28624","1400-1459",2022-07-16,53,6,54,107
"28625","1400-1459",2022-07-17,56,7,64,120
"28626","1400-1459",2022-07-18,56,1,67,123
"28627","1400-1459",2022-07-19,50,2,66,116
"28628","1400-1459",2022-07-20,52,3,66,118
"28629","1400-1459",2022-07-21,57,4,66,123
"28630","1400-1459",2022-07-22,56,5,67,123
"28631","1400-1459",2022-07-23,53,6,54,107
"28632","1400-1459",2022-07-24,57,7,64,121
"28633","1400-1459",2022-07-25,56,1,67,123
"28634","1400-1459",2022-07-26,50,2,66,116
"28635","1400-1459",2022-07-27,52,3,67,119
"28636","1400-1459",2022-07-28,57,4,67,124
"28637","1400-1459",2022-07-29,54,5,67,121
"28638","1400-1459",2022-07-30,53,6,54,107
"28639","1400-1459",2022-07-31,56,7,64,120
"28640","1500-1559",2022-07-01,60,5,61,121
"28641","1500-1559",2022-07-02,46,6,54,100
"28642","1500-1559",2022-07-03,56,7,58,114
"28643","1500-1559",2022-07-04,60,1,59,119
"28644","1500-1559",2022-07-05,53,2,58,111
"28645","1500-1559",2022-07-06,55,3,56,111
"28646","1500-1559",2022-07-07,58,4,62,120
"28647","1500-1559",2022-07-08,58,5,59,117
"28648","1500-1559",2022-07-09,47,6,59,106
"28649","1500-1559",2022-07-10,58,7,62,120
"28650","1500-1559",2022-07-11,58,1,60,118
"28651","1500-1559",2022-07-12,54,2,55,109
"28652","1500-1559",2022-07-13,56,3,56,112
"28653","1500-1559",2022-07-14,57,4,61,118
"28654","1500-1559",2022-07-15,58,5,60,118
"28655","1500-1559",2022-07-16,46,6,58,104
"28656","1500-1559",2022-07-17,58,7,63,121
"28657","1500-1559",2022-07-18,57,1,59,116
"28658","1500-1559",2022-07-19,54,2,56,110
"28659","1500-1559",2022-07-20,55,3,55,110
"28660","1500-1559",2022-07-21,57,4,62,119
"28661","1500-1559",2022-07-22,57,5,59,116
"28662","1500-1559",2022-07-23,46,6,59,105
"28663","1500-1559",2022-07-24,58,7,62,120
"28664","1500-1559",2022-07-25,57,1,60,117
"28665","1500-1559",2022-07-26,54,2,55,109
"28666","1500-1559",2022-07-27,55,3,56,111
"28667","1500-1559",2022-07-28,57,4,61,118
"28668","1500-1559",2022-07-29,58,5,60,118
"28669","1500-1559",2022-07-30,46,6,58,104
"28670","1500-1559",2022-07-31,58,7,63,121
"28671","1600-1659",2022-07-01,64,5,64,128
"28672","1600-1659",2022-07-02,59,6,51,110
"28673","1600-1659",2022-07-03,62,7,62,124
"28674","1600-1659",2022-07-04,64,1,65,129
"28675","1600-1659",2022-07-05,61,2,62,123
"28676","1600-1659",2022-07-06,62,3,61,123
"28677","1600-1659",2022-07-07,66,4,66,132
"28678","1600-1659",2022-07-08,66,5,65,131
"28679","1600-1659",2022-07-09,62,6,51,113
"28680","1600-1659",2022-07-10,65,7,66,131
"28681","1600-1659",2022-07-11,65,1,65,130
"28682","1600-1659",2022-07-12,61,2,61,122
"28683","1600-1659",2022-07-13,62,3,60,122
"28684","1600-1659",2022-07-14,66,4,66,132
"28685","1600-1659",2022-07-15,66,5,65,131
"28686","1600-1659",2022-07-16,62,6,50,112
"28687","1600-1659",2022-07-17,65,7,65,130
"28688","1600-1659",2022-07-18,65,1,65,130
"28689","1600-1659",2022-07-19,60,2,61,121
"28690","1600-1659",2022-07-20,61,3,60,121
"28691","1600-1659",2022-07-21,64,4,66,130
"28692","1600-1659",2022-07-22,65,5,66,131
"28693","1600-1659",2022-07-23,62,6,49,111
"28694","1600-1659",2022-07-24,65,7,65,130
"28695","1600-1659",2022-07-25,65,1,65,130
"28696","1600-1659",2022-07-26,60,2,61,121
"28697","1600-1659",2022-07-27,61,3,60,121
"28698","1600-1659",2022-07-28,64,4,66,130
"28699","1600-1659",2022-07-29,64,5,63,127
"28700","1600-1659",2022-07-30,62,6,50,112
"28701","1600-1659",2022-07-31,65,7,65,130
"28702","1700-1759",2022-07-01,66,5,52,118
"28703","1700-1759",2022-07-02,46,6,46,92
"28704","1700-1759",2022-07-03,52,7,47,99
"28705","1700-1759",2022-07-04,61,1,48,109
"28706","1700-1759",2022-07-05,63,2,45,108
"28707","1700-1759",2022-07-06,58,3,46,104
"28708","1700-1759",2022-07-07,64,4,49,113
"28709","1700-1759",2022-07-08,63,5,49,112
"28710","1700-1759",2022-07-09,47,6,46,93
"28711","1700-1759",2022-07-10,69,7,46,115
"28712","1700-1759",2022-07-11,70,1,51,121
"28713","1700-1759",2022-07-12,65,2,49,114
"28714","1700-1759",2022-07-13,64,3,50,114
"28715","1700-1759",2022-07-14,69,4,51,120
"28716","1700-1759",2022-07-15,70,5,50,120
"28717","1700-1759",2022-07-16,50,6,47,97
"28718","1700-1759",2022-07-17,69,7,49,118
"28719","1700-1759",2022-07-18,70,1,51,121
"28720","1700-1759",2022-07-19,65,2,49,114
"28721","1700-1759",2022-07-20,64,3,50,114
"28722","1700-1759",2022-07-21,69,4,50,119
"28723","1700-1759",2022-07-22,71,5,50,121
"28724","1700-1759",2022-07-23,50,6,47,97
"28725","1700-1759",2022-07-24,69,7,49,118
"28726","1700-1759",2022-07-25,70,1,51,121
"28727","1700-1759",2022-07-26,65,2,49,114
"28728","1700-1759",2022-07-27,64,3,50,114
"28729","1700-1759",2022-07-28,69,4,51,120
"28730","1700-1759",2022-07-29,70,5,50,120
"28731","1700-1759",2022-07-30,50,6,47,97
"28732","1700-1759",2022-07-31,69,7,49,118
"28733","1800-1859",2022-07-01,62,5,79,141
"28734","1800-1859",2022-07-02,56,6,68,124
"28735","1800-1859",2022-07-03,55,7,73,128
"28736","1800-1859",2022-07-04,58,1,76,134
"28737","1800-1859",2022-07-05,54,2,74,128
"28738","1800-1859",2022-07-06,51,3,72,123
"28739","1800-1859",2022-07-07,63,4,78,141
"28740","1800-1859",2022-07-08,60,5,76,136
"28741","1800-1859",2022-07-09,55,6,69,124
"28742","1800-1859",2022-07-10,63,7,83,146
"28743","1800-1859",2022-07-11,63,1,79,142
"28744","1800-1859",2022-07-12,54,2,72,126
"28745","1800-1859",2022-07-13,54,3,73,127
"28746","1800-1859",2022-07-14,66,4,80,146
"28747","1800-1859",2022-07-15,61,5,80,141
"28748","1800-1859",2022-07-16,54,6,70,124
"28749","1800-1859",2022-07-17,66,7,83,149
"28750","1800-1859",2022-07-18,63,1,79,142
"28751","1800-1859",2022-07-19,54,2,72,126
"28752","1800-1859",2022-07-20,53,3,75,128
"28753","1800-1859",2022-07-21,66,4,81,147
"28754","1800-1859",2022-07-22,60,5,80,140
"28755","1800-1859",2022-07-23,53,6,70,123
"28756","1800-1859",2022-07-24,65,7,83,148
"28757","1800-1859",2022-07-25,63,1,79,142
"28758","1800-1859",2022-07-26,54,2,72,126
"28759","1800-1859",2022-07-27,54,3,74,128
"28760","1800-1859",2022-07-28,65,4,81,146
"28761","1800-1859",2022-07-29,61,5,79,140
"28762","1800-1859",2022-07-30,54,6,70,124
"28763","1800-1859",2022-07-31,66,7,83,149
"28764","1900-1959",2022-07-01,69,5,55,124
"28765","1900-1959",2022-07-02,61,6,48,109
"28766","1900-1959",2022-07-03,54,7,49,103
"28767","1900-1959",2022-07-04,56,1,56,112
"28768","1900-1959",2022-07-05,67,2,52,119
"28769","1900-1959",2022-07-06,57,3,51,108
"28770","1900-1959",2022-07-07,62,4,58,120
"28771","1900-1959",2022-07-08,61,5,56,117
"28772","1900-1959",2022-07-09,63,6,51,114
"28773","1900-1959",2022-07-10,70,7,57,127
"28774","1900-1959",2022-07-11,67,1,58,125
"28775","1900-1959",2022-07-12,63,2,53,116
"28776","1900-1959",2022-07-13,62,3,53,115
"28777","1900-1959",2022-07-14,68,4,57,125
"28778","1900-1959",2022-07-15,67,5,58,125
"28779","1900-1959",2022-07-16,63,6,53,116
"28780","1900-1959",2022-07-17,68,7,56,124
"28781","1900-1959",2022-07-18,67,1,58,125
"28782","1900-1959",2022-07-19,63,2,53,116
"28783","1900-1959",2022-07-20,63,3,52,115
"28784","1900-1959",2022-07-21,68,4,57,125
"28785","1900-1959",2022-07-22,67,5,58,125
"28786","1900-1959",2022-07-23,64,6,53,117
"28787","1900-1959",2022-07-24,69,7,56,125
"28788","1900-1959",2022-07-25,67,1,58,125
"28789","1900-1959",2022-07-26,63,2,53,116
"28790","1900-1959",2022-07-27,62,3,53,115
"28791","1900-1959",2022-07-28,68,4,56,124
"28792","1900-1959",2022-07-29,67,5,60,127
"28793","1900-1959",2022-07-30,63,6,53,116
"28794","1900-1959",2022-07-31,68,7,56,124
"28795","2000-2059",2022-07-01,47,5,73,120
"28796","2000-2059",2022-07-02,42,6,69,111
"28797","2000-2059",2022-07-03,41,7,63,104
"28798","2000-2059",2022-07-04,45,1,73,118
"28799","2000-2059",2022-07-05,41,2,69,110
"28800","2000-2059",2022-07-06,43,3,68,111
"28801","2000-2059",2022-07-07,46,4,74,120
"28802","2000-2059",2022-07-08,47,5,74,121
"28803","2000-2059",2022-07-09,45,6,70,115
"28804","2000-2059",2022-07-10,47,7,72,119
"28805","2000-2059",2022-07-11,48,1,75,123
"28806","2000-2059",2022-07-12,43,2,69,112
"28807","2000-2059",2022-07-13,45,3,70,115
"28808","2000-2059",2022-07-14,49,4,76,125
"28809","2000-2059",2022-07-15,50,5,74,124
"28810","2000-2059",2022-07-16,47,6,68,115
"28811","2000-2059",2022-07-17,49,7,75,124
"28812","2000-2059",2022-07-18,48,1,76,124
"28813","2000-2059",2022-07-19,43,2,69,112
"28814","2000-2059",2022-07-20,45,3,68,113
"28815","2000-2059",2022-07-21,49,4,76,125
"28816","2000-2059",2022-07-22,49,5,73,122
"28817","2000-2059",2022-07-23,47,6,68,115
"28818","2000-2059",2022-07-24,49,7,75,124
"28819","2000-2059",2022-07-25,48,1,75,123
"28820","2000-2059",2022-07-26,43,2,69,112
"28821","2000-2059",2022-07-27,45,3,69,114
"28822","2000-2059",2022-07-28,49,4,76,125
"28823","2000-2059",2022-07-29,51,5,73,124
"28824","2000-2059",2022-07-30,47,6,68,115
"28825","2000-2059",2022-07-31,49,7,75,124
"28826","2100-2159",2022-07-01,43,5,81,124
"28827","2100-2159",2022-07-02,28,6,63,91
"28828","2100-2159",2022-07-03,37,7,59,96
"28829","2100-2159",2022-07-04,38,1,70,108
"28830","2100-2159",2022-07-05,40,2,73,113
"28831","2100-2159",2022-07-06,40,3,70,110
"28832","2100-2159",2022-07-07,43,4,75,118
"28833","2100-2159",2022-07-08,41,5,75,116
"28834","2100-2159",2022-07-09,30,6,63,93
"28835","2100-2159",2022-07-10,47,7,79,126
"28836","2100-2159",2022-07-11,45,1,79,124
"28837","2100-2159",2022-07-12,41,2,73,114
"28838","2100-2159",2022-07-13,44,3,74,118
"28839","2100-2159",2022-07-14,47,4,79,126
"28840","2100-2159",2022-07-15,45,5,79,124
"28841","2100-2159",2022-07-16,29,6,63,92
"28842","2100-2159",2022-07-17,47,7,79,126
"28843","2100-2159",2022-07-18,45,1,79,124
"28844","2100-2159",2022-07-19,41,2,73,114
"28845","2100-2159",2022-07-20,43,3,75,118
"28846","2100-2159",2022-07-21,47,4,79,126
"28847","2100-2159",2022-07-22,45,5,78,123
"28848","2100-2159",2022-07-23,29,6,64,93
"28849","2100-2159",2022-07-24,47,7,79,126
"28850","2100-2159",2022-07-25,45,1,79,124
"28851","2100-2159",2022-07-26,41,2,73,114
"28852","2100-2159",2022-07-27,43,3,74,117
"28853","2100-2159",2022-07-28,46,4,78,124
"28854","2100-2159",2022-07-29,45,5,79,124
"28855","2100-2159",2022-07-30,29,6,63,92
"28856","2100-2159",2022-07-31,47,7,80,127
"28857","2200-2259",2022-07-01,52,5,67,119
"28858","2200-2259",2022-07-02,42,6,56,98
"28859","2200-2259",2022-07-03,35,7,59,94
"28860","2200-2259",2022-07-04,43,1,58,101
"28861","2200-2259",2022-07-05,45,2,61,106
"28862","2200-2259",2022-07-06,44,3,56,100
"28863","2200-2259",2022-07-07,47,4,62,109
"28864","2200-2259",2022-07-08,49,5,64,113
"28865","2200-2259",2022-07-09,41,6,58,99
"28866","2200-2259",2022-07-10,50,7,70,120
"28867","2200-2259",2022-07-11,49,1,68,117
"28868","2200-2259",2022-07-12,43,2,59,102
"28869","2200-2259",2022-07-13,46,3,61,107
"28870","2200-2259",2022-07-14,48,4,68,116
"28871","2200-2259",2022-07-15,50,5,70,120
"28872","2200-2259",2022-07-16,42,6,58,100
"28873","2200-2259",2022-07-17,48,7,69,117
"28874","2200-2259",2022-07-18,48,1,68,116
"28875","2200-2259",2022-07-19,43,2,59,102
"28876","2200-2259",2022-07-20,46,3,60,106
"28877","2200-2259",2022-07-21,48,4,68,116
"28878","2200-2259",2022-07-22,50,5,69,119
"28879","2200-2259",2022-07-23,43,6,57,100
"28880","2200-2259",2022-07-24,48,7,69,117
"28881","2200-2259",2022-07-25,48,1,68,116
"28882","2200-2259",2022-07-26,43,2,59,102
"28883","2200-2259",2022-07-27,46,3,60,106
"28884","2200-2259",2022-07-28,48,4,67,115
"28885","2200-2259",2022-07-29,49,5,69,118
"28886","2200-2259",2022-07-30,42,6,58,100
"28887","2200-2259",2022-07-31,48,7,68,116
"28888","2300-2359",2022-07-01,24,5,53,77
"28889","2300-2359",2022-07-02,22,6,46,68
"28890","2300-2359",2022-07-03,18,7,45,63
"28891","2300-2359",2022-07-04,20,1,49,69
"28892","2300-2359",2022-07-05,22,2,50,72
"28893","2300-2359",2022-07-06,23,3,50,73
"28894","2300-2359",2022-07-07,23,4,54,77
"28895","2300-2359",2022-07-08,23,5,52,75
"28896","2300-2359",2022-07-09,23,6,46,69
"28897","2300-2359",2022-07-10,24,7,56,80
"28898","2300-2359",2022-07-11,25,1,56,81
"28899","2300-2359",2022-07-12,22,2,53,75
"28900","2300-2359",2022-07-13,22,3,53,75
"28901","2300-2359",2022-07-14,26,4,58,84
"28902","2300-2359",2022-07-15,25,5,56,81
"28903","2300-2359",2022-07-16,22,6,49,71
"28904","2300-2359",2022-07-17,26,7,58,84
"28905","2300-2359",2022-07-18,26,1,56,82
"28906","2300-2359",2022-07-19,22,2,53,75
"28907","2300-2359",2022-07-20,22,3,53,75
"28908","2300-2359",2022-07-21,26,4,58,84
"28909","2300-2359",2022-07-22,25,5,56,81
"28910","2300-2359",2022-07-23,21,6,49,70
"28911","2300-2359",2022-07-24,26,7,58,84
"28912","2300-2359",2022-07-25,26,1,56,82
"28913","2300-2359",2022-07-26,22,2,53,75
"28914","2300-2359",2022-07-27,22,3,53,75
"28915","2300-2359",2022-07-28,26,4,58,84
"28916","2300-2359",2022-07-29,25,5,56,81
"28917","2300-2359",2022-07-30,22,6,49,71
"28918","2300-2359",2022-07-31,26,7,58,84
"28919","0001-0559",2022-08-01,25,1,55,80
"28920","0001-0559",2022-08-02,25,2,46,71
"28921","0001-0559",2022-08-03,25,3,49,74
"28922","0001-0559",2022-08-04,26,4,58,84
"28923","0001-0559",2022-08-05,26,5,56,82
"28924","0001-0559",2022-08-06,16,6,40,56
"28925","0001-0559",2022-08-07,25,7,58,83
"28926","0001-0559",2022-08-08,26,1,57,83
"28927","0001-0559",2022-08-09,27,2,47,74
"28928","0001-0559",2022-08-10,25,3,49,74
"28929","0001-0559",2022-08-11,26,4,58,84
"28930","0001-0559",2022-08-12,27,5,57,84
"28931","0001-0559",2022-08-13,16,6,39,55
"28932","0001-0559",2022-08-14,25,7,58,83
"28933","0001-0559",2022-08-15,26,1,52,78
"28934","0001-0559",2022-08-16,28,2,44,72
"28935","0001-0559",2022-08-17,25,3,46,71
"28936","0001-0559",2022-08-18,26,4,53,79
"28937","0001-0559",2022-08-19,26,5,52,78
"28938","0001-0559",2022-08-20,16,6,37,53
"28939","0001-0559",2022-08-21,25,7,54,79
"28940","0001-0559",2022-08-22,26,1,52,78
"28941","0001-0559",2022-08-23,25,2,44,69
"28942","0001-0559",2022-08-24,24,3,47,71
"28943","0001-0559",2022-08-25,25,4,53,78
"28944","0001-0559",2022-08-26,27,5,52,79
"28945","0001-0559",2022-08-27,16,6,37,53
"28946","0001-0559",2022-08-28,26,7,53,79
"28947","0001-0559",2022-08-29,26,1,52,78
"28948","0001-0559",2022-08-30,25,2,44,69
"28949","0001-0559",2022-08-31,24,3,47,71
"28950","0600-0659",2022-08-01,72,1,32,104
"28951","0600-0659",2022-08-02,67,2,29,96
"28952","0600-0659",2022-08-03,67,3,32,99
"28953","0600-0659",2022-08-04,70,4,33,103
"28954","0600-0659",2022-08-05,70,5,34,104
"28955","0600-0659",2022-08-06,68,6,31,99
"28956","0600-0659",2022-08-07,67,7,31,98
"28957","0600-0659",2022-08-08,69,1,30,99
"28958","0600-0659",2022-08-09,66,2,29,95
"28959","0600-0659",2022-08-10,68,3,31,99
"28960","0600-0659",2022-08-11,70,4,31,101
"28961","0600-0659",2022-08-12,71,5,33,104
"28962","0600-0659",2022-08-13,68,6,31,99
"28963","0600-0659",2022-08-14,68,7,30,98
"28964","0600-0659",2022-08-15,70,1,31,101
"28965","0600-0659",2022-08-16,70,2,28,98
"28966","0600-0659",2022-08-17,69,3,31,100
"28967","0600-0659",2022-08-18,71,4,31,102
"28968","0600-0659",2022-08-19,71,5,32,103
"28969","0600-0659",2022-08-20,69,6,31,100
"28970","0600-0659",2022-08-21,67,7,29,96
"28971","0600-0659",2022-08-22,71,1,30,101
"28972","0600-0659",2022-08-23,70,2,28,98
"28973","0600-0659",2022-08-24,68,3,31,99
"28974","0600-0659",2022-08-25,70,4,31,101
"28975","0600-0659",2022-08-26,72,5,33,105
"28976","0600-0659",2022-08-27,70,6,31,101
"28977","0600-0659",2022-08-28,69,7,29,98
"28978","0600-0659",2022-08-29,71,1,30,101
"28979","0600-0659",2022-08-30,71,2,27,98
"28980","0600-0659",2022-08-31,69,3,31,100
"28981","0700-0759",2022-08-01,90,1,57,147
"28982","0700-0759",2022-08-02,82,2,53,135
"28983","0700-0759",2022-08-03,81,3,52,133
"28984","0700-0759",2022-08-04,88,4,54,142
"28985","0700-0759",2022-08-05,90,5,55,145
"28986","0700-0759",2022-08-06,76,6,45,121
"28987","0700-0759",2022-08-07,83,7,53,136
"28988","0700-0759",2022-08-08,90,1,55,145
"28989","0700-0759",2022-08-09,83,2,52,135
"28990","0700-0759",2022-08-10,80,3,52,132
"28991","0700-0759",2022-08-11,86,4,53,139
"28992","0700-0759",2022-08-12,89,5,53,142
"28993","0700-0759",2022-08-13,76,6,45,121
"28994","0700-0759",2022-08-14,82,7,53,135
"28995","0700-0759",2022-08-15,89,1,52,141
"28996","0700-0759",2022-08-16,79,2,51,130
"28997","0700-0759",2022-08-17,76,3,51,127
"28998","0700-0759",2022-08-18,85,4,51,136
"28999","0700-0759",2022-08-19,86,5,50,136
"29000","0700-0759",2022-08-20,68,6,43,111
"29001","0700-0759",2022-08-21,82,7,51,133
"29002","0700-0759",2022-08-22,85,1,51,136
"29003","0700-0759",2022-08-23,78,2,50,128
"29004","0700-0759",2022-08-24,76,3,50,126
"29005","0700-0759",2022-08-25,85,4,52,137
"29006","0700-0759",2022-08-26,85,5,52,137
"29007","0700-0759",2022-08-27,68,6,45,113
"29008","0700-0759",2022-08-28,82,7,53,135
"29009","0700-0759",2022-08-29,85,1,53,138
"29010","0700-0759",2022-08-30,78,2,51,129
"29011","0700-0759",2022-08-31,78,3,51,129
"29012","0800-0859",2022-08-01,91,1,44,135
"29013","0800-0859",2022-08-02,90,2,42,132
"29014","0800-0859",2022-08-03,90,3,39,129
"29015","0800-0859",2022-08-04,91,4,43,134
"29016","0800-0859",2022-08-05,90,5,44,134
"29017","0800-0859",2022-08-06,79,6,39,118
"29018","0800-0859",2022-08-07,90,7,41,131
"29019","0800-0859",2022-08-08,90,1,46,136
"29020","0800-0859",2022-08-09,88,2,44,132
"29021","0800-0859",2022-08-10,89,3,42,131
"29022","0800-0859",2022-08-11,89,4,46,135
"29023","0800-0859",2022-08-12,90,5,46,136
"29024","0800-0859",2022-08-13,80,6,42,122
"29025","0800-0859",2022-08-14,90,7,42,132
"29026","0800-0859",2022-08-15,89,1,46,135
"29027","0800-0859",2022-08-16,87,2,40,127
"29028","0800-0859",2022-08-17,88,3,38,126
"29029","0800-0859",2022-08-18,89,4,40,129
"29030","0800-0859",2022-08-19,88,5,41,129
"29031","0800-0859",2022-08-20,84,6,36,120
"29032","0800-0859",2022-08-21,90,7,36,126
"29033","0800-0859",2022-08-22,89,1,41,130
"29034","0800-0859",2022-08-23,86,2,39,125
"29035","0800-0859",2022-08-24,87,3,37,124
"29036","0800-0859",2022-08-25,89,4,39,128
"29037","0800-0859",2022-08-26,88,5,42,130
"29038","0800-0859",2022-08-27,84,6,37,121
"29039","0800-0859",2022-08-28,90,7,38,128
"29040","0800-0859",2022-08-29,89,1,41,130
"29041","0800-0859",2022-08-30,87,2,39,126
"29042","0800-0859",2022-08-31,88,3,38,126
"29043","0900-0959",2022-08-01,56,1,68,124
"29044","0900-0959",2022-08-02,55,2,65,120
"29045","0900-0959",2022-08-03,54,3,66,120
"29046","0900-0959",2022-08-04,56,4,69,125
"29047","0900-0959",2022-08-05,54,5,67,121
"29048","0900-0959",2022-08-06,49,6,61,110
"29049","0900-0959",2022-08-07,54,7,65,119
"29050","0900-0959",2022-08-08,56,1,66,122
"29051","0900-0959",2022-08-09,53,2,62,115
"29052","0900-0959",2022-08-10,55,3,63,118
"29053","0900-0959",2022-08-11,58,4,65,123
"29054","0900-0959",2022-08-12,58,5,66,124
"29055","0900-0959",2022-08-13,49,6,58,107
"29056","0900-0959",2022-08-14,55,7,63,118
"29057","0900-0959",2022-08-15,58,1,65,123
"29058","0900-0959",2022-08-16,55,2,64,119
"29059","0900-0959",2022-08-17,56,3,63,119
"29060","0900-0959",2022-08-18,56,4,67,123
"29061","0900-0959",2022-08-19,59,5,68,127
"29062","0900-0959",2022-08-20,52,6,61,113
"29063","0900-0959",2022-08-21,55,7,63,118
"29064","0900-0959",2022-08-22,59,1,67,126
"29065","0900-0959",2022-08-23,56,2,64,120
"29066","0900-0959",2022-08-24,56,3,63,119
"29067","0900-0959",2022-08-25,57,4,67,124
"29068","0900-0959",2022-08-26,60,5,67,127
"29069","0900-0959",2022-08-27,53,6,61,114
"29070","0900-0959",2022-08-28,56,7,64,120
"29071","0900-0959",2022-08-29,59,1,67,126
"29072","0900-0959",2022-08-30,56,2,64,120
"29073","0900-0959",2022-08-31,56,3,65,121
"29074","1000-1059",2022-08-01,86,1,41,127
"29075","1000-1059",2022-08-02,85,2,40,125
"29076","1000-1059",2022-08-03,86,3,40,126
"29077","1000-1059",2022-08-04,86,4,41,127
"29078","1000-1059",2022-08-05,86,5,42,128
"29079","1000-1059",2022-08-06,74,6,40,114
"29080","1000-1059",2022-08-07,83,7,41,124
"29081","1000-1059",2022-08-08,86,1,42,128
"29082","1000-1059",2022-08-09,84,2,41,125
"29083","1000-1059",2022-08-10,83,3,40,123
"29084","1000-1059",2022-08-11,84,4,42,126
"29085","1000-1059",2022-08-12,83,5,42,125
"29086","1000-1059",2022-08-13,72,6,41,113
"29087","1000-1059",2022-08-14,82,7,42,124
"29088","1000-1059",2022-08-15,83,1,42,125
"29089","1000-1059",2022-08-16,82,2,41,123
"29090","1000-1059",2022-08-17,84,3,41,125
"29091","1000-1059",2022-08-18,85,4,42,127
"29092","1000-1059",2022-08-19,85,5,41,126
"29093","1000-1059",2022-08-20,74,6,41,115
"29094","1000-1059",2022-08-21,79,7,44,123
"29095","1000-1059",2022-08-22,84,1,42,126
"29096","1000-1059",2022-08-23,84,2,41,125
"29097","1000-1059",2022-08-24,83,3,39,122
"29098","1000-1059",2022-08-25,85,4,42,127
"29099","1000-1059",2022-08-26,84,5,42,126
"29100","1000-1059",2022-08-27,74,6,42,116
"29101","1000-1059",2022-08-28,81,7,44,125
"29102","1000-1059",2022-08-29,84,1,42,126
"29103","1000-1059",2022-08-30,83,2,41,124
"29104","1000-1059",2022-08-31,85,3,40,125
"29105","1100-1159",2022-08-01,51,1,70,121
"29106","1100-1159",2022-08-02,50,2,66,116
"29107","1100-1159",2022-08-03,50,3,69,119
"29108","1100-1159",2022-08-04,53,4,67,120
"29109","1100-1159",2022-08-05,52,5,67,119
"29110","1100-1159",2022-08-06,45,6,57,102
"29111","1100-1159",2022-08-07,54,7,66,120
"29112","1100-1159",2022-08-08,54,1,67,121
"29113","1100-1159",2022-08-09,52,2,64,116
"29114","1100-1159",2022-08-10,50,3,68,118
"29115","1100-1159",2022-08-11,53,4,65,118
"29116","1100-1159",2022-08-12,51,5,67,118
"29117","1100-1159",2022-08-13,45,6,56,101
"29118","1100-1159",2022-08-14,53,7,66,119
"29119","1100-1159",2022-08-15,53,1,67,120
"29120","1100-1159",2022-08-16,48,2,63,111
"29121","1100-1159",2022-08-17,48,3,65,113
"29122","1100-1159",2022-08-18,51,4,65,116
"29123","1100-1159",2022-08-19,50,5,67,117
"29124","1100-1159",2022-08-20,44,6,55,99
"29125","1100-1159",2022-08-21,52,7,67,119
"29126","1100-1159",2022-08-22,50,1,67,117
"29127","1100-1159",2022-08-23,48,2,62,110
"29128","1100-1159",2022-08-24,48,3,64,112
"29129","1100-1159",2022-08-25,51,4,64,115
"29130","1100-1159",2022-08-26,51,5,65,116
"29131","1100-1159",2022-08-27,45,6,54,99
"29132","1100-1159",2022-08-28,52,7,67,119
"29133","1100-1159",2022-08-29,50,1,66,116
"29134","1100-1159",2022-08-30,48,2,62,110
"29135","1100-1159",2022-08-31,48,3,65,113
"29136","1200-1259",2022-08-01,63,1,60,123
"29137","1200-1259",2022-08-02,58,2,59,117
"29138","1200-1259",2022-08-03,62,3,58,120
"29139","1200-1259",2022-08-04,62,4,62,124
"29140","1200-1259",2022-08-05,63,5,59,122
"29141","1200-1259",2022-08-06,61,6,48,109
"29142","1200-1259",2022-08-07,61,7,60,121
"29143","1200-1259",2022-08-08,63,1,61,124
"29144","1200-1259",2022-08-09,59,2,59,118
"29145","1200-1259",2022-08-10,64,3,57,121
"29146","1200-1259",2022-08-11,64,4,61,125
"29147","1200-1259",2022-08-12,64,5,60,124
"29148","1200-1259",2022-08-13,61,6,48,109
"29149","1200-1259",2022-08-14,62,7,60,122
"29150","1200-1259",2022-08-15,64,1,60,124
"29151","1200-1259",2022-08-16,61,2,58,119
"29152","1200-1259",2022-08-17,62,3,56,118
"29153","1200-1259",2022-08-18,65,4,58,123
"29154","1200-1259",2022-08-19,64,5,60,124
"29155","1200-1259",2022-08-20,58,6,48,106
"29156","1200-1259",2022-08-21,64,7,55,119
"29157","1200-1259",2022-08-22,64,1,60,124
"29158","1200-1259",2022-08-23,61,2,58,119
"29159","1200-1259",2022-08-24,62,3,56,118
"29160","1200-1259",2022-08-25,65,4,59,124
"29161","1200-1259",2022-08-26,64,5,61,125
"29162","1200-1259",2022-08-27,58,6,48,106
"29163","1200-1259",2022-08-28,63,7,56,119
"29164","1200-1259",2022-08-29,64,1,60,124
"29165","1200-1259",2022-08-30,61,2,58,119
"29166","1200-1259",2022-08-31,62,3,56,118
"29167","1300-1359",2022-08-01,69,1,64,133
"29168","1300-1359",2022-08-02,65,2,58,123
"29169","1300-1359",2022-08-03,66,3,61,127
"29170","1300-1359",2022-08-04,70,4,62,132
"29171","1300-1359",2022-08-05,68,5,64,132
"29172","1300-1359",2022-08-06,51,6,55,106
"29173","1300-1359",2022-08-07,68,7,61,129
"29174","1300-1359",2022-08-08,71,1,67,138
"29175","1300-1359",2022-08-09,66,2,58,124
"29176","1300-1359",2022-08-10,67,3,62,129
"29177","1300-1359",2022-08-11,71,4,64,135
"29178","1300-1359",2022-08-12,71,5,65,136
"29179","1300-1359",2022-08-13,52,6,55,107
"29180","1300-1359",2022-08-14,68,7,62,130
"29181","1300-1359",2022-08-15,69,1,65,134
"29182","1300-1359",2022-08-16,60,2,59,119
"29183","1300-1359",2022-08-17,61,3,61,122
"29184","1300-1359",2022-08-18,62,4,68,130
"29185","1300-1359",2022-08-19,64,5,65,129
"29186","1300-1359",2022-08-20,48,6,55,103
"29187","1300-1359",2022-08-21,62,7,65,127
"29188","1300-1359",2022-08-22,63,1,64,127
"29189","1300-1359",2022-08-23,60,2,61,121
"29190","1300-1359",2022-08-24,62,3,61,123
"29191","1300-1359",2022-08-25,63,4,68,131
"29192","1300-1359",2022-08-26,64,5,65,129
"29193","1300-1359",2022-08-27,49,6,56,105
"29194","1300-1359",2022-08-28,61,7,66,127
"29195","1300-1359",2022-08-29,63,1,64,127
"29196","1300-1359",2022-08-30,61,2,60,121
"29197","1300-1359",2022-08-31,61,3,62,123
"29198","1400-1459",2022-08-01,57,1,66,123
"29199","1400-1459",2022-08-02,50,2,67,117
"29200","1400-1459",2022-08-03,52,3,67,119
"29201","1400-1459",2022-08-04,57,4,67,124
"29202","1400-1459",2022-08-05,57,5,67,124
"29203","1400-1459",2022-08-06,52,6,58,110
"29204","1400-1459",2022-08-07,56,7,65,121
"29205","1400-1459",2022-08-08,57,1,66,123
"29206","1400-1459",2022-08-09,50,2,68,118
"29207","1400-1459",2022-08-10,51,3,67,118
"29208","1400-1459",2022-08-11,57,4,67,124
"29209","1400-1459",2022-08-12,55,5,68,123
"29210","1400-1459",2022-08-13,54,6,58,112
"29211","1400-1459",2022-08-14,56,7,64,120
"29212","1400-1459",2022-08-15,57,1,68,125
"29213","1400-1459",2022-08-16,55,2,66,121
"29214","1400-1459",2022-08-17,53,3,66,119
"29215","1400-1459",2022-08-18,60,4,64,124
"29216","1400-1459",2022-08-19,58,5,65,123
"29217","1400-1459",2022-08-20,56,6,57,113
"29218","1400-1459",2022-08-21,57,7,62,119
"29219","1400-1459",2022-08-22,57,1,65,122
"29220","1400-1459",2022-08-23,55,2,64,119
"29221","1400-1459",2022-08-24,53,3,66,119
"29222","1400-1459",2022-08-25,60,4,64,124
"29223","1400-1459",2022-08-26,57,5,65,122
"29224","1400-1459",2022-08-27,56,6,57,113
"29225","1400-1459",2022-08-28,57,7,62,119
"29226","1400-1459",2022-08-29,57,1,65,122
"29227","1400-1459",2022-08-30,55,2,66,121
"29228","1400-1459",2022-08-31,55,3,65,120
"29229","1500-1559",2022-08-01,58,1,60,118
"29230","1500-1559",2022-08-02,55,2,55,110
"29231","1500-1559",2022-08-03,57,3,55,112
"29232","1500-1559",2022-08-04,57,4,60,117
"29233","1500-1559",2022-08-05,56,5,57,113
"29234","1500-1559",2022-08-06,49,6,54,103
"29235","1500-1559",2022-08-07,57,7,61,118
"29236","1500-1559",2022-08-08,56,1,61,117
"29237","1500-1559",2022-08-09,53,2,55,108
"29238","1500-1559",2022-08-10,56,3,54,110
"29239","1500-1559",2022-08-11,56,4,62,118
"29240","1500-1559",2022-08-12,55,5,59,114
"29241","1500-1559",2022-08-13,46,6,56,102
"29242","1500-1559",2022-08-14,57,7,61,118
"29243","1500-1559",2022-08-15,54,1,60,114
"29244","1500-1559",2022-08-16,54,2,51,105
"29245","1500-1559",2022-08-17,55,3,50,105
"29246","1500-1559",2022-08-18,56,4,61,117
"29247","1500-1559",2022-08-19,56,5,58,114
"29248","1500-1559",2022-08-20,50,6,51,101
"29249","1500-1559",2022-08-21,57,7,60,117
"29250","1500-1559",2022-08-22,56,1,56,112
"29251","1500-1559",2022-08-23,53,2,52,105
"29252","1500-1559",2022-08-24,55,3,51,106
"29253","1500-1559",2022-08-25,56,4,61,117
"29254","1500-1559",2022-08-26,56,5,56,112
"29255","1500-1559",2022-08-27,51,6,51,102
"29256","1500-1559",2022-08-28,56,7,58,114
"29257","1500-1559",2022-08-29,56,1,56,112
"29258","1500-1559",2022-08-30,51,2,52,103
"29259","1500-1559",2022-08-31,54,3,52,106
"29260","1600-1659",2022-08-01,66,1,65,131
"29261","1600-1659",2022-08-02,59,2,60,119
"29262","1600-1659",2022-08-03,60,3,59,119
"29263","1600-1659",2022-08-04,65,4,64,129
"29264","1600-1659",2022-08-05,66,5,64,130
"29265","1600-1659",2022-08-06,60,6,49,109
"29266","1600-1659",2022-08-07,65,7,63,128
"29267","1600-1659",2022-08-08,68,1,63,131
"29268","1600-1659",2022-08-09,61,2,59,120
"29269","1600-1659",2022-08-10,61,3,60,121
"29270","1600-1659",2022-08-11,69,4,64,133
"29271","1600-1659",2022-08-12,68,5,64,132
"29272","1600-1659",2022-08-13,62,6,49,111
"29273","1600-1659",2022-08-14,66,7,63,129
"29274","1600-1659",2022-08-15,67,1,62,129
"29275","1600-1659",2022-08-16,55,2,63,118
"29276","1600-1659",2022-08-17,55,3,61,116
"29277","1600-1659",2022-08-18,64,4,63,127
"29278","1600-1659",2022-08-19,63,5,63,126
"29279","1600-1659",2022-08-20,52,6,53,105
"29280","1600-1659",2022-08-21,62,7,63,125
"29281","1600-1659",2022-08-22,61,1,62,123
"29282","1600-1659",2022-08-23,55,2,62,117
"29283","1600-1659",2022-08-24,56,3,61,117
"29284","1600-1659",2022-08-25,64,4,63,127
"29285","1600-1659",2022-08-26,62,5,63,125
"29286","1600-1659",2022-08-27,52,6,53,105
"29287","1600-1659",2022-08-28,62,7,63,125
"29288","1600-1659",2022-08-29,61,1,62,123
"29289","1600-1659",2022-08-30,58,2,62,120
"29290","1600-1659",2022-08-31,57,3,61,118
"29291","1700-1759",2022-08-01,69,1,49,118
"29292","1700-1759",2022-08-02,66,2,47,113
"29293","1700-1759",2022-08-03,65,3,48,113
"29294","1700-1759",2022-08-04,68,4,51,119
"29295","1700-1759",2022-08-05,67,5,49,116
"29296","1700-1759",2022-08-06,46,6,46,92
"29297","1700-1759",2022-08-07,68,7,49,117
"29298","1700-1759",2022-08-08,66,1,52,118
"29299","1700-1759",2022-08-09,64,2,48,112
"29300","1700-1759",2022-08-10,63,3,49,112
"29301","1700-1759",2022-08-11,68,4,54,122
"29302","1700-1759",2022-08-12,68,5,51,119
"29303","1700-1759",2022-08-13,46,6,48,94
"29304","1700-1759",2022-08-14,69,7,51,120
"29305","1700-1759",2022-08-15,69,1,52,121
"29306","1700-1759",2022-08-16,66,2,47,113
"29307","1700-1759",2022-08-17,65,3,48,113
"29308","1700-1759",2022-08-18,69,4,53,122
"29309","1700-1759",2022-08-19,69,5,51,120
"29310","1700-1759",2022-08-20,52,6,47,99
"29311","1700-1759",2022-08-21,69,7,50,119
"29312","1700-1759",2022-08-22,69,1,53,122
"29313","1700-1759",2022-08-23,66,2,47,113
"29314","1700-1759",2022-08-24,64,3,48,112
"29315","1700-1759",2022-08-25,69,4,53,122
"29316","1700-1759",2022-08-26,70,5,53,123
"29317","1700-1759",2022-08-27,51,6,49,100
"29318","1700-1759",2022-08-28,70,7,51,121
"29319","1700-1759",2022-08-29,68,1,52,120
"29320","1700-1759",2022-08-30,65,2,47,112
"29321","1700-1759",2022-08-31,64,3,48,112
"29322","1800-1859",2022-08-01,60,1,81,141
"29323","1800-1859",2022-08-02,53,2,74,127
"29324","1800-1859",2022-08-03,53,3,76,129
"29325","1800-1859",2022-08-04,64,4,85,149
"29326","1800-1859",2022-08-05,59,5,81,140
"29327","1800-1859",2022-08-06,51,6,70,121
"29328","1800-1859",2022-08-07,65,7,85,150
"29329","1800-1859",2022-08-08,62,1,80,142
"29330","1800-1859",2022-08-09,55,2,73,128
"29331","1800-1859",2022-08-10,53,3,74,127
"29332","1800-1859",2022-08-11,65,4,82,147
"29333","1800-1859",2022-08-12,61,5,79,140
"29334","1800-1859",2022-08-13,52,6,68,120
"29335","1800-1859",2022-08-14,65,7,84,149
"29336","1800-1859",2022-08-15,63,1,78,141
"29337","1800-1859",2022-08-16,56,2,71,127
"29338","1800-1859",2022-08-17,57,3,72,129
"29339","1800-1859",2022-08-18,65,4,78,143
"29340","1800-1859",2022-08-19,64,5,78,142
"29341","1800-1859",2022-08-20,56,6,66,122
"29342","1800-1859",2022-08-21,65,7,79,144
"29343","1800-1859",2022-08-22,66,1,77,143
"29344","1800-1859",2022-08-23,58,2,71,129
"29345","1800-1859",2022-08-24,58,3,72,130
"29346","1800-1859",2022-08-25,65,4,78,143
"29347","1800-1859",2022-08-26,64,5,77,141
"29348","1800-1859",2022-08-27,56,6,65,121
"29349","1800-1859",2022-08-28,65,7,78,143
"29350","1800-1859",2022-08-29,65,1,78,143
"29351","1800-1859",2022-08-30,58,2,71,129
"29352","1800-1859",2022-08-31,57,3,72,129
"29353","1900-1959",2022-08-01,66,1,55,121
"29354","1900-1959",2022-08-02,62,2,50,112
"29355","1900-1959",2022-08-03,61,3,50,111
"29356","1900-1959",2022-08-04,67,4,52,119
"29357","1900-1959",2022-08-05,65,5,54,119
"29358","1900-1959",2022-08-06,59,6,48,107
"29359","1900-1959",2022-08-07,65,7,51,116
"29360","1900-1959",2022-08-08,63,1,54,117
"29361","1900-1959",2022-08-09,59,2,50,109
"29362","1900-1959",2022-08-10,58,3,50,108
"29363","1900-1959",2022-08-11,65,4,54,119
"29364","1900-1959",2022-08-12,62,5,55,117
"29365","1900-1959",2022-08-13,56,6,48,104
"29366","1900-1959",2022-08-14,65,7,53,118
"29367","1900-1959",2022-08-15,60,1,54,114
"29368","1900-1959",2022-08-16,56,2,49,105
"29369","1900-1959",2022-08-17,56,3,49,105
"29370","1900-1959",2022-08-18,59,4,52,111
"29371","1900-1959",2022-08-19,58,5,54,112
"29372","1900-1959",2022-08-20,53,6,48,101
"29373","1900-1959",2022-08-21,59,7,53,112
"29374","1900-1959",2022-08-22,58,1,54,112
"29375","1900-1959",2022-08-23,56,2,50,106
"29376","1900-1959",2022-08-24,56,3,49,105
"29377","1900-1959",2022-08-25,59,4,52,111
"29378","1900-1959",2022-08-26,58,5,56,114
"29379","1900-1959",2022-08-27,52,6,49,101
"29380","1900-1959",2022-08-28,59,7,54,113
"29381","1900-1959",2022-08-29,59,1,53,112
"29382","1900-1959",2022-08-30,57,2,50,107
"29383","1900-1959",2022-08-31,57,3,49,106
"29384","2000-2059",2022-08-01,45,1,74,119
"29385","2000-2059",2022-08-02,39,2,72,111
"29386","2000-2059",2022-08-03,42,3,73,115
"29387","2000-2059",2022-08-04,47,4,75,122
"29388","2000-2059",2022-08-05,48,5,72,120
"29389","2000-2059",2022-08-06,44,6,66,110
"29390","2000-2059",2022-08-07,48,7,75,123
"29391","2000-2059",2022-08-08,47,1,74,121
"29392","2000-2059",2022-08-09,41,2,71,112
"29393","2000-2059",2022-08-10,42,3,70,112
"29394","2000-2059",2022-08-11,46,4,77,123
"29395","2000-2059",2022-08-12,47,5,74,121
"29396","2000-2059",2022-08-13,45,6,66,111
"29397","2000-2059",2022-08-14,47,7,76,123
"29398","2000-2059",2022-08-15,46,1,75,121
"29399","2000-2059",2022-08-16,41,2,73,114
"29400","2000-2059",2022-08-17,41,3,73,114
"29401","2000-2059",2022-08-18,47,4,77,124
"29402","2000-2059",2022-08-19,46,5,75,121
"29403","2000-2059",2022-08-20,43,6,69,112
"29404","2000-2059",2022-08-21,46,7,75,121
"29405","2000-2059",2022-08-22,46,1,76,122
"29406","2000-2059",2022-08-23,40,2,74,114
"29407","2000-2059",2022-08-24,41,3,73,114
"29408","2000-2059",2022-08-25,49,4,77,126
"29409","2000-2059",2022-08-26,50,5,74,124
"29410","2000-2059",2022-08-27,47,6,68,115
"29411","2000-2059",2022-08-28,50,7,75,125
"29412","2000-2059",2022-08-29,46,1,76,122
"29413","2000-2059",2022-08-30,41,2,74,115
"29414","2000-2059",2022-08-31,42,3,73,115
"29415","2100-2159",2022-08-01,44,1,75,119
"29416","2100-2159",2022-08-02,39,2,68,107
"29417","2100-2159",2022-08-03,42,3,70,112
"29418","2100-2159",2022-08-04,47,4,77,124
"29419","2100-2159",2022-08-05,45,5,77,122
"29420","2100-2159",2022-08-06,30,6,62,92
"29421","2100-2159",2022-08-07,48,7,78,126
"29422","2100-2159",2022-08-08,46,1,77,123
"29423","2100-2159",2022-08-09,42,2,72,114
"29424","2100-2159",2022-08-10,44,3,71,115
"29425","2100-2159",2022-08-11,48,4,78,126
"29426","2100-2159",2022-08-12,46,5,76,122
"29427","2100-2159",2022-08-13,29,6,61,90
"29428","2100-2159",2022-08-14,48,7,77,125
"29429","2100-2159",2022-08-15,47,1,77,124
"29430","2100-2159",2022-08-16,40,2,69,109
"29431","2100-2159",2022-08-17,41,3,68,109
"29432","2100-2159",2022-08-18,46,4,76,122
"29433","2100-2159",2022-08-19,44,5,76,120
"29434","2100-2159",2022-08-20,28,6,62,90
"29435","2100-2159",2022-08-21,46,7,75,121
"29436","2100-2159",2022-08-22,43,1,77,120
"29437","2100-2159",2022-08-23,39,2,69,108
"29438","2100-2159",2022-08-24,40,3,68,108
"29439","2100-2159",2022-08-25,46,4,78,124
"29440","2100-2159",2022-08-26,43,5,78,121
"29441","2100-2159",2022-08-27,28,6,64,92
"29442","2100-2159",2022-08-28,45,7,76,121
"29443","2100-2159",2022-08-29,43,1,75,118
"29444","2100-2159",2022-08-30,39,2,70,109
"29445","2100-2159",2022-08-31,40,3,69,109
"29446","2200-2259",2022-08-01,44,1,69,113
"29447","2200-2259",2022-08-02,38,2,59,97
"29448","2200-2259",2022-08-03,42,3,61,103
"29449","2200-2259",2022-08-04,45,4,69,114
"29450","2200-2259",2022-08-05,46,5,71,117
"29451","2200-2259",2022-08-06,41,6,55,96
"29452","2200-2259",2022-08-07,45,7,70,115
"29453","2200-2259",2022-08-08,44,1,69,113
"29454","2200-2259",2022-08-09,39,2,60,99
"29455","2200-2259",2022-08-10,40,3,62,102
"29456","2200-2259",2022-08-11,43,4,65,108
"29457","2200-2259",2022-08-12,45,5,67,112
"29458","2200-2259",2022-08-13,39,6,54,93
"29459","2200-2259",2022-08-14,43,7,67,110
"29460","2200-2259",2022-08-15,41,1,69,110
"29461","2200-2259",2022-08-16,34,2,60,94
"29462","2200-2259",2022-08-17,37,3,61,98
"29463","2200-2259",2022-08-18,39,4,67,106
"29464","2200-2259",2022-08-19,40,5,66,106
"29465","2200-2259",2022-08-20,39,6,53,92
"29466","2200-2259",2022-08-21,40,7,68,108
"29467","2200-2259",2022-08-22,38,1,64,102
"29468","2200-2259",2022-08-23,35,2,58,93
"29469","2200-2259",2022-08-24,38,3,62,100
"29470","2200-2259",2022-08-25,39,4,68,107
"29471","2200-2259",2022-08-26,40,5,66,106
"29472","2200-2259",2022-08-27,39,6,53,92
"29473","2200-2259",2022-08-28,40,7,68,108
"29474","2200-2259",2022-08-29,38,1,66,104
"29475","2200-2259",2022-08-30,35,2,62,97
"29476","2200-2259",2022-08-31,38,3,64,102
"29477","2300-2359",2022-08-01,27,1,54,81
"29478","2300-2359",2022-08-02,23,2,51,74
"29479","2300-2359",2022-08-03,22,3,52,74
"29480","2300-2359",2022-08-04,27,4,57,84
"29481","2300-2359",2022-08-05,27,5,55,82
"29482","2300-2359",2022-08-06,22,6,49,71
"29483","2300-2359",2022-08-07,28,7,57,85
"29484","2300-2359",2022-08-08,28,1,55,83
"29485","2300-2359",2022-08-09,24,2,54,78
"29486","2300-2359",2022-08-10,23,3,51,74
"29487","2300-2359",2022-08-11,26,4,56,82
"29488","2300-2359",2022-08-12,25,5,54,79
"29489","2300-2359",2022-08-13,22,6,47,69
"29490","2300-2359",2022-08-14,27,7,56,83
"29491","2300-2359",2022-08-15,23,1,53,76
"29492","2300-2359",2022-08-16,23,2,53,76
"29493","2300-2359",2022-08-17,23,3,52,75
"29494","2300-2359",2022-08-18,24,4,53,77
"29495","2300-2359",2022-08-19,23,5,52,75
"29496","2300-2359",2022-08-20,20,6,49,69
"29497","2300-2359",2022-08-21,25,7,53,78
"29498","2300-2359",2022-08-22,24,1,51,75
"29499","2300-2359",2022-08-23,22,2,53,75
"29500","2300-2359",2022-08-24,22,3,51,73
"29501","2300-2359",2022-08-25,25,4,53,78
"29502","2300-2359",2022-08-26,24,5,52,76
"29503","2300-2359",2022-08-27,21,6,50,71
"29504","2300-2359",2022-08-28,25,7,54,79
"29505","2300-2359",2022-08-29,25,1,51,76
"29506","2300-2359",2022-08-30,22,2,51,73
"29507","2300-2359",2022-08-31,23,3,50,73
"29508","0001-0559",2022-09-01,25,4,52,77
"29509","0001-0559",2022-09-02,27,5,52,79
"29510","0001-0559",2022-09-03,16,6,34,50
"29511","0001-0559",2022-09-04,19,7,42,61
"29512","0001-0559",2022-09-05,26,1,49,75
"29513","0001-0559",2022-09-06,26,2,39,65
"29514","0001-0559",2022-09-07,25,3,41,66
"29515","0001-0559",2022-09-08,25,4,48,73
"29516","0001-0559",2022-09-09,27,5,47,74
"29517","0001-0559",2022-09-10,18,6,37,55
"29518","0001-0559",2022-09-11,18,7,51,69
"29519","0001-0559",2022-09-12,27,1,47,74
"29520","0001-0559",2022-09-13,25,2,39,64
"29521","0001-0559",2022-09-14,24,3,41,65
"29522","0001-0559",2022-09-15,25,4,50,75
"29523","0001-0559",2022-09-16,27,5,48,75
"29524","0001-0559",2022-09-17,18,6,39,57
"29525","0001-0559",2022-09-18,17,7,54,71
"29526","0001-0559",2022-09-19,27,1,47,74
"29527","0001-0559",2022-09-20,25,2,37,62
"29528","0001-0559",2022-09-21,24,3,42,66
"29529","0001-0559",2022-09-22,25,4,50,75
"29530","0001-0559",2022-09-23,27,5,49,76
"29531","0001-0559",2022-09-24,18,6,39,57
"29532","0001-0559",2022-09-25,17,7,53,70
"29533","0001-0559",2022-09-26,27,1,47,74
"29534","0001-0559",2022-09-27,25,2,39,64
"29535","0001-0559",2022-09-28,24,3,41,65
"29536","0001-0559",2022-09-29,25,4,50,75
"29537","0001-0559",2022-09-30,28,5,51,79
"29538","0600-0659",2022-09-01,71,4,31,102
"29539","0600-0659",2022-09-02,72,5,32,104
"29540","0600-0659",2022-09-03,70,6,27,97
"29541","0600-0659",2022-09-04,63,7,25,88
"29542","0600-0659",2022-09-05,71,1,29,100
"29543","0600-0659",2022-09-06,64,2,23,87
"29544","0600-0659",2022-09-07,57,3,25,82
"29545","0600-0659",2022-09-08,65,4,25,90
"29546","0600-0659",2022-09-09,65,5,27,92
"29547","0600-0659",2022-09-10,69,6,28,97
"29548","0600-0659",2022-09-11,71,7,26,97
"29549","0600-0659",2022-09-12,65,1,27,92
"29550","0600-0659",2022-09-13,56,2,23,79
"29551","0600-0659",2022-09-14,56,3,24,80
"29552","0600-0659",2022-09-15,66,4,27,93
"29553","0600-0659",2022-09-16,64,5,28,92
"29554","0600-0659",2022-09-17,68,6,27,95
"29555","0600-0659",2022-09-18,71,7,27,98
"29556","0600-0659",2022-09-19,66,1,26,92
"29557","0600-0659",2022-09-20,55,2,23,78
"29558","0600-0659",2022-09-21,56,3,25,81
"29559","0600-0659",2022-09-22,65,4,26,91
"29560","0600-0659",2022-09-23,64,5,28,92
"29561","0600-0659",2022-09-24,68,6,26,94
"29562","0600-0659",2022-09-25,71,7,26,97
"29563","0600-0659",2022-09-26,65,1,27,92
"29564","0600-0659",2022-09-27,56,2,23,79
"29565","0600-0659",2022-09-28,56,3,25,81
"29566","0600-0659",2022-09-29,66,4,26,92
"29567","0600-0659",2022-09-30,62,5,26,88
"29568","0700-0759",2022-09-01,85,4,52,137
"29569","0700-0759",2022-09-02,85,5,52,137
"29570","0700-0759",2022-09-03,67,6,42,109
"29571","0700-0759",2022-09-04,75,7,43,118
"29572","0700-0759",2022-09-05,86,1,52,138
"29573","0700-0759",2022-09-06,77,2,41,118
"29574","0700-0759",2022-09-07,76,3,34,110
"29575","0700-0759",2022-09-08,90,4,42,132
"29576","0700-0759",2022-09-09,85,5,44,129
"29577","0700-0759",2022-09-10,75,6,44,119
"29578","0700-0759",2022-09-11,79,7,41,120
"29579","0700-0759",2022-09-12,85,1,43,128
"29580","0700-0759",2022-09-13,81,2,37,118
"29581","0700-0759",2022-09-14,78,3,34,112
"29582","0700-0759",2022-09-15,86,4,44,130
"29583","0700-0759",2022-09-16,85,5,44,129
"29584","0700-0759",2022-09-17,71,6,41,112
"29585","0700-0759",2022-09-18,77,7,40,117
"29586","0700-0759",2022-09-19,86,1,44,130
"29587","0700-0759",2022-09-20,80,2,36,116
"29588","0700-0759",2022-09-21,78,3,34,112
"29589","0700-0759",2022-09-22,87,4,44,131
"29590","0700-0759",2022-09-23,83,5,44,127
"29591","0700-0759",2022-09-24,71,6,41,112
"29592","0700-0759",2022-09-25,78,7,40,118
"29593","0700-0759",2022-09-26,84,1,44,128
"29594","0700-0759",2022-09-27,81,2,36,117
"29595","0700-0759",2022-09-28,78,3,34,112
"29596","0700-0759",2022-09-29,88,4,44,132
"29597","0700-0759",2022-09-30,82,5,45,127
"29598","0800-0859",2022-09-01,88,4,40,128
"29599","0800-0859",2022-09-02,88,5,41,129
"29600","0800-0859",2022-09-03,83,6,37,120
"29601","0800-0859",2022-09-04,89,7,38,127
"29602","0800-0859",2022-09-05,87,1,42,129
"29603","0800-0859",2022-09-06,85,2,40,125
"29604","0800-0859",2022-09-07,90,3,42,132
"29605","0800-0859",2022-09-08,91,4,45,136
"29606","0800-0859",2022-09-09,96,5,43,139
"29607","0800-0859",2022-09-10,92,6,38,130
"29608","0800-0859",2022-09-11,91,7,40,131
"29609","0800-0859",2022-09-12,92,1,43,135
"29610","0800-0859",2022-09-13,88,2,38,126
"29611","0800-0859",2022-09-14,88,3,41,129
"29612","0800-0859",2022-09-15,91,4,41,132
"29613","0800-0859",2022-09-16,95,5,41,136
"29614","0800-0859",2022-09-17,90,6,37,127
"29615","0800-0859",2022-09-18,91,7,38,129
"29616","0800-0859",2022-09-19,92,1,44,136
"29617","0800-0859",2022-09-20,88,2,37,125
"29618","0800-0859",2022-09-21,88,3,40,128
"29619","0800-0859",2022-09-22,90,4,40,130
"29620","0800-0859",2022-09-23,95,5,41,136
"29621","0800-0859",2022-09-24,88,6,37,125
"29622","0800-0859",2022-09-25,91,7,38,129
"29623","0800-0859",2022-09-26,92,1,43,135
"29624","0800-0859",2022-09-27,88,2,37,125
"29625","0800-0859",2022-09-28,88,3,40,128
"29626","0800-0859",2022-09-29,90,4,40,130
"29627","0800-0859",2022-09-30,93,5,40,133
"29628","0900-0959",2022-09-01,57,4,67,124
"29629","0900-0959",2022-09-02,59,5,68,127
"29630","0900-0959",2022-09-03,54,6,60,114
"29631","0900-0959",2022-09-04,50,7,56,106
"29632","0900-0959",2022-09-05,61,1,66,127
"29633","0900-0959",2022-09-06,52,2,58,110
"29634","0900-0959",2022-09-07,50,3,54,104
"29635","0900-0959",2022-09-08,52,4,61,113
"29636","0900-0959",2022-09-09,51,5,60,111
"29637","0900-0959",2022-09-10,45,6,61,106
"29638","0900-0959",2022-09-11,51,7,54,105
"29639","0900-0959",2022-09-12,53,1,63,116
"29640","0900-0959",2022-09-13,51,2,57,108
"29641","0900-0959",2022-09-14,52,3,55,107
"29642","0900-0959",2022-09-15,53,4,63,116
"29643","0900-0959",2022-09-16,52,5,64,116
"29644","0900-0959",2022-09-17,47,6,62,109
"29645","0900-0959",2022-09-18,52,7,58,110
"29646","0900-0959",2022-09-19,53,1,64,117
"29647","0900-0959",2022-09-20,51,2,56,107
"29648","0900-0959",2022-09-21,51,3,56,107
"29649","0900-0959",2022-09-22,53,4,63,116
"29650","0900-0959",2022-09-23,53,5,62,115
"29651","0900-0959",2022-09-24,48,6,62,110
"29652","0900-0959",2022-09-25,52,7,59,111
"29653","0900-0959",2022-09-26,52,1,63,115
"29654","0900-0959",2022-09-27,50,2,58,108
"29655","0900-0959",2022-09-28,51,3,56,107
"29656","0900-0959",2022-09-29,52,4,65,117
"29657","0900-0959",2022-09-30,54,5,64,118
"29658","1000-1059",2022-09-01,84,4,42,126
"29659","1000-1059",2022-09-02,84,5,43,127
"29660","1000-1059",2022-09-03,73,6,43,116
"29661","1000-1059",2022-09-04,79,7,45,124
"29662","1000-1059",2022-09-05,82,1,44,126
"29663","1000-1059",2022-09-06,71,2,48,119
"29664","1000-1059",2022-09-07,71,3,49,120
"29665","1000-1059",2022-09-08,75,4,52,127
"29666","1000-1059",2022-09-09,73,5,52,125
"29667","1000-1059",2022-09-10,75,6,41,116
"29668","1000-1059",2022-09-11,70,7,46,116
"29669","1000-1059",2022-09-12,76,1,50,126
"29670","1000-1059",2022-09-13,74,2,47,121
"29671","1000-1059",2022-09-14,74,3,46,120
"29672","1000-1059",2022-09-15,77,4,51,128
"29673","1000-1059",2022-09-16,76,5,50,126
"29674","1000-1059",2022-09-17,74,6,42,116
"29675","1000-1059",2022-09-18,72,7,44,116
"29676","1000-1059",2022-09-19,77,1,50,127
"29677","1000-1059",2022-09-20,73,2,47,120
"29678","1000-1059",2022-09-21,73,3,46,119
"29679","1000-1059",2022-09-22,77,4,51,128
"29680","1000-1059",2022-09-23,76,5,51,127
"29681","1000-1059",2022-09-24,74,6,41,115
"29682","1000-1059",2022-09-25,73,7,44,117
"29683","1000-1059",2022-09-26,76,1,49,125
"29684","1000-1059",2022-09-27,75,2,47,122
"29685","1000-1059",2022-09-28,74,3,46,120
"29686","1000-1059",2022-09-29,78,4,50,128
"29687","1000-1059",2022-09-30,76,5,50,126
"29688","1100-1159",2022-09-01,51,4,63,114
"29689","1100-1159",2022-09-02,50,5,65,115
"29690","1100-1159",2022-09-03,43,6,51,94
"29691","1100-1159",2022-09-04,53,7,62,115
"29692","1100-1159",2022-09-05,52,1,64,116
"29693","1100-1159",2022-09-06,56,2,58,114
"29694","1100-1159",2022-09-07,53,3,59,112
"29695","1100-1159",2022-09-08,59,4,57,116
"29696","1100-1159",2022-09-09,61,5,60,121
"29697","1100-1159",2022-09-10,48,6,64,112
"29698","1100-1159",2022-09-11,60,7,63,123
"29699","1100-1159",2022-09-12,60,1,58,118
"29700","1100-1159",2022-09-13,56,2,59,115
"29701","1100-1159",2022-09-14,53,3,58,111
"29702","1100-1159",2022-09-15,60,4,57,117
"29703","1100-1159",2022-09-16,60,5,59,119
"29704","1100-1159",2022-09-17,48,6,59,107
"29705","1100-1159",2022-09-18,60,7,60,120
"29706","1100-1159",2022-09-19,60,1,58,118
"29707","1100-1159",2022-09-20,56,2,59,115
"29708","1100-1159",2022-09-21,54,3,57,111
"29709","1100-1159",2022-09-22,60,4,57,117
"29710","1100-1159",2022-09-23,60,5,59,119
"29711","1100-1159",2022-09-24,48,6,60,108
"29712","1100-1159",2022-09-25,60,7,60,120
"29713","1100-1159",2022-09-26,60,1,58,118
"29714","1100-1159",2022-09-27,56,2,58,114
"29715","1100-1159",2022-09-28,54,3,57,111
"29716","1100-1159",2022-09-29,61,4,56,117
"29717","1100-1159",2022-09-30,61,5,59,120
"29718","1200-1259",2022-09-01,64,4,57,121
"29719","1200-1259",2022-09-02,63,5,58,121
"29720","1200-1259",2022-09-03,57,6,48,105
"29721","1200-1259",2022-09-04,63,7,55,118
"29722","1200-1259",2022-09-05,62,1,59,121
"29723","1200-1259",2022-09-06,60,2,47,107
"29724","1200-1259",2022-09-07,59,3,51,110
"29725","1200-1259",2022-09-08,61,4,56,117
"29726","1200-1259",2022-09-09,62,5,55,117
"29727","1200-1259",2022-09-10,53,6,47,100
"29728","1200-1259",2022-09-11,57,7,56,113
"29729","1200-1259",2022-09-12,61,1,59,120
"29730","1200-1259",2022-09-13,56,2,56,112
"29731","1200-1259",2022-09-14,57,3,56,113
"29732","1200-1259",2022-09-15,61,4,59,120
"29733","1200-1259",2022-09-16,62,5,59,121
"29734","1200-1259",2022-09-17,52,6,50,102
"29735","1200-1259",2022-09-18,55,7,60,115
"29736","1200-1259",2022-09-19,61,1,59,120
"29737","1200-1259",2022-09-20,57,2,55,112
"29738","1200-1259",2022-09-21,57,3,55,112
"29739","1200-1259",2022-09-22,61,4,58,119
"29740","1200-1259",2022-09-23,62,5,59,121
"29741","1200-1259",2022-09-24,53,6,50,103
"29742","1200-1259",2022-09-25,55,7,61,116
"29743","1200-1259",2022-09-26,61,1,57,118
"29744","1200-1259",2022-09-27,56,2,55,111
"29745","1200-1259",2022-09-28,56,3,55,111
"29746","1200-1259",2022-09-29,61,4,59,120
"29747","1200-1259",2022-09-30,61,5,56,117
"29748","1300-1359",2022-09-01,62,4,68,130
"29749","1300-1359",2022-09-02,63,5,66,129
"29750","1300-1359",2022-09-03,47,6,54,101
"29751","1300-1359",2022-09-04,59,7,62,121
"29752","1300-1359",2022-09-05,63,1,65,128
"29753","1300-1359",2022-09-06,57,2,68,125
"29754","1300-1359",2022-09-07,55,3,63,118
"29755","1300-1359",2022-09-08,61,4,71,132
"29756","1300-1359",2022-09-09,58,5,70,128
"29757","1300-1359",2022-09-10,54,6,59,113
"29758","1300-1359",2022-09-11,62,7,63,125
"29759","1300-1359",2022-09-12,64,1,64,128
"29760","1300-1359",2022-09-13,60,2,62,122
"29761","1300-1359",2022-09-14,59,3,59,118
"29762","1300-1359",2022-09-15,64,4,66,130
"29763","1300-1359",2022-09-16,62,5,64,126
"29764","1300-1359",2022-09-17,56,6,52,108
"29765","1300-1359",2022-09-18,65,7,58,123
"29766","1300-1359",2022-09-19,64,1,65,129
"29767","1300-1359",2022-09-20,59,2,63,122
"29768","1300-1359",2022-09-21,58,3,60,118
"29769","1300-1359",2022-09-22,63,4,67,130
"29770","1300-1359",2022-09-23,62,5,64,126
"29771","1300-1359",2022-09-24,56,6,53,109
"29772","1300-1359",2022-09-25,65,7,58,123
"29773","1300-1359",2022-09-26,63,1,66,129
"29774","1300-1359",2022-09-27,59,2,62,121
"29775","1300-1359",2022-09-28,58,3,60,118
"29776","1300-1359",2022-09-29,62,4,67,129
"29777","1300-1359",2022-09-30,60,5,65,125
"29778","1400-1459",2022-09-01,60,4,64,124
"29779","1400-1459",2022-09-02,59,5,63,122
"29780","1400-1459",2022-09-03,56,6,58,114
"29781","1400-1459",2022-09-04,58,7,61,119
"29782","1400-1459",2022-09-05,58,1,65,123
"29783","1400-1459",2022-09-06,52,2,54,106
"29784","1400-1459",2022-09-07,47,3,51,98
"29785","1400-1459",2022-09-08,54,4,56,110
"29786","1400-1459",2022-09-09,59,5,60,119
"29787","1400-1459",2022-09-10,49,6,50,99
"29788","1400-1459",2022-09-11,51,7,58,109
"29789","1400-1459",2022-09-12,54,1,62,116
"29790","1400-1459",2022-09-13,46,2,57,103
"29791","1400-1459",2022-09-14,45,3,55,100
"29792","1400-1459",2022-09-15,52,4,60,112
"29793","1400-1459",2022-09-16,56,5,64,120
"29794","1400-1459",2022-09-17,43,6,52,95
"29795","1400-1459",2022-09-18,48,7,61,109
"29796","1400-1459",2022-09-19,54,1,62,116
"29797","1400-1459",2022-09-20,47,2,57,104
"29798","1400-1459",2022-09-21,45,3,55,100
"29799","1400-1459",2022-09-22,54,4,60,114
"29800","1400-1459",2022-09-23,56,5,64,120
"29801","1400-1459",2022-09-24,44,6,51,95
"29802","1400-1459",2022-09-25,49,7,61,110
"29803","1400-1459",2022-09-26,55,1,62,117
"29804","1400-1459",2022-09-27,46,2,57,103
"29805","1400-1459",2022-09-28,45,3,55,100
"29806","1400-1459",2022-09-29,53,4,61,114
"29807","1400-1459",2022-09-30,57,5,65,122
"29808","1500-1559",2022-09-01,56,4,60,116
"29809","1500-1559",2022-09-02,56,5,57,113
"29810","1500-1559",2022-09-03,50,6,52,102
"29811","1500-1559",2022-09-04,56,7,60,116
"29812","1500-1559",2022-09-05,56,1,57,113
"29813","1500-1559",2022-09-06,51,2,55,106
"29814","1500-1559",2022-09-07,53,3,54,107
"29815","1500-1559",2022-09-08,56,4,64,120
"29816","1500-1559",2022-09-09,58,5,59,117
"29817","1500-1559",2022-09-10,50,6,53,103
"29818","1500-1559",2022-09-11,55,7,57,112
"29819","1500-1559",2022-09-12,57,1,61,118
"29820","1500-1559",2022-09-13,53,2,53,106
"29821","1500-1559",2022-09-14,51,3,55,106
"29822","1500-1559",2022-09-15,56,4,64,120
"29823","1500-1559",2022-09-16,58,5,60,118
"29824","1500-1559",2022-09-17,47,6,53,100
"29825","1500-1559",2022-09-18,54,7,57,111
"29826","1500-1559",2022-09-19,57,1,62,119
"29827","1500-1559",2022-09-20,54,2,54,108
"29828","1500-1559",2022-09-21,53,3,55,108
"29829","1500-1559",2022-09-22,56,4,64,120
"29830","1500-1559",2022-09-23,57,5,60,117
"29831","1500-1559",2022-09-24,48,6,54,102
"29832","1500-1559",2022-09-25,54,7,57,111
"29833","1500-1559",2022-09-26,57,1,61,118
"29834","1500-1559",2022-09-27,54,2,53,107
"29835","1500-1559",2022-09-28,53,3,54,107
"29836","1500-1559",2022-09-29,58,4,63,121
"29837","1500-1559",2022-09-30,58,5,59,117
"29838","1600-1659",2022-09-01,62,4,63,125
"29839","1600-1659",2022-09-02,61,5,64,125
"29840","1600-1659",2022-09-03,49,6,52,101
"29841","1600-1659",2022-09-04,60,7,64,124
"29842","1600-1659",2022-09-05,59,1,63,122
"29843","1600-1659",2022-09-06,48,2,58,106
"29844","1600-1659",2022-09-07,55,3,60,115
"29845","1600-1659",2022-09-08,61,4,60,121
"29846","1600-1659",2022-09-09,59,5,63,122
"29847","1600-1659",2022-09-10,59,6,54,113
"29848","1600-1659",2022-09-11,61,7,58,119
"29849","1600-1659",2022-09-12,61,1,64,125
"29850","1600-1659",2022-09-13,53,2,64,117
"29851","1600-1659",2022-09-14,56,3,60,116
"29852","1600-1659",2022-09-15,63,4,64,127
"29853","1600-1659",2022-09-16,61,5,66,127
"29854","1600-1659",2022-09-17,57,6,54,111
"29855","1600-1659",2022-09-18,60,7,59,119
"29856","1600-1659",2022-09-19,60,1,63,123
"29857","1600-1659",2022-09-20,52,2,63,115
"29858","1600-1659",2022-09-21,54,3,60,114
"29859","1600-1659",2022-09-22,62,4,64,126
"29860","1600-1659",2022-09-23,62,5,66,128
"29861","1600-1659",2022-09-24,58,6,54,112
"29862","1600-1659",2022-09-25,60,7,60,120
"29863","1600-1659",2022-09-26,61,1,62,123
"29864","1600-1659",2022-09-27,52,2,63,115
"29865","1600-1659",2022-09-28,54,3,60,114
"29866","1600-1659",2022-09-29,61,4,64,125
"29867","1600-1659",2022-09-30,63,5,64,127
"29868","1700-1759",2022-09-01,70,4,53,123
"29869","1700-1759",2022-09-02,70,5,52,122
"29870","1700-1759",2022-09-03,48,6,48,96
"29871","1700-1759",2022-09-04,61,7,49,110
"29872","1700-1759",2022-09-05,70,1,52,122
"29873","1700-1759",2022-09-06,63,2,59,122
"29874","1700-1759",2022-09-07,56,3,54,110
"29875","1700-1759",2022-09-08,68,4,61,129
"29876","1700-1759",2022-09-09,68,5,60,128
"29877","1700-1759",2022-09-10,48,6,55,103
"29878","1700-1759",2022-09-11,66,7,58,124
"29879","1700-1759",2022-09-12,68,1,58,126
"29880","1700-1759",2022-09-13,56,2,49,105
"29881","1700-1759",2022-09-14,56,3,50,106
"29882","1700-1759",2022-09-15,68,4,56,124
"29883","1700-1759",2022-09-16,69,5,57,126
"29884","1700-1759",2022-09-17,50,6,51,101
"29885","1700-1759",2022-09-18,67,7,55,122
"29886","1700-1759",2022-09-19,68,1,58,126
"29887","1700-1759",2022-09-20,56,2,51,107
"29888","1700-1759",2022-09-21,56,3,52,108
"29889","1700-1759",2022-09-22,69,4,57,126
"29890","1700-1759",2022-09-23,69,5,57,126
"29891","1700-1759",2022-09-24,50,6,52,102
"29892","1700-1759",2022-09-25,67,7,55,122
"29893","1700-1759",2022-09-26,68,1,59,127
"29894","1700-1759",2022-09-27,56,2,51,107
"29895","1700-1759",2022-09-28,56,3,52,108
"29896","1700-1759",2022-09-29,69,4,55,124
"29897","1700-1759",2022-09-30,69,5,58,127
"29898","1800-1859",2022-09-01,63,4,77,140
"29899","1800-1859",2022-09-02,61,5,75,136
"29900","1800-1859",2022-09-03,46,6,60,106
"29901","1800-1859",2022-09-04,55,7,71,126
"29902","1800-1859",2022-09-05,61,1,77,138
"29903","1800-1859",2022-09-06,53,2,58,111
"29904","1800-1859",2022-09-07,55,3,62,117
"29905","1800-1859",2022-09-08,65,4,66,131
"29906","1800-1859",2022-09-09,63,5,68,131
"29907","1800-1859",2022-09-10,56,6,58,114
"29908","1800-1859",2022-09-11,65,7,70,135
"29909","1800-1859",2022-09-12,65,1,70,135
"29910","1800-1859",2022-09-13,56,2,62,118
"29911","1800-1859",2022-09-14,54,3,64,118
"29912","1800-1859",2022-09-15,65,4,70,135
"29913","1800-1859",2022-09-16,63,5,71,134
"29914","1800-1859",2022-09-17,56,6,59,115
"29915","1800-1859",2022-09-18,64,7,71,135
"29916","1800-1859",2022-09-19,65,1,70,135
"29917","1800-1859",2022-09-20,56,2,61,117
"29918","1800-1859",2022-09-21,55,3,63,118
"29919","1800-1859",2022-09-22,65,4,70,135
"29920","1800-1859",2022-09-23,63,5,71,134
"29921","1800-1859",2022-09-24,58,6,59,117
"29922","1800-1859",2022-09-25,64,7,71,135
"29923","1800-1859",2022-09-26,65,1,70,135
"29924","1800-1859",2022-09-27,56,2,63,119
"29925","1800-1859",2022-09-28,55,3,63,118
"29926","1800-1859",2022-09-29,65,4,71,136
"29927","1800-1859",2022-09-30,66,5,72,138
"29928","1900-1959",2022-09-01,59,4,53,112
"29929","1900-1959",2022-09-02,58,5,55,113
"29930","1900-1959",2022-09-03,42,6,47,89
"29931","1900-1959",2022-09-04,48,7,51,99
"29932","1900-1959",2022-09-05,57,1,53,110
"29933","1900-1959",2022-09-06,49,2,49,98
"29934","1900-1959",2022-09-07,41,3,49,90
"29935","1900-1959",2022-09-08,56,4,63,119
"29936","1900-1959",2022-09-09,56,5,61,117
"29937","1900-1959",2022-09-10,49,6,57,106
"29938","1900-1959",2022-09-11,58,7,57,115
"29939","1900-1959",2022-09-12,61,1,63,124
"29940","1900-1959",2022-09-13,46,2,50,96
"29941","1900-1959",2022-09-14,45,3,51,96
"29942","1900-1959",2022-09-15,62,4,65,127
"29943","1900-1959",2022-09-16,62,5,62,124
"29944","1900-1959",2022-09-17,51,6,58,109
"29945","1900-1959",2022-09-18,58,7,60,118
"29946","1900-1959",2022-09-19,61,1,62,123
"29947","1900-1959",2022-09-20,47,2,49,96
"29948","1900-1959",2022-09-21,45,3,50,95
"29949","1900-1959",2022-09-22,62,4,64,126
"29950","1900-1959",2022-09-23,62,5,62,124
"29951","1900-1959",2022-09-24,51,6,60,111
"29952","1900-1959",2022-09-25,57,7,59,116
"29953","1900-1959",2022-09-26,61,1,63,124
"29954","1900-1959",2022-09-27,47,2,50,97
"29955","1900-1959",2022-09-28,45,3,51,96
"29956","1900-1959",2022-09-29,62,4,66,128
"29957","1900-1959",2022-09-30,63,5,66,129
"29958","2000-2059",2022-09-01,49,4,76,125
"29959","2000-2059",2022-09-02,49,5,74,123
"29960","2000-2059",2022-09-03,36,6,62,98
"29961","2000-2059",2022-09-04,44,7,73,117
"29962","2000-2059",2022-09-05,47,1,74,121
"29963","2000-2059",2022-09-06,38,2,70,108
"29964","2000-2059",2022-09-07,46,3,68,114
"29965","2000-2059",2022-09-08,54,4,80,134
"29966","2000-2059",2022-09-09,51,5,78,129
"29967","2000-2059",2022-09-10,35,6,61,96
"29968","2000-2059",2022-09-11,55,7,81,136
"29969","2000-2059",2022-09-12,55,1,79,134
"29970","2000-2059",2022-09-13,47,2,73,120
"29971","2000-2059",2022-09-14,49,3,71,120
"29972","2000-2059",2022-09-15,58,4,80,138
"29973","2000-2059",2022-09-16,55,5,80,135
"29974","2000-2059",2022-09-17,36,6,59,95
"29975","2000-2059",2022-09-18,57,7,81,138
"29976","2000-2059",2022-09-19,56,1,79,135
"29977","2000-2059",2022-09-20,47,2,73,120
"29978","2000-2059",2022-09-21,50,3,71,121
"29979","2000-2059",2022-09-22,58,4,80,138
"29980","2000-2059",2022-09-23,55,5,80,135
"29981","2000-2059",2022-09-24,36,6,59,95
"29982","2000-2059",2022-09-25,57,7,80,137
"29983","2000-2059",2022-09-26,56,1,79,135
"29984","2000-2059",2022-09-27,47,2,73,120
"29985","2000-2059",2022-09-28,50,3,71,121
"29986","2000-2059",2022-09-29,58,4,81,139
"29987","2000-2059",2022-09-30,57,5,79,136
"29988","2100-2159",2022-09-01,45,4,78,123
"29989","2100-2159",2022-09-02,44,5,78,122
"29990","2100-2159",2022-09-03,28,6,53,81
"29991","2100-2159",2022-09-04,36,7,71,107
"29992","2100-2159",2022-09-05,46,1,73,119
"29993","2100-2159",2022-09-06,34,2,60,94
"29994","2100-2159",2022-09-07,35,3,58,93
"29995","2100-2159",2022-09-08,40,4,69,109
"29996","2100-2159",2022-09-09,42,5,69,111
"29997","2100-2159",2022-09-10,26,6,59,85
"29998","2100-2159",2022-09-11,40,7,68,108
"29999","2100-2159",2022-09-12,41,1,73,114
"30000","2100-2159",2022-09-13,34,2,61,95
"30001","2100-2159",2022-09-14,35,3,57,92
"30002","2100-2159",2022-09-15,41,4,73,114
"30003","2100-2159",2022-09-16,41,5,71,112
"30004","2100-2159",2022-09-17,26,6,62,88
"30005","2100-2159",2022-09-18,40,7,67,107
"30006","2100-2159",2022-09-19,41,1,72,113
"30007","2100-2159",2022-09-20,33,2,61,94
"30008","2100-2159",2022-09-21,35,3,58,93
"30009","2100-2159",2022-09-22,40,4,73,113
"30010","2100-2159",2022-09-23,42,5,71,113
"30011","2100-2159",2022-09-24,27,6,62,89
"30012","2100-2159",2022-09-25,40,7,67,107
"30013","2100-2159",2022-09-26,41,1,73,114
"30014","2100-2159",2022-09-27,34,2,60,94
"30015","2100-2159",2022-09-28,35,3,60,95
"30016","2100-2159",2022-09-29,40,4,73,113
"30017","2100-2159",2022-09-30,44,5,76,120
"30018","2200-2259",2022-09-01,40,4,68,108
"30019","2200-2259",2022-09-02,40,5,67,107
"30020","2200-2259",2022-09-03,32,6,45,77
"30021","2200-2259",2022-09-04,35,7,57,92
"30022","2200-2259",2022-09-05,33,1,66,99
"30023","2200-2259",2022-09-06,31,2,54,85
"30024","2200-2259",2022-09-07,34,3,52,86
"30025","2200-2259",2022-09-08,38,4,59,97
"30026","2200-2259",2022-09-09,39,5,60,99
"30027","2200-2259",2022-09-10,35,6,47,82
"30028","2200-2259",2022-09-11,38,7,64,102
"30029","2200-2259",2022-09-12,37,1,61,98
"30030","2200-2259",2022-09-13,33,2,53,86
"30031","2200-2259",2022-09-14,34,3,53,87
"30032","2200-2259",2022-09-15,41,4,61,102
"30033","2200-2259",2022-09-16,42,5,62,104
"30034","2200-2259",2022-09-17,35,6,44,79
"30035","2200-2259",2022-09-18,41,7,61,102
"30036","2200-2259",2022-09-19,36,1,62,98
"30037","2200-2259",2022-09-20,33,2,53,86
"30038","2200-2259",2022-09-21,36,3,53,89
"30039","2200-2259",2022-09-22,40,4,61,101
"30040","2200-2259",2022-09-23,40,5,62,102
"30041","2200-2259",2022-09-24,34,6,45,79
"30042","2200-2259",2022-09-25,39,7,62,101
"30043","2200-2259",2022-09-26,37,1,61,98
"30044","2200-2259",2022-09-27,33,2,53,86
"30045","2200-2259",2022-09-28,35,3,51,86
"30046","2200-2259",2022-09-29,41,4,61,102
"30047","2200-2259",2022-09-30,39,5,61,100
"30048","2300-2359",2022-09-01,25,4,52,77
"30049","2300-2359",2022-09-02,25,5,52,77
"30050","2300-2359",2022-09-03,18,6,42,60
"30051","2300-2359",2022-09-04,22,7,40,62
"30052","2300-2359",2022-09-05,25,1,52,77
"30053","2300-2359",2022-09-06,19,2,47,66
"30054","2300-2359",2022-09-07,15,3,47,62
"30055","2300-2359",2022-09-08,18,4,54,72
"30056","2300-2359",2022-09-09,17,5,54,71
"30057","2300-2359",2022-09-10,17,6,40,57
"30058","2300-2359",2022-09-11,19,7,56,75
"30059","2300-2359",2022-09-12,18,1,55,73
"30060","2300-2359",2022-09-13,15,2,46,61
"30061","2300-2359",2022-09-14,14,3,50,64
"30062","2300-2359",2022-09-15,19,4,57,76
"30063","2300-2359",2022-09-16,17,5,57,74
"30064","2300-2359",2022-09-17,17,6,41,58
"30065","2300-2359",2022-09-18,19,7,57,76
"30066","2300-2359",2022-09-19,19,1,56,75
"30067","2300-2359",2022-09-20,13,2,47,60
"30068","2300-2359",2022-09-21,14,3,50,64
"30069","2300-2359",2022-09-22,19,4,57,76
"30070","2300-2359",2022-09-23,19,5,57,76
"30071","2300-2359",2022-09-24,17,6,42,59
"30072","2300-2359",2022-09-25,19,7,57,76
"30073","2300-2359",2022-09-26,19,1,56,75
"30074","2300-2359",2022-09-27,14,2,47,61
"30075","2300-2359",2022-09-28,14,3,50,64
"30076","2300-2359",2022-09-29,19,4,57,76
"30077","2300-2359",2022-09-30,22,5,59,81
"30078","0001-0559",2022-10-01,17,6,40,57
"30079","0001-0559",2022-10-02,18,7,51,69
"30080","0001-0559",2022-10-03,27,1,45,72
"30081","0001-0559",2022-10-04,25,2,38,63
"30082","0001-0559",2022-10-05,24,3,40,64
"30083","0001-0559",2022-10-06,27,4,50,77
"30084","0001-0559",2022-10-07,27,5,49,76
"30085","0001-0559",2022-10-08,18,6,40,58
"30086","0001-0559",2022-10-09,18,7,52,70
"30087","0001-0559",2022-10-10,27,1,45,72
"30088","0001-0559",2022-10-11,28,2,42,70
"30089","0001-0559",2022-10-12,26,3,44,70
"30090","0001-0559",2022-10-13,27,4,50,77
"30091","0001-0559",2022-10-14,27,5,49,76
"30092","0001-0559",2022-10-15,18,6,39,57
"30093","0001-0559",2022-10-16,18,7,52,70
"30094","0001-0559",2022-10-17,27,1,45,72
"30095","0001-0559",2022-10-18,28,2,42,70
"30096","0001-0559",2022-10-19,26,3,44,70
"30097","0001-0559",2022-10-20,27,4,52,79
"30098","0001-0559",2022-10-21,28,5,50,78
"30099","0001-0559",2022-10-22,18,6,40,58
"30100","0001-0559",2022-10-23,18,7,53,71
"30101","0001-0559",2022-10-24,27,1,49,76
"30102","0001-0559",2022-10-25,28,2,42,70
"30103","0001-0559",2022-10-26,26,3,44,70
"30104","0001-0559",2022-10-27,26,4,49,75
"30105","0001-0559",2022-10-28,26,5,47,73
"30106","0001-0559",2022-10-29,17,6,39,56
"30107","0001-0559",2022-10-30,19,7,52,71
"30108","0001-0559",2022-10-31,28,1,44,72
"30109","0600-0659",2022-10-01,65,6,24,89
"30110","0600-0659",2022-10-02,70,7,25,95
"30111","0600-0659",2022-10-03,67,1,25,92
"30112","0600-0659",2022-10-04,56,2,21,77
"30113","0600-0659",2022-10-05,57,3,25,82
"30114","0600-0659",2022-10-06,72,4,25,97
"30115","0600-0659",2022-10-07,67,5,25,92
"30116","0600-0659",2022-10-08,62,6,23,85
"30117","0600-0659",2022-10-09,71,7,26,97
"30118","0600-0659",2022-10-10,68,1,23,91
"30119","0600-0659",2022-10-11,62,2,21,83
"30120","0600-0659",2022-10-12,62,3,22,84
"30121","0600-0659",2022-10-13,69,4,25,94
"30122","0600-0659",2022-10-14,67,5,25,92
"30123","0600-0659",2022-10-15,62,6,22,84
"30124","0600-0659",2022-10-16,71,7,25,96
"30125","0600-0659",2022-10-17,68,1,24,92
"30126","0600-0659",2022-10-18,62,2,22,84
"30127","0600-0659",2022-10-19,62,3,23,85
"30128","0600-0659",2022-10-20,72,4,26,98
"30129","0600-0659",2022-10-21,67,5,27,94
"30130","0600-0659",2022-10-22,62,6,22,84
"30131","0600-0659",2022-10-23,71,7,26,97
"30132","0600-0659",2022-10-24,68,1,24,92
"30133","0600-0659",2022-10-25,62,2,22,84
"30134","0600-0659",2022-10-26,62,3,23,85
"30135","0600-0659",2022-10-27,69,4,26,95
"30136","0600-0659",2022-10-28,67,5,25,92
"30137","0600-0659",2022-10-29,61,6,21,82
"30138","0600-0659",2022-10-30,69,7,21,90
"30139","0600-0659",2022-10-31,62,1,17,79
"30140","0700-0759",2022-10-01,71,6,41,112
"30141","0700-0759",2022-10-02,78,7,42,120
"30142","0700-0759",2022-10-03,83,1,47,130
"30143","0700-0759",2022-10-04,79,2,38,117
"30144","0700-0759",2022-10-05,77,3,36,113
"30145","0700-0759",2022-10-06,77,4,47,124
"30146","0700-0759",2022-10-07,78,5,47,125
"30147","0700-0759",2022-10-08,69,6,40,109
"30148","0700-0759",2022-10-09,71,7,41,112
"30149","0700-0759",2022-10-10,79,1,48,127
"30150","0700-0759",2022-10-11,75,2,44,119
"30151","0700-0759",2022-10-12,74,3,44,118
"30152","0700-0759",2022-10-13,79,4,47,126
"30153","0700-0759",2022-10-14,79,5,47,126
"30154","0700-0759",2022-10-15,69,6,41,110
"30155","0700-0759",2022-10-16,70,7,42,112
"30156","0700-0759",2022-10-17,78,1,47,125
"30157","0700-0759",2022-10-18,74,2,43,117
"30158","0700-0759",2022-10-19,73,3,43,116
"30159","0700-0759",2022-10-20,77,4,47,124
"30160","0700-0759",2022-10-21,78,5,46,124
"30161","0700-0759",2022-10-22,69,6,41,110
"30162","0700-0759",2022-10-23,70,7,41,111
"30163","0700-0759",2022-10-24,79,1,47,126
"30164","0700-0759",2022-10-25,74,2,43,117
"30165","0700-0759",2022-10-26,73,3,43,116
"30166","0700-0759",2022-10-27,78,4,46,124
"30167","0700-0759",2022-10-28,79,5,45,124
"30168","0700-0759",2022-10-29,71,6,40,111
"30169","0700-0759",2022-10-30,70,7,39,109
"30170","0700-0759",2022-10-31,81,1,44,125
"30171","0800-0859",2022-10-01,85,6,37,122
"30172","0800-0859",2022-10-02,86,7,39,125
"30173","0800-0859",2022-10-03,88,1,41,129
"30174","0800-0859",2022-10-04,86,2,36,122
"30175","0800-0859",2022-10-05,83,3,40,123
"30176","0800-0859",2022-10-06,85,4,41,126
"30177","0800-0859",2022-10-07,89,5,43,132
"30178","0800-0859",2022-10-08,85,6,38,123
"30179","0800-0859",2022-10-09,84,7,35,119
"30180","0800-0859",2022-10-10,89,1,44,133
"30181","0800-0859",2022-10-11,88,2,41,129
"30182","0800-0859",2022-10-12,86,3,40,126
"30183","0800-0859",2022-10-13,86,4,41,127
"30184","0800-0859",2022-10-14,89,5,43,132
"30185","0800-0859",2022-10-15,84,6,38,122
"30186","0800-0859",2022-10-16,83,7,34,117
"30187","0800-0859",2022-10-17,88,1,44,132
"30188","0800-0859",2022-10-18,88,2,41,129
"30189","0800-0859",2022-10-19,86,3,40,126
"30190","0800-0859",2022-10-20,85,4,41,126
"30191","0800-0859",2022-10-21,89,5,43,132
"30192","0800-0859",2022-10-22,84,6,38,122
"30193","0800-0859",2022-10-23,83,7,34,117
"30194","0800-0859",2022-10-24,89,1,44,133
"30195","0800-0859",2022-10-25,88,2,41,129
"30196","0800-0859",2022-10-26,86,3,40,126
"30197","0800-0859",2022-10-27,86,4,41,127
"30198","0800-0859",2022-10-28,89,5,44,133
"30199","0800-0859",2022-10-29,84,6,38,122
"30200","0800-0859",2022-10-30,85,7,34,119
"30201","0800-0859",2022-10-31,92,1,43,135
"30202","0900-0959",2022-10-01,51,6,59,110
"30203","0900-0959",2022-10-02,54,7,57,111
"30204","0900-0959",2022-10-03,54,1,66,120
"30205","0900-0959",2022-10-04,51,2,59,110
"30206","0900-0959",2022-10-05,52,3,57,109
"30207","0900-0959",2022-10-06,49,4,55,104
"30208","0900-0959",2022-10-07,51,5,57,108
"30209","0900-0959",2022-10-08,47,6,51,98
"30210","0900-0959",2022-10-09,52,7,54,106
"30211","0900-0959",2022-10-10,50,1,58,108
"30212","0900-0959",2022-10-11,48,2,54,102
"30213","0900-0959",2022-10-12,53,3,53,106
"30214","0900-0959",2022-10-13,50,4,56,106
"30215","0900-0959",2022-10-14,51,5,58,109
"30216","0900-0959",2022-10-15,47,6,50,97
"30217","0900-0959",2022-10-16,50,7,53,103
"30218","0900-0959",2022-10-17,51,1,57,108
"30219","0900-0959",2022-10-18,49,2,54,103
"30220","0900-0959",2022-10-19,54,3,53,107
"30221","0900-0959",2022-10-20,52,4,56,108
"30222","0900-0959",2022-10-21,52,5,58,110
"30223","0900-0959",2022-10-22,47,6,50,97
"30224","0900-0959",2022-10-23,50,7,53,103
"30225","0900-0959",2022-10-24,51,1,58,109
"30226","0900-0959",2022-10-25,49,2,54,103
"30227","0900-0959",2022-10-26,54,3,53,107
"30228","0900-0959",2022-10-27,51,4,56,107
"30229","0900-0959",2022-10-28,52,5,59,111
"30230","0900-0959",2022-10-29,47,6,51,98
"30231","0900-0959",2022-10-30,48,7,54,102
"30232","0900-0959",2022-10-31,48,1,59,107
"30233","1000-1059",2022-10-01,75,6,41,116
"30234","1000-1059",2022-10-02,74,7,43,117
"30235","1000-1059",2022-10-03,78,1,45,123
"30236","1000-1059",2022-10-04,74,2,45,119
"30237","1000-1059",2022-10-05,75,3,42,117
"30238","1000-1059",2022-10-06,73,4,48,121
"30239","1000-1059",2022-10-07,73,5,48,121
"30240","1000-1059",2022-10-08,70,6,41,111
"30241","1000-1059",2022-10-09,73,7,39,112
"30242","1000-1059",2022-10-10,74,1,48,122
"30243","1000-1059",2022-10-11,71,2,46,117
"30244","1000-1059",2022-10-12,70,3,47,117
"30245","1000-1059",2022-10-13,75,4,50,125
"30246","1000-1059",2022-10-14,72,5,48,120
"30247","1000-1059",2022-10-15,69,6,41,110
"30248","1000-1059",2022-10-16,73,7,39,112
"30249","1000-1059",2022-10-17,73,1,47,120
"30250","1000-1059",2022-10-18,72,2,45,117
"30251","1000-1059",2022-10-19,71,3,46,117
"30252","1000-1059",2022-10-20,75,4,49,124
"30253","1000-1059",2022-10-21,74,5,47,121
"30254","1000-1059",2022-10-22,69,6,41,110
"30255","1000-1059",2022-10-23,73,7,39,112
"30256","1000-1059",2022-10-24,72,1,48,120
"30257","1000-1059",2022-10-25,72,2,45,117
"30258","1000-1059",2022-10-26,70,3,46,116
"30259","1000-1059",2022-10-27,76,4,49,125
"30260","1000-1059",2022-10-28,75,5,47,122
"30261","1000-1059",2022-10-29,70,6,42,112
"30262","1000-1059",2022-10-30,71,7,42,113
"30263","1000-1059",2022-10-31,69,1,49,118
"30264","1100-1159",2022-10-01,48,6,62,110
"30265","1100-1159",2022-10-02,58,7,60,118
"30266","1100-1159",2022-10-03,57,1,57,114
"30267","1100-1159",2022-10-04,53,2,56,109
"30268","1100-1159",2022-10-05,52,3,55,107
"30269","1100-1159",2022-10-06,60,4,60,120
"30270","1100-1159",2022-10-07,56,5,62,118
"30271","1100-1159",2022-10-08,50,6,67,117
"30272","1100-1159",2022-10-09,56,7,66,122
"30273","1100-1159",2022-10-10,58,1,59,117
"30274","1100-1159",2022-10-11,56,2,59,115
"30275","1100-1159",2022-10-12,57,3,60,117
"30276","1100-1159",2022-10-13,60,4,59,119
"30277","1100-1159",2022-10-14,57,5,62,119
"30278","1100-1159",2022-10-15,50,6,67,117
"30279","1100-1159",2022-10-16,55,7,66,121
"30280","1100-1159",2022-10-17,56,1,59,115
"30281","1100-1159",2022-10-18,54,2,59,113
"30282","1100-1159",2022-10-19,55,3,60,115
"30283","1100-1159",2022-10-20,58,4,60,118
"30284","1100-1159",2022-10-21,55,5,62,117
"30285","1100-1159",2022-10-22,50,6,67,117
"30286","1100-1159",2022-10-23,56,7,66,122
"30287","1100-1159",2022-10-24,57,1,59,116
"30288","1100-1159",2022-10-25,54,2,59,113
"30289","1100-1159",2022-10-26,55,3,60,115
"30290","1100-1159",2022-10-27,58,4,59,117
"30291","1100-1159",2022-10-28,55,5,61,116
"30292","1100-1159",2022-10-29,48,6,66,114
"30293","1100-1159",2022-10-30,52,7,64,116
"30294","1100-1159",2022-10-31,51,1,57,108
"30295","1200-1259",2022-10-01,51,6,50,101
"30296","1200-1259",2022-10-02,53,7,60,113
"30297","1200-1259",2022-10-03,58,1,58,116
"30298","1200-1259",2022-10-04,55,2,55,110
"30299","1200-1259",2022-10-05,55,3,58,113
"30300","1200-1259",2022-10-06,58,4,57,115
"30301","1200-1259",2022-10-07,62,5,52,114
"30302","1200-1259",2022-10-08,52,6,46,98
"30303","1200-1259",2022-10-09,58,7,55,113
"30304","1200-1259",2022-10-10,57,1,54,111
"30305","1200-1259",2022-10-11,55,2,52,107
"30306","1200-1259",2022-10-12,55,3,53,108
"30307","1200-1259",2022-10-13,59,4,56,115
"30308","1200-1259",2022-10-14,60,5,51,111
"30309","1200-1259",2022-10-15,52,6,46,98
"30310","1200-1259",2022-10-16,57,7,53,110
"30311","1200-1259",2022-10-17,56,1,54,110
"30312","1200-1259",2022-10-18,55,2,53,108
"30313","1200-1259",2022-10-19,55,3,54,109
"30314","1200-1259",2022-10-20,59,4,57,116
"30315","1200-1259",2022-10-21,61,5,53,114
"30316","1200-1259",2022-10-22,52,6,46,98
"30317","1200-1259",2022-10-23,57,7,54,111
"30318","1200-1259",2022-10-24,56,1,53,109
"30319","1200-1259",2022-10-25,55,2,53,108
"30320","1200-1259",2022-10-26,54,3,53,107
"30321","1200-1259",2022-10-27,59,4,57,116
"30322","1200-1259",2022-10-28,61,5,55,116
"30323","1200-1259",2022-10-29,53,6,44,97
"30324","1200-1259",2022-10-30,59,7,48,107
"30325","1200-1259",2022-10-31,57,1,48,105
"30326","1300-1359",2022-10-01,55,6,49,104
"30327","1300-1359",2022-10-02,64,7,58,122
"30328","1300-1359",2022-10-03,63,1,63,126
"30329","1300-1359",2022-10-04,59,2,61,120
"30330","1300-1359",2022-10-05,59,3,59,118
"30331","1300-1359",2022-10-06,60,4,64,124
"30332","1300-1359",2022-10-07,59,5,62,121
"30333","1300-1359",2022-10-08,54,6,53,107
"30334","1300-1359",2022-10-09,58,7,60,118
"30335","1300-1359",2022-10-10,61,1,62,123
"30336","1300-1359",2022-10-11,58,2,60,118
"30337","1300-1359",2022-10-12,58,3,61,119
"30338","1300-1359",2022-10-13,60,4,65,125
"30339","1300-1359",2022-10-14,59,5,62,121
"30340","1300-1359",2022-10-15,53,6,52,105
"30341","1300-1359",2022-10-16,58,7,59,117
"30342","1300-1359",2022-10-17,60,1,60,120
"30343","1300-1359",2022-10-18,57,2,59,116
"30344","1300-1359",2022-10-19,57,3,60,117
"30345","1300-1359",2022-10-20,59,4,63,122
"30346","1300-1359",2022-10-21,58,5,60,118
"30347","1300-1359",2022-10-22,53,6,52,105
"30348","1300-1359",2022-10-23,58,7,58,116
"30349","1300-1359",2022-10-24,60,1,60,120
"30350","1300-1359",2022-10-25,57,2,58,115
"30351","1300-1359",2022-10-26,57,3,59,116
"30352","1300-1359",2022-10-27,59,4,63,122
"30353","1300-1359",2022-10-28,58,5,60,118
"30354","1300-1359",2022-10-29,52,6,53,105
"30355","1300-1359",2022-10-30,55,7,58,113
"30356","1300-1359",2022-10-31,55,1,58,113
"30357","1400-1459",2022-10-01,45,6,53,98
"30358","1400-1459",2022-10-02,50,7,58,108
"30359","1400-1459",2022-10-03,55,1,61,116
"30360","1400-1459",2022-10-04,48,2,55,103
"30361","1400-1459",2022-10-05,47,3,55,102
"30362","1400-1459",2022-10-06,62,4,53,115
"30363","1400-1459",2022-10-07,61,5,54,115
"30364","1400-1459",2022-10-08,49,6,45,94
"30365","1400-1459",2022-10-09,58,7,55,113
"30366","1400-1459",2022-10-10,60,1,54,114
"30367","1400-1459",2022-10-11,55,2,51,106
"30368","1400-1459",2022-10-12,58,3,49,107
"30369","1400-1459",2022-10-13,62,4,54,116
"30370","1400-1459",2022-10-14,61,5,54,115
"30371","1400-1459",2022-10-15,50,6,45,95
"30372","1400-1459",2022-10-16,58,7,54,112
"30373","1400-1459",2022-10-17,60,1,56,116
"30374","1400-1459",2022-10-18,55,2,52,107
"30375","1400-1459",2022-10-19,58,3,49,107
"30376","1400-1459",2022-10-20,61,4,54,115
"30377","1400-1459",2022-10-21,60,5,55,115
"30378","1400-1459",2022-10-22,49,6,45,94
"30379","1400-1459",2022-10-23,57,7,55,112
"30380","1400-1459",2022-10-24,58,1,56,114
"30381","1400-1459",2022-10-25,54,2,53,107
"30382","1400-1459",2022-10-26,57,3,50,107
"30383","1400-1459",2022-10-27,61,4,55,116
"30384","1400-1459",2022-10-28,59,5,55,114
"30385","1400-1459",2022-10-29,49,6,46,95
"30386","1400-1459",2022-10-30,52,7,58,110
"30387","1400-1459",2022-10-31,47,1,57,104
"30388","1500-1559",2022-10-01,47,6,54,101
"30389","1500-1559",2022-10-02,55,7,59,114
"30390","1500-1559",2022-10-03,55,1,63,118
"30391","1500-1559",2022-10-04,51,2,57,108
"30392","1500-1559",2022-10-05,49,3,58,107
"30393","1500-1559",2022-10-06,52,4,64,116
"30394","1500-1559",2022-10-07,54,5,65,119
"30395","1500-1559",2022-10-08,44,6,55,99
"30396","1500-1559",2022-10-09,51,7,56,107
"30397","1500-1559",2022-10-10,54,1,64,118
"30398","1500-1559",2022-10-11,50,2,59,109
"30399","1500-1559",2022-10-12,49,3,61,110
"30400","1500-1559",2022-10-13,52,4,63,115
"30401","1500-1559",2022-10-14,54,5,65,119
"30402","1500-1559",2022-10-15,44,6,55,99
"30403","1500-1559",2022-10-16,51,7,56,107
"30404","1500-1559",2022-10-17,53,1,61,114
"30405","1500-1559",2022-10-18,49,2,57,106
"30406","1500-1559",2022-10-19,47,3,60,107
"30407","1500-1559",2022-10-20,53,4,62,115
"30408","1500-1559",2022-10-21,54,5,64,118
"30409","1500-1559",2022-10-22,45,6,55,100
"30410","1500-1559",2022-10-23,52,7,56,108
"30411","1500-1559",2022-10-24,55,1,62,117
"30412","1500-1559",2022-10-25,50,2,57,107
"30413","1500-1559",2022-10-26,48,3,60,108
"30414","1500-1559",2022-10-27,52,4,62,114
"30415","1500-1559",2022-10-28,55,5,64,119
"30416","1500-1559",2022-10-29,46,6,54,100
"30417","1500-1559",2022-10-30,56,7,51,107
"30418","1500-1559",2022-10-31,53,1,54,107
"30419","1600-1659",2022-10-01,60,6,55,115
"30420","1600-1659",2022-10-02,60,7,60,120
"30421","1600-1659",2022-10-03,61,1,61,122
"30422","1600-1659",2022-10-04,55,2,62,117
"30423","1600-1659",2022-10-05,56,3,59,115
"30424","1600-1659",2022-10-06,58,4,63,121
"30425","1600-1659",2022-10-07,59,5,62,121
"30426","1600-1659",2022-10-08,55,6,54,109
"30427","1600-1659",2022-10-09,54,7,59,113
"30428","1600-1659",2022-10-10,58,1,62,120
"30429","1600-1659",2022-10-11,55,2,62,117
"30430","1600-1659",2022-10-12,55,3,59,114
"30431","1600-1659",2022-10-13,58,4,63,121
"30432","1600-1659",2022-10-14,57,5,62,119
"30433","1600-1659",2022-10-15,55,6,54,109
"30434","1600-1659",2022-10-16,54,7,59,113
"30435","1600-1659",2022-10-17,58,1,62,120
"30436","1600-1659",2022-10-18,55,2,62,117
"30437","1600-1659",2022-10-19,55,3,59,114
"30438","1600-1659",2022-10-20,57,4,63,120
"30439","1600-1659",2022-10-21,57,5,61,118
"30440","1600-1659",2022-10-22,55,6,53,108
"30441","1600-1659",2022-10-23,54,7,58,112
"30442","1600-1659",2022-10-24,57,1,61,118
"30443","1600-1659",2022-10-25,55,2,61,116
"30444","1600-1659",2022-10-26,55,3,58,113
"30445","1600-1659",2022-10-27,57,4,62,119
"30446","1600-1659",2022-10-28,57,5,61,118
"30447","1600-1659",2022-10-29,52,6,53,105
"30448","1600-1659",2022-10-30,51,7,57,108
"30449","1600-1659",2022-10-31,49,1,61,110
"30450","1700-1759",2022-10-01,51,6,51,102
"30451","1700-1759",2022-10-02,68,7,53,121
"30452","1700-1759",2022-10-03,67,1,56,123
"30453","1700-1759",2022-10-04,57,2,50,107
"30454","1700-1759",2022-10-05,55,3,49,104
"30455","1700-1759",2022-10-06,67,4,58,125
"30456","1700-1759",2022-10-07,69,5,58,127
"30457","1700-1759",2022-10-08,57,6,51,108
"30458","1700-1759",2022-10-09,63,7,55,118
"30459","1700-1759",2022-10-10,65,1,60,125
"30460","1700-1759",2022-10-11,61,2,54,115
"30461","1700-1759",2022-10-12,58,3,56,114
"30462","1700-1759",2022-10-13,67,4,58,125
"30463","1700-1759",2022-10-14,69,5,57,126
"30464","1700-1759",2022-10-15,56,6,51,107
"30465","1700-1759",2022-10-16,63,7,55,118
"30466","1700-1759",2022-10-17,63,1,58,121
"30467","1700-1759",2022-10-18,59,2,53,112
"30468","1700-1759",2022-10-19,57,3,55,112
"30469","1700-1759",2022-10-20,66,4,58,124
"30470","1700-1759",2022-10-21,66,5,58,124
"30471","1700-1759",2022-10-22,56,6,52,108
"30472","1700-1759",2022-10-23,62,7,56,118
"30473","1700-1759",2022-10-24,64,1,60,124
"30474","1700-1759",2022-10-25,58,2,54,112
"30475","1700-1759",2022-10-26,56,3,55,111
"30476","1700-1759",2022-10-27,65,4,58,123
"30477","1700-1759",2022-10-28,66,5,58,124
"30478","1700-1759",2022-10-29,54,6,50,104
"30479","1700-1759",2022-10-30,64,7,52,116
"30480","1700-1759",2022-10-31,54,1,51,105
"30481","1800-1859",2022-10-01,57,6,62,119
"30482","1800-1859",2022-10-02,64,7,72,136
"30483","1800-1859",2022-10-03,63,1,74,137
"30484","1800-1859",2022-10-04,56,2,66,122
"30485","1800-1859",2022-10-05,56,3,65,121
"30486","1800-1859",2022-10-06,62,4,66,128
"30487","1800-1859",2022-10-07,62,5,68,130
"30488","1800-1859",2022-10-08,53,6,59,112
"30489","1800-1859",2022-10-09,64,7,67,131
"30490","1800-1859",2022-10-10,61,1,65,126
"30491","1800-1859",2022-10-11,58,2,67,125
"30492","1800-1859",2022-10-12,58,3,66,124
"30493","1800-1859",2022-10-13,62,4,66,128
"30494","1800-1859",2022-10-14,62,5,66,128
"30495","1800-1859",2022-10-15,53,6,58,111
"30496","1800-1859",2022-10-16,64,7,66,130
"30497","1800-1859",2022-10-17,61,1,65,126
"30498","1800-1859",2022-10-18,58,2,67,125
"30499","1800-1859",2022-10-19,58,3,66,124
"30500","1800-1859",2022-10-20,62,4,65,127
"30501","1800-1859",2022-10-21,63,5,66,129
"30502","1800-1859",2022-10-22,54,6,58,112
"30503","1800-1859",2022-10-23,65,7,66,131
"30504","1800-1859",2022-10-24,62,1,63,125
"30505","1800-1859",2022-10-25,58,2,67,125
"30506","1800-1859",2022-10-26,59,3,66,125
"30507","1800-1859",2022-10-27,63,4,66,129
"30508","1800-1859",2022-10-28,62,5,66,128
"30509","1800-1859",2022-10-29,52,6,57,109
"30510","1800-1859",2022-10-30,56,7,64,120
"30511","1800-1859",2022-10-31,43,1,59,102
"30512","1900-1959",2022-10-01,53,6,62,115
"30513","1900-1959",2022-10-02,60,7,63,123
"30514","1900-1959",2022-10-03,63,1,61,124
"30515","1900-1959",2022-10-04,50,2,51,101
"30516","1900-1959",2022-10-05,50,3,51,101
"30517","1900-1959",2022-10-06,63,4,66,129
"30518","1900-1959",2022-10-07,63,5,67,130
"30519","1900-1959",2022-10-08,54,6,60,114
"30520","1900-1959",2022-10-09,59,7,64,123
"30521","1900-1959",2022-10-10,62,1,64,126
"30522","1900-1959",2022-10-11,58,2,59,117
"30523","1900-1959",2022-10-12,57,3,60,117
"30524","1900-1959",2022-10-13,63,4,68,131
"30525","1900-1959",2022-10-14,64,5,67,131
"30526","1900-1959",2022-10-15,54,6,61,115
"30527","1900-1959",2022-10-16,59,7,64,123
"30528","1900-1959",2022-10-17,62,1,63,125
"30529","1900-1959",2022-10-18,58,2,58,116
"30530","1900-1959",2022-10-19,57,3,58,115
"30531","1900-1959",2022-10-20,64,4,67,131
"30532","1900-1959",2022-10-21,63,5,65,128
"30533","1900-1959",2022-10-22,53,6,62,115
"30534","1900-1959",2022-10-23,59,7,63,122
"30535","1900-1959",2022-10-24,62,1,64,126
"30536","1900-1959",2022-10-25,59,2,58,117
"30537","1900-1959",2022-10-26,57,3,58,115
"30538","1900-1959",2022-10-27,63,4,66,129
"30539","1900-1959",2022-10-28,63,5,65,128
"30540","1900-1959",2022-10-29,48,6,59,107
"30541","1900-1959",2022-10-30,55,7,58,113
"30542","1900-1959",2022-10-31,46,1,48,94
"30543","2000-2059",2022-10-01,36,6,58,94
"30544","2000-2059",2022-10-02,55,7,82,137
"30545","2000-2059",2022-10-03,55,1,77,132
"30546","2000-2059",2022-10-04,47,2,71,118
"30547","2000-2059",2022-10-05,44,3,70,114
"30548","2000-2059",2022-10-06,54,4,69,123
"30549","2000-2059",2022-10-07,53,5,72,125
"30550","2000-2059",2022-10-08,35,6,57,92
"30551","2000-2059",2022-10-09,51,7,73,124
"30552","2000-2059",2022-10-10,52,1,70,122
"30553","2000-2059",2022-10-11,48,2,66,114
"30554","2000-2059",2022-10-12,51,3,65,116
"30555","2000-2059",2022-10-13,54,4,69,123
"30556","2000-2059",2022-10-14,52,5,72,124
"30557","2000-2059",2022-10-15,35,6,57,92
"30558","2000-2059",2022-10-16,51,7,73,124
"30559","2000-2059",2022-10-17,51,1,69,120
"30560","2000-2059",2022-10-18,47,2,65,112
"30561","2000-2059",2022-10-19,50,3,65,115
"30562","2000-2059",2022-10-20,52,4,69,121
"30563","2000-2059",2022-10-21,51,5,72,123
"30564","2000-2059",2022-10-22,35,6,57,92
"30565","2000-2059",2022-10-23,52,7,74,126
"30566","2000-2059",2022-10-24,52,1,70,122
"30567","2000-2059",2022-10-25,46,2,65,111
"30568","2000-2059",2022-10-26,49,3,65,114
"30569","2000-2059",2022-10-27,52,4,69,121
"30570","2000-2059",2022-10-28,51,5,71,122
"30571","2000-2059",2022-10-29,32,6,54,86
"30572","2000-2059",2022-10-30,48,7,76,124
"30573","2000-2059",2022-10-31,37,1,65,102
"30574","2100-2159",2022-10-01,28,6,63,91
"30575","2100-2159",2022-10-02,41,7,65,106
"30576","2100-2159",2022-10-03,41,1,73,114
"30577","2100-2159",2022-10-04,34,2,62,96
"30578","2100-2159",2022-10-05,37,3,60,97
"30579","2100-2159",2022-10-06,41,4,76,117
"30580","2100-2159",2022-10-07,40,5,76,116
"30581","2100-2159",2022-10-08,28,6,63,91
"30582","2100-2159",2022-10-09,38,7,68,106
"30583","2100-2159",2022-10-10,40,1,76,116
"30584","2100-2159",2022-10-11,36,2,70,106
"30585","2100-2159",2022-10-12,38,3,69,107
"30586","2100-2159",2022-10-13,41,4,76,117
"30587","2100-2159",2022-10-14,40,5,77,117
"30588","2100-2159",2022-10-15,28,6,64,92
"30589","2100-2159",2022-10-16,39,7,69,108
"30590","2100-2159",2022-10-17,40,1,75,115
"30591","2100-2159",2022-10-18,36,2,69,105
"30592","2100-2159",2022-10-19,38,3,68,106
"30593","2100-2159",2022-10-20,42,4,75,117
"30594","2100-2159",2022-10-21,41,5,76,117
"30595","2100-2159",2022-10-22,28,6,62,90
"30596","2100-2159",2022-10-23,39,7,69,108
"30597","2100-2159",2022-10-24,42,1,74,116
"30598","2100-2159",2022-10-25,37,2,67,104
"30599","2100-2159",2022-10-26,39,3,67,106
"30600","2100-2159",2022-10-27,42,4,74,116
"30601","2100-2159",2022-10-28,40,5,76,116
"30602","2100-2159",2022-10-29,28,6,60,88
"30603","2100-2159",2022-10-30,37,7,62,99
"30604","2100-2159",2022-10-31,38,1,49,87
"30605","2200-2259",2022-10-01,32,6,43,75
"30606","2200-2259",2022-10-02,38,7,62,100
"30607","2200-2259",2022-10-03,33,1,61,94
"30608","2200-2259",2022-10-04,30,2,53,83
"30609","2200-2259",2022-10-05,34,3,53,87
"30610","2200-2259",2022-10-06,40,4,64,104
"30611","2200-2259",2022-10-07,40,5,62,102
"30612","2200-2259",2022-10-08,32,6,51,83
"30613","2200-2259",2022-10-09,40,7,61,101
"30614","2200-2259",2022-10-10,35,1,61,96
"30615","2200-2259",2022-10-11,33,2,57,90
"30616","2200-2259",2022-10-12,35,3,59,94
"30617","2200-2259",2022-10-13,40,4,64,104
"30618","2200-2259",2022-10-14,40,5,62,102
"30619","2200-2259",2022-10-15,31,6,49,80
"30620","2200-2259",2022-10-16,40,7,62,102
"30621","2200-2259",2022-10-17,35,1,61,96
"30622","2200-2259",2022-10-18,33,2,57,90
"30623","2200-2259",2022-10-19,35,3,59,94
"30624","2200-2259",2022-10-20,43,4,64,107
"30625","2200-2259",2022-10-21,41,5,61,102
"30626","2200-2259",2022-10-22,32,6,49,81
"30627","2200-2259",2022-10-23,41,7,61,102
"30628","2200-2259",2022-10-24,37,1,61,98
"30629","2200-2259",2022-10-25,33,2,58,91
"30630","2200-2259",2022-10-26,35,3,59,94
"30631","2200-2259",2022-10-27,40,4,64,104
"30632","2200-2259",2022-10-28,40,5,61,101
"30633","2200-2259",2022-10-29,29,6,46,75
"30634","2200-2259",2022-10-30,35,7,58,93
"30635","2200-2259",2022-10-31,27,1,49,76
"30636","2300-2359",2022-10-01,19,6,42,61
"30637","2300-2359",2022-10-02,20,7,57,77
"30638","2300-2359",2022-10-03,21,1,55,76
"30639","2300-2359",2022-10-04,17,2,47,64
"30640","2300-2359",2022-10-05,17,3,47,64
"30641","2300-2359",2022-10-06,22,4,56,78
"30642","2300-2359",2022-10-07,22,5,56,78
"30643","2300-2359",2022-10-08,19,6,39,58
"30644","2300-2359",2022-10-09,21,7,54,75
"30645","2300-2359",2022-10-10,20,1,53,73
"30646","2300-2359",2022-10-11,17,2,48,65
"30647","2300-2359",2022-10-12,17,3,49,66
"30648","2300-2359",2022-10-13,22,4,56,78
"30649","2300-2359",2022-10-14,22,5,55,77
"30650","2300-2359",2022-10-15,19,6,39,58
"30651","2300-2359",2022-10-16,21,7,54,75
"30652","2300-2359",2022-10-17,20,1,53,73
"30653","2300-2359",2022-10-18,17,2,48,65
"30654","2300-2359",2022-10-19,17,3,49,66
"30655","2300-2359",2022-10-20,21,4,57,78
"30656","2300-2359",2022-10-21,22,5,56,78
"30657","2300-2359",2022-10-22,19,6,40,59
"30658","2300-2359",2022-10-23,21,7,56,77
"30659","2300-2359",2022-10-24,20,1,55,75
"30660","2300-2359",2022-10-25,17,2,49,66
"30661","2300-2359",2022-10-26,17,3,50,67
"30662","2300-2359",2022-10-27,22,4,57,79
"30663","2300-2359",2022-10-28,21,5,56,77
"30664","2300-2359",2022-10-29,18,6,38,56
"30665","2300-2359",2022-10-30,17,7,51,68
"30666","2300-2359",2022-10-31,17,1,42,59
"30667","0001-0559",2022-11-01,28,2,47,75
"30668","0001-0559",2022-11-02,26,3,50,76
"30669","0001-0559",2022-11-03,26,4,55,81
"30670","0001-0559",2022-11-04,27,5,56,83
"30671","0001-0559",2022-11-05,19,6,52,71
"30672","0001-0559",2022-11-06,26,7,57,83
"30673","0001-0559",2022-11-07,25,1,51,76
"30674","0001-0559",2022-11-08,27,2,49,76
"30675","0001-0559",2022-11-09,26,3,46,72
"30676","0001-0559",2022-11-10,24,4,51,75
"30677","0001-0559",2022-11-11,24,5,54,78
"30678","0001-0559",2022-11-12,28,6,38,66
"30679","0001-0559",2022-11-13,23,7,52,75
"30680","0001-0559",2022-11-14,24,1,50,74
"30681","0001-0559",2022-11-15,27,2,45,72
"30682","0001-0559",2022-11-16,26,3,45,71
"30683","0001-0559",2022-11-17,23,4,50,73
"30684","0001-0559",2022-11-18,23,5,55,78
"30685","0001-0559",2022-11-19,28,6,39,67
"30686","0001-0559",2022-11-20,22,7,53,75
"30687","0001-0559",2022-11-21,25,1,51,76
"30688","0001-0559",2022-11-22,22,2,53,75
"30689","0001-0559",2022-11-23,21,3,60,81
"30690","0001-0559",2022-11-24,26,4,25,51
"30691","0001-0559",2022-11-25,20,5,45,65
"30692","0001-0559",2022-11-26,26,6,46,72
"30693","0001-0559",2022-11-27,26,7,60,86
"30694","0001-0559",2022-11-28,26,1,53,79
"30695","0001-0559",2022-11-29,23,2,50,73
"30696","0001-0559",2022-11-30,24,3,44,68
"30697","0600-0659",2022-11-01,59,2,19,78
"30698","0600-0659",2022-11-02,59,3,21,80
"30699","0600-0659",2022-11-03,75,4,19,94
"30700","0600-0659",2022-11-04,71,5,20,91
"30701","0600-0659",2022-11-05,67,6,13,80
"30702","0600-0659",2022-11-06,66,7,20,86
"30703","0600-0659",2022-11-07,66,1,18,84
"30704","0600-0659",2022-11-08,57,2,17,74
"30705","0600-0659",2022-11-09,59,3,23,82
"30706","0600-0659",2022-11-10,72,4,23,95
"30707","0600-0659",2022-11-11,69,5,23,92
"30708","0600-0659",2022-11-12,60,6,27,87
"30709","0600-0659",2022-11-13,68,7,23,91
"30710","0600-0659",2022-11-14,67,1,22,89
"30711","0600-0659",2022-11-15,59,2,22,81
"30712","0600-0659",2022-11-16,59,3,22,81
"30713","0600-0659",2022-11-17,70,4,22,92
"30714","0600-0659",2022-11-18,67,5,22,89
"30715","0600-0659",2022-11-19,57,6,28,85
"30716","0600-0659",2022-11-20,67,7,24,91
"30717","0600-0659",2022-11-21,67,1,20,87
"30718","0600-0659",2022-11-22,69,2,19,88
"30719","0600-0659",2022-11-23,70,3,20,90
"30720","0600-0659",2022-11-24,59,4,14,73
"30721","0600-0659",2022-11-25,51,5,21,72
"30722","0600-0659",2022-11-26,60,6,28,88
"30723","0600-0659",2022-11-27,73,7,24,97
"30724","0600-0659",2022-11-28,77,1,24,101
"30725","0600-0659",2022-11-29,66,2,20,86
"30726","0600-0659",2022-11-30,61,3,23,84
"30727","0700-0759",2022-11-01,75,2,42,117
"30728","0700-0759",2022-11-02,76,3,41,117
"30729","0700-0759",2022-11-03,80,4,49,129
"30730","0700-0759",2022-11-04,83,5,48,131
"30731","0700-0759",2022-11-05,69,6,37,106
"30732","0700-0759",2022-11-06,80,7,47,127
"30733","0700-0759",2022-11-07,84,1,49,133
"30734","0700-0759",2022-11-08,84,2,43,127
"30735","0700-0759",2022-11-09,83,3,42,125
"30736","0700-0759",2022-11-10,83,4,50,133
"30737","0700-0759",2022-11-11,85,5,49,134
"30738","0700-0759",2022-11-12,79,6,40,119
"30739","0700-0759",2022-11-13,82,7,49,131
"30740","0700-0759",2022-11-14,84,1,49,133
"30741","0700-0759",2022-11-15,85,2,42,127
"30742","0700-0759",2022-11-16,82,3,42,124
"30743","0700-0759",2022-11-17,84,4,51,135
"30744","0700-0759",2022-11-18,87,5,48,135
"30745","0700-0759",2022-11-19,84,6,41,125
"30746","0700-0759",2022-11-20,84,7,51,135
"30747","0700-0759",2022-11-21,85,1,49,134
"30748","0700-0759",2022-11-22,85,2,48,133
"30749","0700-0759",2022-11-23,83,3,50,133
"30750","0700-0759",2022-11-24,82,4,40,122
"30751","0700-0759",2022-11-25,80,5,43,123
"30752","0700-0759",2022-11-26,84,6,44,128
"30753","0700-0759",2022-11-27,85,7,51,136
"30754","0700-0759",2022-11-28,84,1,52,136
"30755","0700-0759",2022-11-29,80,2,47,127
"30756","0700-0759",2022-11-30,80,3,40,120
"30757","0800-0859",2022-11-01,87,2,38,125
"30758","0800-0859",2022-11-02,85,3,38,123
"30759","0800-0859",2022-11-03,84,4,39,123
"30760","0800-0859",2022-11-04,85,5,44,129
"30761","0800-0859",2022-11-05,80,6,37,117
"30762","0800-0859",2022-11-06,87,7,39,126
"30763","0800-0859",2022-11-07,87,1,45,132
"30764","0800-0859",2022-11-08,81,2,43,124
"30765","0800-0859",2022-11-09,78,3,45,123
"30766","0800-0859",2022-11-10,85,4,45,130
"30767","0800-0859",2022-11-11,86,5,45,131
"30768","0800-0859",2022-11-12,72,6,42,114
"30769","0800-0859",2022-11-13,83,7,40,123
"30770","0800-0859",2022-11-14,85,1,45,130
"30771","0800-0859",2022-11-15,78,2,46,124
"30772","0800-0859",2022-11-16,79,3,45,124
"30773","0800-0859",2022-11-17,88,4,46,134
"30774","0800-0859",2022-11-18,88,5,49,137
"30775","0800-0859",2022-11-19,80,6,47,127
"30776","0800-0859",2022-11-20,87,7,46,133
"30777","0800-0859",2022-11-21,87,1,49,136
"30778","0800-0859",2022-11-22,85,2,48,133
"30779","0800-0859",2022-11-23,84,3,48,132
"30780","0800-0859",2022-11-24,76,4,47,123
"30781","0800-0859",2022-11-25,74,5,46,120
"30782","0800-0859",2022-11-26,77,6,45,122
"30783","0800-0859",2022-11-27,85,7,54,139
"30784","0800-0859",2022-11-28,87,1,54,141
"30785","0800-0859",2022-11-29,85,2,43,128
"30786","0800-0859",2022-11-30,73,3,41,114
"30787","0900-0959",2022-11-01,51,2,54,105
"30788","0900-0959",2022-11-02,54,3,52,106
"30789","0900-0959",2022-11-03,58,4,60,118
"30790","0900-0959",2022-11-04,56,5,60,116
"30791","0900-0959",2022-11-05,52,6,50,102
"30792","0900-0959",2022-11-06,53,7,56,109
"30793","0900-0959",2022-11-07,59,1,56,115
"30794","0900-0959",2022-11-08,61,2,52,113
"30795","0900-0959",2022-11-09,67,3,51,118
"30796","0900-0959",2022-11-10,64,4,56,120
"30797","0900-0959",2022-11-11,62,5,57,119
"30798","0900-0959",2022-11-12,57,6,46,103
"30799","0900-0959",2022-11-13,62,7,55,117
"30800","0900-0959",2022-11-14,63,1,55,118
"30801","0900-0959",2022-11-15,65,2,51,116
"30802","0900-0959",2022-11-16,68,3,51,119
"30803","0900-0959",2022-11-17,66,4,54,120
"30804","0900-0959",2022-11-18,70,5,52,122
"30805","0900-0959",2022-11-19,65,6,43,108
"30806","0900-0959",2022-11-20,72,7,51,123
"30807","0900-0959",2022-11-21,73,1,51,124
"30808","0900-0959",2022-11-22,66,2,49,115
"30809","0900-0959",2022-11-23,70,3,49,119
"30810","0900-0959",2022-11-24,72,4,48,120
"30811","0900-0959",2022-11-25,72,5,40,112
"30812","0900-0959",2022-11-26,65,6,45,110
"30813","0900-0959",2022-11-27,69,7,51,120
"30814","0900-0959",2022-11-28,67,1,50,117
"30815","0900-0959",2022-11-29,70,2,48,118
"30816","0900-0959",2022-11-30,73,3,47,120
"30817","1000-1059",2022-11-01,70,2,46,116
"30818","1000-1059",2022-11-02,69,3,49,118
"30819","1000-1059",2022-11-03,71,4,52,123
"30820","1000-1059",2022-11-04,72,5,49,121
"30821","1000-1059",2022-11-05,66,6,42,108
"30822","1000-1059",2022-11-06,71,7,41,112
"30823","1000-1059",2022-11-07,67,1,42,109
"30824","1000-1059",2022-11-08,69,2,42,111
"30825","1000-1059",2022-11-09,67,3,43,110
"30826","1000-1059",2022-11-10,68,4,47,115
"30827","1000-1059",2022-11-11,68,5,45,113
"30828","1000-1059",2022-11-12,64,6,41,105
"30829","1000-1059",2022-11-13,70,7,44,114
"30830","1000-1059",2022-11-14,67,1,45,112
"30831","1000-1059",2022-11-15,68,2,44,112
"30832","1000-1059",2022-11-16,66,3,44,110
"30833","1000-1059",2022-11-17,68,4,50,118
"30834","1000-1059",2022-11-18,63,5,49,112
"30835","1000-1059",2022-11-19,58,6,47,105
"30836","1000-1059",2022-11-20,67,7,51,118
"30837","1000-1059",2022-11-21,65,1,50,115
"30838","1000-1059",2022-11-22,64,2,52,116
"30839","1000-1059",2022-11-23,62,3,51,113
"30840","1000-1059",2022-11-24,55,4,51,106
"30841","1000-1059",2022-11-25,65,5,45,110
"30842","1000-1059",2022-11-26,59,6,46,105
"30843","1000-1059",2022-11-27,66,7,51,117
"30844","1000-1059",2022-11-28,63,1,53,116
"30845","1000-1059",2022-11-29,63,2,51,114
"30846","1000-1059",2022-11-30,61,3,48,109
"30847","1100-1159",2022-11-01,52,2,60,112
"30848","1100-1159",2022-11-02,50,3,61,111
"30849","1100-1159",2022-11-03,54,4,59,113
"30850","1100-1159",2022-11-04,48,5,59,107
"30851","1100-1159",2022-11-05,41,6,66,107
"30852","1100-1159",2022-11-06,48,7,63,111
"30853","1100-1159",2022-11-07,47,1,63,110
"30854","1100-1159",2022-11-08,46,2,63,109
"30855","1100-1159",2022-11-09,46,3,61,107
"30856","1100-1159",2022-11-10,54,4,62,116
"30857","1100-1159",2022-11-11,50,5,62,112
"30858","1100-1159",2022-11-12,39,6,64,103
"30859","1100-1159",2022-11-13,52,7,61,113
"30860","1100-1159",2022-11-14,49,1,62,111
"30861","1100-1159",2022-11-15,49,2,61,110
"30862","1100-1159",2022-11-16,46,3,61,107
"30863","1100-1159",2022-11-17,53,4,61,114
"30864","1100-1159",2022-11-18,54,5,61,115
"30865","1100-1159",2022-11-19,42,6,63,105
"30866","1100-1159",2022-11-20,52,7,61,113
"30867","1100-1159",2022-11-21,52,1,60,112
"30868","1100-1159",2022-11-22,51,2,64,115
"30869","1100-1159",2022-11-23,50,3,65,115
"30870","1100-1159",2022-11-24,51,4,57,108
"30871","1100-1159",2022-11-25,49,5,58,107
"30872","1100-1159",2022-11-26,39,6,62,101
"30873","1100-1159",2022-11-27,48,7,63,111
"30874","1100-1159",2022-11-28,49,1,63,112
"30875","1100-1159",2022-11-29,53,2,63,116
"30876","1100-1159",2022-11-30,45,3,58,103
"30877","1200-1259",2022-11-01,57,2,48,105
"30878","1200-1259",2022-11-02,57,3,48,105
"30879","1200-1259",2022-11-03,60,4,55,115
"30880","1200-1259",2022-11-04,59,5,48,107
"30881","1200-1259",2022-11-05,52,6,41,93
"30882","1200-1259",2022-11-06,54,7,49,103
"30883","1200-1259",2022-11-07,50,1,51,101
"30884","1200-1259",2022-11-08,51,2,53,104
"30885","1200-1259",2022-11-09,51,3,54,105
"30886","1200-1259",2022-11-10,52,4,54,106
"30887","1200-1259",2022-11-11,53,5,52,105
"30888","1200-1259",2022-11-12,50,6,48,98
"30889","1200-1259",2022-11-13,52,7,56,108
"30890","1200-1259",2022-11-14,52,1,52,104
"30891","1200-1259",2022-11-15,51,2,55,106
"30892","1200-1259",2022-11-16,52,3,53,105
"30893","1200-1259",2022-11-17,51,4,53,104
"30894","1200-1259",2022-11-18,49,5,55,104
"30895","1200-1259",2022-11-19,47,6,52,99
"30896","1200-1259",2022-11-20,50,7,55,105
"30897","1200-1259",2022-11-21,51,1,57,108
"30898","1200-1259",2022-11-22,53,2,52,105
"30899","1200-1259",2022-11-23,56,3,51,107
"30900","1200-1259",2022-11-24,48,4,53,101
"30901","1200-1259",2022-11-25,52,5,56,108
"30902","1200-1259",2022-11-26,50,6,53,103
"30903","1200-1259",2022-11-27,53,7,50,103
"30904","1200-1259",2022-11-28,55,1,53,108
"30905","1200-1259",2022-11-29,48,2,51,99
"30906","1200-1259",2022-11-30,52,3,52,104
"30907","1300-1359",2022-11-01,58,2,59,117
"30908","1300-1359",2022-11-02,58,3,60,118
"30909","1300-1359",2022-11-03,57,4,58,115
"30910","1300-1359",2022-11-04,56,5,57,113
"30911","1300-1359",2022-11-05,53,6,48,101
"30912","1300-1359",2022-11-06,55,7,56,111
"30913","1300-1359",2022-11-07,57,1,53,110
"30914","1300-1359",2022-11-08,52,2,52,104
"30915","1300-1359",2022-11-09,52,3,53,105
"30916","1300-1359",2022-11-10,55,4,56,111
"30917","1300-1359",2022-11-11,56,5,55,111
"30918","1300-1359",2022-11-12,51,6,46,97
"30919","1300-1359",2022-11-13,55,7,56,111
"30920","1300-1359",2022-11-14,56,1,54,110
"30921","1300-1359",2022-11-15,51,2,53,104
"30922","1300-1359",2022-11-16,51,3,53,104
"30923","1300-1359",2022-11-17,57,4,56,113
"30924","1300-1359",2022-11-18,59,5,55,114
"30925","1300-1359",2022-11-19,54,6,49,103
"30926","1300-1359",2022-11-20,60,7,57,117
"30927","1300-1359",2022-11-21,58,1,55,113
"30928","1300-1359",2022-11-22,55,2,55,110
"30929","1300-1359",2022-11-23,55,3,54,109
"30930","1300-1359",2022-11-24,46,4,62,108
"30931","1300-1359",2022-11-25,54,5,50,104
"30932","1300-1359",2022-11-26,57,6,47,104
"30933","1300-1359",2022-11-27,56,7,56,112
"30934","1300-1359",2022-11-28,57,1,55,112
"30935","1300-1359",2022-11-29,58,2,56,114
"30936","1300-1359",2022-11-30,55,3,52,107
"30937","1400-1459",2022-11-01,52,2,56,108
"30938","1400-1459",2022-11-02,54,3,53,107
"30939","1400-1459",2022-11-03,54,4,61,115
"30940","1400-1459",2022-11-04,57,5,60,117
"30941","1400-1459",2022-11-05,43,6,53,96
"30942","1400-1459",2022-11-06,55,7,58,113
"30943","1400-1459",2022-11-07,55,1,60,115
"30944","1400-1459",2022-11-08,59,2,59,118
"30945","1400-1459",2022-11-09,60,3,59,119
"30946","1400-1459",2022-11-10,57,4,59,116
"30947","1400-1459",2022-11-11,59,5,59,118
"30948","1400-1459",2022-11-12,48,6,53,101
"30949","1400-1459",2022-11-13,57,7,56,113
"30950","1400-1459",2022-11-14,57,1,60,117
"30951","1400-1459",2022-11-15,62,2,58,120
"30952","1400-1459",2022-11-16,60,3,59,119
"30953","1400-1459",2022-11-17,57,4,59,116
"30954","1400-1459",2022-11-18,53,5,62,115
"30955","1400-1459",2022-11-19,45,6,50,95
"30956","1400-1459",2022-11-20,53,7,59,112
"30957","1400-1459",2022-11-21,52,1,62,114
"30958","1400-1459",2022-11-22,50,2,58,108
"30959","1400-1459",2022-11-23,52,3,63,115
"30960","1400-1459",2022-11-24,42,4,50,92
"30961","1400-1459",2022-11-25,51,5,59,110
"30962","1400-1459",2022-11-26,44,6,52,96
"30963","1400-1459",2022-11-27,52,7,59,111
"30964","1400-1459",2022-11-28,49,1,58,107
"30965","1400-1459",2022-11-29,52,2,53,105
"30966","1400-1459",2022-11-30,53,3,59,112
"30967","1500-1559",2022-11-01,56,2,55,111
"30968","1500-1559",2022-11-02,54,3,56,110
"30969","1500-1559",2022-11-03,59,4,55,114
"30970","1500-1559",2022-11-04,60,5,54,114
"30971","1500-1559",2022-11-05,55,6,45,100
"30972","1500-1559",2022-11-06,58,7,55,113
"30973","1500-1559",2022-11-07,60,1,54,114
"30974","1500-1559",2022-11-08,58,2,54,112
"30975","1500-1559",2022-11-09,61,3,59,120
"30976","1500-1559",2022-11-10,59,4,61,120
"30977","1500-1559",2022-11-11,60,5,61,121
"30978","1500-1559",2022-11-12,56,6,53,109
"30979","1500-1559",2022-11-13,57,7,60,117
"30980","1500-1559",2022-11-14,62,1,60,122
"30981","1500-1559",2022-11-15,59,2,61,120
"30982","1500-1559",2022-11-16,62,3,58,120
"30983","1500-1559",2022-11-17,59,4,62,121
"30984","1500-1559",2022-11-18,65,5,59,124
"30985","1500-1559",2022-11-19,59,6,55,114
"30986","1500-1559",2022-11-20,64,7,58,122
"30987","1500-1559",2022-11-21,64,1,59,123
"30988","1500-1559",2022-11-22,67,2,60,127
"30989","1500-1559",2022-11-23,71,3,58,129
"30990","1500-1559",2022-11-24,32,4,54,86
"30991","1500-1559",2022-11-25,65,5,56,121
"30992","1500-1559",2022-11-26,59,6,54,113
"30993","1500-1559",2022-11-27,70,7,56,126
"30994","1500-1559",2022-11-28,70,1,60,130
"30995","1500-1559",2022-11-29,57,2,59,116
"30996","1500-1559",2022-11-30,65,3,54,119
"30997","1600-1659",2022-11-01,53,2,60,113
"30998","1600-1659",2022-11-02,54,3,58,112
"30999","1600-1659",2022-11-03,56,4,64,120
"31000","1600-1659",2022-11-04,57,5,66,123
"31001","1600-1659",2022-11-05,54,6,55,109
"31002","1600-1659",2022-11-06,59,7,58,117
"31003","1600-1659",2022-11-07,60,1,61,121
"31004","1600-1659",2022-11-08,54,2,60,114
"31005","1600-1659",2022-11-09,55,3,56,111
"31006","1600-1659",2022-11-10,59,4,58,117
"31007","1600-1659",2022-11-11,59,5,59,118
"31008","1600-1659",2022-11-12,54,6,49,103
"31009","1600-1659",2022-11-13,59,7,60,119
"31010","1600-1659",2022-11-14,59,1,59,118
"31011","1600-1659",2022-11-15,56,2,58,114
"31012","1600-1659",2022-11-16,53,3,57,110
"31013","1600-1659",2022-11-17,57,4,59,116
"31014","1600-1659",2022-11-18,59,5,56,115
"31015","1600-1659",2022-11-19,57,6,51,108
"31016","1600-1659",2022-11-20,58,7,59,117
"31017","1600-1659",2022-11-21,59,1,56,115
"31018","1600-1659",2022-11-22,50,2,56,106
"31019","1600-1659",2022-11-23,48,3,56,104
"31020","1600-1659",2022-11-24,25,4,41,66
"31021","1600-1659",2022-11-25,52,5,52,104
"31022","1600-1659",2022-11-26,60,6,53,113
"31023","1600-1659",2022-11-27,51,7,59,110
"31024","1600-1659",2022-11-28,50,1,54,104
"31025","1600-1659",2022-11-29,59,2,57,116
"31026","1600-1659",2022-11-30,54,3,51,105
"31027","1700-1759",2022-11-01,57,2,52,109
"31028","1700-1759",2022-11-02,57,3,54,111
"31029","1700-1759",2022-11-03,63,4,56,119
"31030","1700-1759",2022-11-04,64,5,56,120
"31031","1700-1759",2022-11-05,57,6,51,108
"31032","1700-1759",2022-11-06,63,7,52,115
"31033","1700-1759",2022-11-07,62,1,52,114
"31034","1700-1759",2022-11-08,59,2,53,112
"31035","1700-1759",2022-11-09,57,3,52,109
"31036","1700-1759",2022-11-10,63,4,52,115
"31037","1700-1759",2022-11-11,63,5,52,115
"31038","1700-1759",2022-11-12,52,6,48,100
"31039","1700-1759",2022-11-13,64,7,49,113
"31040","1700-1759",2022-11-14,62,1,52,114
"31041","1700-1759",2022-11-15,58,2,51,109
"31042","1700-1759",2022-11-16,57,3,52,109
"31043","1700-1759",2022-11-17,64,4,53,117
"31044","1700-1759",2022-11-18,59,5,53,112
"31045","1700-1759",2022-11-19,52,6,46,98
"31046","1700-1759",2022-11-20,63,7,53,116
"31047","1700-1759",2022-11-21,59,1,55,114
"31048","1700-1759",2022-11-22,61,2,54,115
"31049","1700-1759",2022-11-23,62,3,55,117
"31050","1700-1759",2022-11-24,19,4,37,56
"31051","1700-1759",2022-11-25,51,5,53,104
"31052","1700-1759",2022-11-26,53,6,45,98
"31053","1700-1759",2022-11-27,66,7,55,121
"31054","1700-1759",2022-11-28,62,1,54,116
"31055","1700-1759",2022-11-29,55,2,56,111
"31056","1700-1759",2022-11-30,51,3,57,108
"31057","1800-1859",2022-11-01,55,2,69,124
"31058","1800-1859",2022-11-02,56,3,68,124
"31059","1800-1859",2022-11-03,59,4,68,127
"31060","1800-1859",2022-11-04,56,5,68,124
"31061","1800-1859",2022-11-05,50,6,62,112
"31062","1800-1859",2022-11-06,54,7,74,128
"31063","1800-1859",2022-11-07,51,1,74,125
"31064","1800-1859",2022-11-08,50,2,69,119
"31065","1800-1859",2022-11-09,52,3,72,124
"31066","1800-1859",2022-11-10,55,4,77,132
"31067","1800-1859",2022-11-11,54,5,77,131
"31068","1800-1859",2022-11-12,46,6,62,108
"31069","1800-1859",2022-11-13,55,7,77,132
"31070","1800-1859",2022-11-14,53,1,77,130
"31071","1800-1859",2022-11-15,51,2,71,122
"31072","1800-1859",2022-11-16,51,3,71,122
"31073","1800-1859",2022-11-17,54,4,77,131
"31074","1800-1859",2022-11-18,57,5,75,132
"31075","1800-1859",2022-11-19,51,6,64,115
"31076","1800-1859",2022-11-20,57,7,77,134
"31077","1800-1859",2022-11-21,56,1,73,129
"31078","1800-1859",2022-11-22,53,2,67,120
"31079","1800-1859",2022-11-23,58,3,69,127
"31080","1800-1859",2022-11-24,13,4,30,43
"31081","1800-1859",2022-11-25,53,5,67,120
"31082","1800-1859",2022-11-26,56,6,68,124
"31083","1800-1859",2022-11-27,56,7,71,127
"31084","1800-1859",2022-11-28,53,1,70,123
"31085","1800-1859",2022-11-29,53,2,69,122
"31086","1800-1859",2022-11-30,48,3,70,118
"31087","1900-1959",2022-11-01,57,2,52,109
"31088","1900-1959",2022-11-02,57,3,51,108
"31089","1900-1959",2022-11-03,65,4,54,119
"31090","1900-1959",2022-11-04,65,5,54,119
"31091","1900-1959",2022-11-05,53,6,52,105
"31092","1900-1959",2022-11-06,62,7,55,117
"31093","1900-1959",2022-11-07,65,1,54,119
"31094","1900-1959",2022-11-08,62,2,51,113
"31095","1900-1959",2022-11-09,64,3,49,113
"31096","1900-1959",2022-11-10,72,4,54,126
"31097","1900-1959",2022-11-11,72,5,55,127
"31098","1900-1959",2022-11-12,57,6,46,103
"31099","1900-1959",2022-11-13,70,7,54,124
"31100","1900-1959",2022-11-14,71,1,54,125
"31101","1900-1959",2022-11-15,65,2,51,116
"31102","1900-1959",2022-11-16,64,3,49,113
"31103","1900-1959",2022-11-17,73,4,54,127
"31104","1900-1959",2022-11-18,72,5,52,124
"31105","1900-1959",2022-11-19,61,6,47,108
"31106","1900-1959",2022-11-20,72,7,51,123
"31107","1900-1959",2022-11-21,68,1,52,120
"31108","1900-1959",2022-11-22,70,2,49,119
"31109","1900-1959",2022-11-23,72,3,49,121
"31110","1900-1959",2022-11-24,9,4,20,29
"31111","1900-1959",2022-11-25,62,5,48,110
"31112","1900-1959",2022-11-26,70,6,45,115
"31113","1900-1959",2022-11-27,74,7,50,124
"31114","1900-1959",2022-11-28,72,1,52,124
"31115","1900-1959",2022-11-29,68,2,48,116
"31116","1900-1959",2022-11-30,57,3,46,103
"31117","2000-2059",2022-11-01,45,2,71,116
"31118","2000-2059",2022-11-02,45,3,71,116
"31119","2000-2059",2022-11-03,49,4,78,127
"31120","2000-2059",2022-11-04,49,5,79,128
"31121","2000-2059",2022-11-05,34,6,69,103
"31122","2000-2059",2022-11-06,44,7,67,111
"31123","2000-2059",2022-11-07,42,1,65,107
"31124","2000-2059",2022-11-08,39,2,62,101
"31125","2000-2059",2022-11-09,42,3,65,107
"31126","2000-2059",2022-11-10,48,4,68,116
"31127","2000-2059",2022-11-11,47,5,68,115
"31128","2000-2059",2022-11-12,37,6,63,100
"31129","2000-2059",2022-11-13,47,7,69,116
"31130","2000-2059",2022-11-14,46,1,65,111
"31131","2000-2059",2022-11-15,40,2,65,105
"31132","2000-2059",2022-11-16,43,3,66,109
"31133","2000-2059",2022-11-17,46,4,70,116
"31134","2000-2059",2022-11-18,45,5,70,115
"31135","2000-2059",2022-11-19,40,6,67,107
"31136","2000-2059",2022-11-20,47,7,73,120
"31137","2000-2059",2022-11-21,45,1,72,117
"31138","2000-2059",2022-11-22,44,2,68,112
"31139","2000-2059",2022-11-23,45,3,69,114
"31140","2000-2059",2022-11-24,14,4,28,42
"31141","2000-2059",2022-11-25,38,5,67,105
"31142","2000-2059",2022-11-26,45,6,67,112
"31143","2000-2059",2022-11-27,48,7,75,123
"31144","2000-2059",2022-11-28,46,1,67,113
"31145","2000-2059",2022-11-29,46,2,71,117
"31146","2000-2059",2022-11-30,37,3,66,103
"31147","2100-2159",2022-11-01,39,2,64,103
"31148","2100-2159",2022-11-02,41,3,62,103
"31149","2100-2159",2022-11-03,47,4,68,115
"31150","2100-2159",2022-11-04,48,5,69,117
"31151","2100-2159",2022-11-05,26,6,54,80
"31152","2100-2159",2022-11-06,42,7,69,111
"31153","2100-2159",2022-11-07,44,1,67,111
"31154","2100-2159",2022-11-08,40,2,66,106
"31155","2100-2159",2022-11-09,39,3,70,109
"31156","2100-2159",2022-11-10,42,4,72,114
"31157","2100-2159",2022-11-11,43,5,72,115
"31158","2100-2159",2022-11-12,28,6,64,92
"31159","2100-2159",2022-11-13,42,7,72,114
"31160","2100-2159",2022-11-14,41,1,72,113
"31161","2100-2159",2022-11-15,38,2,70,108
"31162","2100-2159",2022-11-16,39,3,70,109
"31163","2100-2159",2022-11-17,41,4,70,111
"31164","2100-2159",2022-11-18,47,5,73,120
"31165","2100-2159",2022-11-19,34,6,68,102
"31166","2100-2159",2022-11-20,48,7,74,122
"31167","2100-2159",2022-11-21,45,1,71,116
"31168","2100-2159",2022-11-22,40,2,71,111
"31169","2100-2159",2022-11-23,47,3,73,120
"31170","2100-2159",2022-11-24,9,4,16,25
"31171","2100-2159",2022-11-25,45,5,67,112
"31172","2100-2159",2022-11-26,38,6,76,114
"31173","2100-2159",2022-11-27,49,7,73,122
"31174","2100-2159",2022-11-28,45,1,73,118
"31175","2100-2159",2022-11-29,38,2,73,111
"31176","2100-2159",2022-11-30,38,3,66,104
"31177","2200-2259",2022-11-01,29,2,56,85
"31178","2200-2259",2022-11-02,31,3,58,89
"31179","2200-2259",2022-11-03,32,4,60,92
"31180","2200-2259",2022-11-04,32,5,58,90
"31181","2200-2259",2022-11-05,25,6,46,71
"31182","2200-2259",2022-11-06,35,7,60,95
"31183","2200-2259",2022-11-07,31,1,66,97
"31184","2200-2259",2022-11-08,26,2,58,84
"31185","2200-2259",2022-11-09,32,3,61,93
"31186","2200-2259",2022-11-10,37,4,68,105
"31187","2200-2259",2022-11-11,39,5,69,108
"31188","2200-2259",2022-11-12,31,6,55,86
"31189","2200-2259",2022-11-13,40,7,66,106
"31190","2200-2259",2022-11-14,36,1,69,105
"31191","2200-2259",2022-11-15,29,2,59,88
"31192","2200-2259",2022-11-16,32,3,61,93
"31193","2200-2259",2022-11-17,37,4,67,104
"31194","2200-2259",2022-11-18,36,5,69,105
"31195","2200-2259",2022-11-19,29,6,56,85
"31196","2200-2259",2022-11-20,37,7,68,105
"31197","2200-2259",2022-11-21,31,1,68,99
"31198","2200-2259",2022-11-22,37,2,65,102
"31199","2200-2259",2022-11-23,40,3,71,111
"31200","2200-2259",2022-11-24,15,4,18,33
"31201","2200-2259",2022-11-25,26,5,58,84
"31202","2200-2259",2022-11-26,36,6,67,103
"31203","2200-2259",2022-11-27,41,7,72,113
"31204","2200-2259",2022-11-28,36,1,70,106
"31205","2200-2259",2022-11-29,32,2,63,95
"31206","2200-2259",2022-11-30,32,3,58,90
"31207","2300-2359",2022-11-01,16,2,48,64
"31208","2300-2359",2022-11-02,15,3,47,62
"31209","2300-2359",2022-11-03,21,4,60,81
"31210","2300-2359",2022-11-04,21,5,61,82
"31211","2300-2359",2022-11-05,23,6,46,69
"31212","2300-2359",2022-11-06,22,7,58,80
"31213","2300-2359",2022-11-07,24,1,55,79
"31214","2300-2359",2022-11-08,22,2,51,73
"31215","2300-2359",2022-11-09,21,3,51,72
"31216","2300-2359",2022-11-10,26,4,62,88
"31217","2300-2359",2022-11-11,26,5,61,87
"31218","2300-2359",2022-11-12,23,6,47,70
"31219","2300-2359",2022-11-13,25,7,64,89
"31220","2300-2359",2022-11-14,25,1,57,82
"31221","2300-2359",2022-11-15,22,2,50,72
"31222","2300-2359",2022-11-16,21,3,52,73
"31223","2300-2359",2022-11-17,27,4,61,88
"31224","2300-2359",2022-11-18,27,5,65,92
"31225","2300-2359",2022-11-19,28,6,58,86
"31226","2300-2359",2022-11-20,29,7,68,97
"31227","2300-2359",2022-11-21,26,1,58,84
"31228","2300-2359",2022-11-22,27,2,61,88
"31229","2300-2359",2022-11-23,29,3,64,93
"31230","2300-2359",2022-11-24,18,4,20,38
"31231","2300-2359",2022-11-25,27,5,56,83
"31232","2300-2359",2022-11-26,30,6,65,95
"31233","2300-2359",2022-11-27,33,7,71,104
"31234","2300-2359",2022-11-28,30,1,63,93
"31235","2300-2359",2022-11-29,24,2,52,76
"31236","2300-2359",2022-11-30,21,3,48,69
"31237","0001-0559",2022-12-01,24,4,50,74
"31238","0001-0559",2022-12-02,24,5,50,74
"31239","0001-0559",2022-12-03,26,6,40,66
"31240","0001-0559",2022-12-04,20,7,52,72
"31241","0001-0559",2022-12-05,24,1,48,72
"31242","0001-0559",2022-12-06,23,2,44,67
"31243","0001-0559",2022-12-07,22,3,46,68
"31244","0001-0559",2022-12-08,24,4,50,74
"31245","0001-0559",2022-12-09,24,5,49,73
"31246","0001-0559",2022-12-10,25,6,40,65
"31247","0001-0559",2022-12-11,20,7,52,72
"31248","0001-0559",2022-12-12,27,1,47,74
"31249","0001-0559",2022-12-13,27,2,41,68
"31250","0001-0559",2022-12-14,25,3,47,72
"31251","0001-0559",2022-12-15,32,4,54,86
"31252","0001-0559",2022-12-16,26,5,55,81
"31253","0001-0559",2022-12-17,33,6,40,73
"31254","0001-0559",2022-12-18,26,7,49,75
"31255","0001-0559",2022-12-19,27,1,49,76
"31256","0001-0559",2022-12-20,29,2,45,74
"31257","0001-0559",2022-12-21,24,3,52,76
"31258","0001-0559",2022-12-22,26,4,56,82
"31259","0001-0559",2022-12-23,26,5,56,82
"31260","0001-0559",2022-12-24,30,6,28,58
"31261","0001-0559",2022-12-25,16,7,37,53
"31262","0001-0559",2022-12-26,23,1,48,71
"31263","0001-0559",2022-12-27,25,2,47,72
"31264","0001-0559",2022-12-28,23,3,49,72
"31265","0001-0559",2022-12-29,24,4,53,77
"31266","0001-0559",2022-12-30,24,5,49,73
"31267","0001-0559",2022-12-31,30,6,28,58
"31268","0600-0659",2022-12-01,66,4,25,91
"31269","0600-0659",2022-12-02,65,5,25,90
"31270","0600-0659",2022-12-03,61,6,29,90
"31271","0600-0659",2022-12-04,72,7,26,98
"31272","0600-0659",2022-12-05,70,1,26,96
"31273","0600-0659",2022-12-06,64,2,24,88
"31274","0600-0659",2022-12-07,60,3,26,86
"31275","0600-0659",2022-12-08,66,4,28,94
"31276","0600-0659",2022-12-09,64,5,28,92
"31277","0600-0659",2022-12-10,59,6,30,89
"31278","0600-0659",2022-12-11,69,7,27,96
"31279","0600-0659",2022-12-12,64,1,27,91
"31280","0600-0659",2022-12-13,59,2,25,84
"31281","0600-0659",2022-12-14,57,3,26,83
"31282","0600-0659",2022-12-15,62,4,29,91
"31283","0600-0659",2022-12-16,72,5,30,102
"31284","0600-0659",2022-12-17,64,6,34,98
"31285","0600-0659",2022-12-18,71,7,29,100
"31286","0600-0659",2022-12-19,72,1,28,100
"31287","0600-0659",2022-12-20,67,2,27,94
"31288","0600-0659",2022-12-21,71,3,27,98
"31289","0600-0659",2022-12-22,75,4,27,102
"31290","0600-0659",2022-12-23,77,5,26,103
"31291","0600-0659",2022-12-24,61,6,22,83
"31292","0600-0659",2022-12-25,46,7,18,64
"31293","0600-0659",2022-12-26,77,1,26,103
"31294","0600-0659",2022-12-27,73,2,26,99
"31295","0600-0659",2022-12-28,71,3,26,97
"31296","0600-0659",2022-12-29,75,4,26,101
"31297","0600-0659",2022-12-30,76,5,26,102
"31298","0600-0659",2022-12-31,60,6,25,85
"31299","0700-0759",2022-12-01,79,4,44,123
"31300","0700-0759",2022-12-02,81,5,42,123
"31301","0700-0759",2022-12-03,76,6,40,116
"31302","0700-0759",2022-12-04,79,7,48,127
"31303","0700-0759",2022-12-05,82,1,45,127
"31304","0700-0759",2022-12-06,79,2,43,122
"31305","0700-0759",2022-12-07,78,3,38,116
"31306","0700-0759",2022-12-08,81,4,43,124
"31307","0700-0759",2022-12-09,84,5,41,125
"31308","0700-0759",2022-12-10,78,6,37,115
"31309","0700-0759",2022-12-11,80,7,46,126
"31310","0700-0759",2022-12-12,83,1,43,126
"31311","0700-0759",2022-12-13,78,2,41,119
"31312","0700-0759",2022-12-14,79,3,38,117
"31313","0700-0759",2022-12-15,82,4,49,131
"31314","0700-0759",2022-12-16,82,5,51,133
"31315","0700-0759",2022-12-17,81,6,43,124
"31316","0700-0759",2022-12-18,81,7,51,132
"31317","0700-0759",2022-12-19,79,1,48,127
"31318","0700-0759",2022-12-20,79,2,49,128
"31319","0700-0759",2022-12-21,80,3,47,127
"31320","0700-0759",2022-12-22,80,4,50,130
"31321","0700-0759",2022-12-23,80,5,48,128
"31322","0700-0759",2022-12-24,76,6,39,115
"31323","0700-0759",2022-12-25,65,7,34,99
"31324","0700-0759",2022-12-26,76,1,51,127
"31325","0700-0759",2022-12-27,75,2,49,124
"31326","0700-0759",2022-12-28,77,3,49,126
"31327","0700-0759",2022-12-29,77,4,50,127
"31328","0700-0759",2022-12-30,79,5,50,129
"31329","0700-0759",2022-12-31,76,6,39,115
"31330","0800-0859",2022-12-01,75,4,43,118
"31331","0800-0859",2022-12-02,77,5,41,118
"31332","0800-0859",2022-12-03,67,6,35,102
"31333","0800-0859",2022-12-04,76,7,35,111
"31334","0800-0859",2022-12-05,76,1,43,119
"31335","0800-0859",2022-12-06,75,2,38,113
"31336","0800-0859",2022-12-07,76,3,36,112
"31337","0800-0859",2022-12-08,74,4,41,115
"31338","0800-0859",2022-12-09,77,5,40,117
"31339","0800-0859",2022-12-10,65,6,35,100
"31340","0800-0859",2022-12-11,76,7,35,111
"31341","0800-0859",2022-12-12,76,1,42,118
"31342","0800-0859",2022-12-13,75,2,36,111
"31343","0800-0859",2022-12-14,77,3,36,113
"31344","0800-0859",2022-12-15,78,4,42,120
"31345","0800-0859",2022-12-16,82,5,38,120
"31346","0800-0859",2022-12-17,70,6,43,113
"31347","0800-0859",2022-12-18,81,7,38,119
"31348","0800-0859",2022-12-19,82,1,42,124
"31349","0800-0859",2022-12-20,85,2,38,123
"31350","0800-0859",2022-12-21,82,3,40,122
"31351","0800-0859",2022-12-22,80,4,41,121
"31352","0800-0859",2022-12-23,79,5,41,120
"31353","0800-0859",2022-12-24,71,6,38,109
"31354","0800-0859",2022-12-25,73,7,29,102
"31355","0800-0859",2022-12-26,77,1,41,118
"31356","0800-0859",2022-12-27,79,2,38,117
"31357","0800-0859",2022-12-28,80,3,38,118
"31358","0800-0859",2022-12-29,78,4,39,117
"31359","0800-0859",2022-12-30,76,5,40,116
"31360","0800-0859",2022-12-31,69,6,38,107
"31361","0900-0959",2022-12-01,71,4,46,117
"31362","0900-0959",2022-12-02,71,5,50,121
"31363","0900-0959",2022-12-03,63,6,46,109
"31364","0900-0959",2022-12-04,67,7,51,118
"31365","0900-0959",2022-12-05,71,1,49,120
"31366","0900-0959",2022-12-06,69,2,46,115
"31367","0900-0959",2022-12-07,66,3,51,117
"31368","0900-0959",2022-12-08,69,4,49,118
"31369","0900-0959",2022-12-09,68,5,52,120
"31370","0900-0959",2022-12-10,64,6,46,110
"31371","0900-0959",2022-12-11,65,7,53,118
"31372","0900-0959",2022-12-12,70,1,51,121
"31373","0900-0959",2022-12-13,67,2,50,117
"31374","0900-0959",2022-12-14,67,3,51,118
"31375","0900-0959",2022-12-15,67,4,51,118
"31376","0900-0959",2022-12-16,65,5,56,121
"31377","0900-0959",2022-12-17,67,6,50,117
"31378","0900-0959",2022-12-18,59,7,54,113
"31379","0900-0959",2022-12-19,65,1,51,116
"31380","0900-0959",2022-12-20,64,2,52,116
"31381","0900-0959",2022-12-21,64,3,52,116
"31382","0900-0959",2022-12-22,63,4,50,113
"31383","0900-0959",2022-12-23,61,5,52,113
"31384","0900-0959",2022-12-24,60,6,49,109
"31385","0900-0959",2022-12-25,53,7,42,95
"31386","0900-0959",2022-12-26,62,1,46,108
"31387","0900-0959",2022-12-27,61,2,47,108
"31388","0900-0959",2022-12-28,63,3,48,111
"31389","0900-0959",2022-12-29,62,4,46,108
"31390","0900-0959",2022-12-30,61,5,48,109
"31391","0900-0959",2022-12-31,62,6,46,108
"31392","1000-1059",2022-12-01,64,4,47,111
"31393","1000-1059",2022-12-02,63,5,47,110
"31394","1000-1059",2022-12-03,63,6,41,104
"31395","1000-1059",2022-12-04,63,7,43,106
"31396","1000-1059",2022-12-05,62,1,47,109
"31397","1000-1059",2022-12-06,63,2,46,109
"31398","1000-1059",2022-12-07,62,3,44,106
"31399","1000-1059",2022-12-08,64,4,45,109
"31400","1000-1059",2022-12-09,65,5,46,111
"31401","1000-1059",2022-12-10,64,6,41,105
"31402","1000-1059",2022-12-11,65,7,43,108
"31403","1000-1059",2022-12-12,64,1,45,109
"31404","1000-1059",2022-12-13,66,2,43,109
"31405","1000-1059",2022-12-14,64,3,44,108
"31406","1000-1059",2022-12-15,62,4,51,113
"31407","1000-1059",2022-12-16,67,5,50,117
"31408","1000-1059",2022-12-17,60,6,44,104
"31409","1000-1059",2022-12-18,68,7,48,116
"31410","1000-1059",2022-12-19,66,1,52,118
"31411","1000-1059",2022-12-20,66,2,52,118
"31412","1000-1059",2022-12-21,63,3,55,118
"31413","1000-1059",2022-12-22,62,4,53,115
"31414","1000-1059",2022-12-23,63,5,51,114
"31415","1000-1059",2022-12-24,56,6,43,99
"31416","1000-1059",2022-12-25,57,7,43,100
"31417","1000-1059",2022-12-26,59,1,53,112
"31418","1000-1059",2022-12-27,60,2,52,112
"31419","1000-1059",2022-12-28,60,3,55,115
"31420","1000-1059",2022-12-29,59,4,53,112
"31421","1000-1059",2022-12-30,61,5,52,113
"31422","1000-1059",2022-12-31,53,6,43,96
"31423","1100-1159",2022-12-01,47,4,59,106
"31424","1100-1159",2022-12-02,47,5,59,106
"31425","1100-1159",2022-12-03,37,6,58,95
"31426","1100-1159",2022-12-04,49,7,59,108
"31427","1100-1159",2022-12-05,47,1,59,106
"31428","1100-1159",2022-12-06,47,2,58,105
"31429","1100-1159",2022-12-07,45,3,56,101
"31430","1100-1159",2022-12-08,48,4,59,107
"31431","1100-1159",2022-12-09,48,5,58,106
"31432","1100-1159",2022-12-10,38,6,57,95
"31433","1100-1159",2022-12-11,50,7,57,107
"31434","1100-1159",2022-12-12,47,1,60,107
"31435","1100-1159",2022-12-13,45,2,58,103
"31436","1100-1159",2022-12-14,44,3,58,102
"31437","1100-1159",2022-12-15,50,4,54,104
"31438","1100-1159",2022-12-16,51,5,57,108
"31439","1100-1159",2022-12-17,39,6,58,97
"31440","1100-1159",2022-12-18,55,7,53,108
"31441","1100-1159",2022-12-19,50,1,54,104
"31442","1100-1159",2022-12-20,51,2,55,106
"31443","1100-1159",2022-12-21,51,3,56,107
"31444","1100-1159",2022-12-22,51,4,59,110
"31445","1100-1159",2022-12-23,50,5,59,109
"31446","1100-1159",2022-12-24,41,6,52,93
"31447","1100-1159",2022-12-25,50,7,39,89
"31448","1100-1159",2022-12-26,48,1,57,105
"31449","1100-1159",2022-12-27,49,2,58,107
"31450","1100-1159",2022-12-28,50,3,56,106
"31451","1100-1159",2022-12-29,50,4,59,109
"31452","1100-1159",2022-12-30,49,5,58,107
"31453","1100-1159",2022-12-31,39,6,53,92
"31454","1200-1259",2022-12-01,54,4,56,110
"31455","1200-1259",2022-12-02,55,5,55,110
"31456","1200-1259",2022-12-03,46,6,51,97
"31457","1200-1259",2022-12-04,50,7,55,105
"31458","1200-1259",2022-12-05,53,1,55,108
"31459","1200-1259",2022-12-06,52,2,55,107
"31460","1200-1259",2022-12-07,53,3,52,105
"31461","1200-1259",2022-12-08,55,4,55,110
"31462","1200-1259",2022-12-09,54,5,54,108
"31463","1200-1259",2022-12-10,47,6,51,98
"31464","1200-1259",2022-12-11,51,7,54,105
"31465","1200-1259",2022-12-12,54,1,53,107
"31466","1200-1259",2022-12-13,52,2,54,106
"31467","1200-1259",2022-12-14,53,3,52,105
"31468","1200-1259",2022-12-15,53,4,55,108
"31469","1200-1259",2022-12-16,51,5,54,105
"31470","1200-1259",2022-12-17,53,6,55,108
"31471","1200-1259",2022-12-18,52,7,57,109
"31472","1200-1259",2022-12-19,54,1,55,109
"31473","1200-1259",2022-12-20,52,2,57,109
"31474","1200-1259",2022-12-21,56,3,52,108
"31475","1200-1259",2022-12-22,57,4,53,110
"31476","1200-1259",2022-12-23,58,5,50,108
"31477","1200-1259",2022-12-24,48,6,57,105
"31478","1200-1259",2022-12-25,50,7,50,100
"31479","1200-1259",2022-12-26,60,1,48,108
"31480","1200-1259",2022-12-27,55,2,50,105
"31481","1200-1259",2022-12-28,57,3,48,105
"31482","1200-1259",2022-12-29,57,4,49,106
"31483","1200-1259",2022-12-30,59,5,47,106
"31484","1200-1259",2022-12-31,50,6,58,108
"31485","1300-1359",2022-12-01,57,4,50,107
"31486","1300-1359",2022-12-02,58,5,51,109
"31487","1300-1359",2022-12-03,54,6,44,98
"31488","1300-1359",2022-12-04,58,7,50,108
"31489","1300-1359",2022-12-05,58,1,51,109
"31490","1300-1359",2022-12-06,55,2,53,108
"31491","1300-1359",2022-12-07,52,3,52,104
"31492","1300-1359",2022-12-08,54,4,53,107
"31493","1300-1359",2022-12-09,54,5,53,107
"31494","1300-1359",2022-12-10,49,6,49,98
"31495","1300-1359",2022-12-11,54,7,52,106
"31496","1300-1359",2022-12-12,53,1,53,106
"31497","1300-1359",2022-12-13,55,2,52,107
"31498","1300-1359",2022-12-14,52,3,53,105
"31499","1300-1359",2022-12-15,57,4,53,110
"31500","1300-1359",2022-12-16,59,5,56,115
"31501","1300-1359",2022-12-17,50,6,46,96
"31502","1300-1359",2022-12-18,56,7,54,110
"31503","1300-1359",2022-12-19,56,1,53,109
"31504","1300-1359",2022-12-20,59,2,53,112
"31505","1300-1359",2022-12-21,54,3,54,108
"31506","1300-1359",2022-12-22,58,4,53,111
"31507","1300-1359",2022-12-23,54,5,53,107
"31508","1300-1359",2022-12-24,52,6,48,100
"31509","1300-1359",2022-12-25,53,7,54,107
"31510","1300-1359",2022-12-26,50,1,54,104
"31511","1300-1359",2022-12-27,58,2,52,110
"31512","1300-1359",2022-12-28,51,3,54,105
"31513","1300-1359",2022-12-29,56,4,53,109
"31514","1300-1359",2022-12-30,50,5,53,103
"31515","1300-1359",2022-12-31,50,6,46,96
"31516","1400-1459",2022-12-01,54,4,63,117
"31517","1400-1459",2022-12-02,53,5,65,118
"31518","1400-1459",2022-12-03,43,6,56,99
"31519","1400-1459",2022-12-04,50,7,57,107
"31520","1400-1459",2022-12-05,54,1,63,117
"31521","1400-1459",2022-12-06,54,2,59,113
"31522","1400-1459",2022-12-07,53,3,57,110
"31523","1400-1459",2022-12-08,55,4,58,113
"31524","1400-1459",2022-12-09,56,5,61,117
"31525","1400-1459",2022-12-10,49,6,51,100
"31526","1400-1459",2022-12-11,53,7,54,107
"31527","1400-1459",2022-12-12,56,1,61,117
"31528","1400-1459",2022-12-13,52,2,60,112
"31529","1400-1459",2022-12-14,53,3,57,110
"31530","1400-1459",2022-12-15,56,4,57,113
"31531","1400-1459",2022-12-16,53,5,58,111
"31532","1400-1459",2022-12-17,47,6,56,103
"31533","1400-1459",2022-12-18,53,7,62,115
"31534","1400-1459",2022-12-19,51,1,64,115
"31535","1400-1459",2022-12-20,49,2,64,113
"31536","1400-1459",2022-12-21,46,3,62,108
"31537","1400-1459",2022-12-22,49,4,62,111
"31538","1400-1459",2022-12-23,49,5,65,114
"31539","1400-1459",2022-12-24,43,6,50,93
"31540","1400-1459",2022-12-25,51,7,54,105
"31541","1400-1459",2022-12-26,49,1,59,108
"31542","1400-1459",2022-12-27,46,2,60,106
"31543","1400-1459",2022-12-28,46,3,59,105
"31544","1400-1459",2022-12-29,49,4,59,108
"31545","1400-1459",2022-12-30,49,5,62,111
"31546","1400-1459",2022-12-31,44,6,51,95
"31547","1500-1559",2022-12-01,66,4,57,123
"31548","1500-1559",2022-12-02,67,5,57,124
"31549","1500-1559",2022-12-03,62,6,47,109
"31550","1500-1559",2022-12-04,62,7,60,122
"31551","1500-1559",2022-12-05,65,1,59,124
"31552","1500-1559",2022-12-06,63,2,60,123
"31553","1500-1559",2022-12-07,64,3,58,122
"31554","1500-1559",2022-12-08,65,4,63,128
"31555","1500-1559",2022-12-09,65,5,63,128
"31556","1500-1559",2022-12-10,59,6,53,112
"31557","1500-1559",2022-12-11,61,7,66,127
"31558","1500-1559",2022-12-12,65,1,63,128
"31559","1500-1559",2022-12-13,63,2,60,123
"31560","1500-1559",2022-12-14,64,3,59,123
"31561","1500-1559",2022-12-15,55,4,60,115
"31562","1500-1559",2022-12-16,55,5,62,117
"31563","1500-1559",2022-12-17,51,6,49,100
"31564","1500-1559",2022-12-18,55,7,52,107
"31565","1500-1559",2022-12-19,53,1,55,108
"31566","1500-1559",2022-12-20,53,2,53,106
"31567","1500-1559",2022-12-21,61,3,50,111
"31568","1500-1559",2022-12-22,63,4,54,117
"31569","1500-1559",2022-12-23,63,5,53,116
"31570","1500-1559",2022-12-24,40,6,52,92
"31571","1500-1559",2022-12-25,42,7,59,101
"31572","1500-1559",2022-12-26,57,1,55,112
"31573","1500-1559",2022-12-27,58,2,53,111
"31574","1500-1559",2022-12-28,56,3,52,108
"31575","1500-1559",2022-12-29,58,4,56,114
"31576","1500-1559",2022-12-30,58,5,55,113
"31577","1500-1559",2022-12-31,42,6,51,93
"31578","1600-1659",2022-12-01,55,4,51,106
"31579","1600-1659",2022-12-02,54,5,49,103
"31580","1600-1659",2022-12-03,52,6,46,98
"31581","1600-1659",2022-12-04,59,7,51,110
"31582","1600-1659",2022-12-05,56,1,49,105
"31583","1600-1659",2022-12-06,54,2,51,105
"31584","1600-1659",2022-12-07,56,3,47,103
"31585","1600-1659",2022-12-08,58,4,47,105
"31586","1600-1659",2022-12-09,57,5,46,103
"31587","1600-1659",2022-12-10,52,6,44,96
"31588","1600-1659",2022-12-11,62,7,47,109
"31589","1600-1659",2022-12-12,58,1,48,106
"31590","1600-1659",2022-12-13,56,2,48,104
"31591","1600-1659",2022-12-14,56,3,47,103
"31592","1600-1659",2022-12-15,66,4,50,116
"31593","1600-1659",2022-12-16,71,5,49,120
"31594","1600-1659",2022-12-17,63,6,53,116
"31595","1600-1659",2022-12-18,71,7,53,124
"31596","1600-1659",2022-12-19,73,1,52,125
"31597","1600-1659",2022-12-20,69,2,53,122
"31598","1600-1659",2022-12-21,63,3,53,116
"31599","1600-1659",2022-12-22,64,4,56,120
"31600","1600-1659",2022-12-23,63,5,54,117
"31601","1600-1659",2022-12-24,48,6,49,97
"31602","1600-1659",2022-12-25,62,7,51,113
"31603","1600-1659",2022-12-26,62,1,52,114
"31604","1600-1659",2022-12-27,60,2,55,115
"31605","1600-1659",2022-12-28,62,3,52,114
"31606","1600-1659",2022-12-29,62,4,55,117
"31607","1600-1659",2022-12-30,61,5,53,114
"31608","1600-1659",2022-12-31,49,6,47,96
"31609","1700-1759",2022-12-01,56,4,57,113
"31610","1700-1759",2022-12-02,53,5,56,109
"31611","1700-1759",2022-12-03,53,6,51,104
"31612","1700-1759",2022-12-04,57,7,54,111
"31613","1700-1759",2022-12-05,56,1,57,113
"31614","1700-1759",2022-12-06,54,2,55,109
"31615","1700-1759",2022-12-07,53,3,60,113
"31616","1700-1759",2022-12-08,55,4,61,116
"31617","1700-1759",2022-12-09,53,5,62,115
"31618","1700-1759",2022-12-10,54,6,53,107
"31619","1700-1759",2022-12-11,54,7,58,112
"31620","1700-1759",2022-12-12,55,1,62,117
"31621","1700-1759",2022-12-13,55,2,59,114
"31622","1700-1759",2022-12-14,53,3,60,113
"31623","1700-1759",2022-12-15,53,4,57,110
"31624","1700-1759",2022-12-16,52,5,55,107
"31625","1700-1759",2022-12-17,46,6,45,91
"31626","1700-1759",2022-12-18,44,7,56,100
"31627","1700-1759",2022-12-19,44,1,59,103
"31628","1700-1759",2022-12-20,46,2,56,102
"31629","1700-1759",2022-12-21,50,3,57,107
"31630","1700-1759",2022-12-22,51,4,57,108
"31631","1700-1759",2022-12-23,50,5,57,107
"31632","1700-1759",2022-12-24,36,6,35,71
"31633","1700-1759",2022-12-25,39,7,51,90
"31634","1700-1759",2022-12-26,50,1,59,109
"31635","1700-1759",2022-12-27,54,2,57,111
"31636","1700-1759",2022-12-28,51,3,58,109
"31637","1700-1759",2022-12-29,52,4,58,110
"31638","1700-1759",2022-12-30,51,5,58,109
"31639","1700-1759",2022-12-31,41,6,40,81
"31640","1800-1859",2022-12-01,54,4,73,127
"31641","1800-1859",2022-12-02,55,5,72,127
"31642","1800-1859",2022-12-03,44,6,63,107
"31643","1800-1859",2022-12-04,56,7,78,134
"31644","1800-1859",2022-12-05,53,1,70,123
"31645","1800-1859",2022-12-06,43,2,68,111
"31646","1800-1859",2022-12-07,47,3,69,116
"31647","1800-1859",2022-12-08,52,4,68,120
"31648","1800-1859",2022-12-09,55,5,68,123
"31649","1800-1859",2022-12-10,46,6,60,106
"31650","1800-1859",2022-12-11,56,7,73,129
"31651","1800-1859",2022-12-12,52,1,66,118
"31652","1800-1859",2022-12-13,43,2,66,109
"31653","1800-1859",2022-12-14,48,3,69,117
"31654","1800-1859",2022-12-15,56,4,65,121
"31655","1800-1859",2022-12-16,61,5,73,134
"31656","1800-1859",2022-12-17,54,6,59,113
"31657","1800-1859",2022-12-18,63,7,71,134
"31658","1800-1859",2022-12-19,65,1,69,134
"31659","1800-1859",2022-12-20,63,2,67,130
"31660","1800-1859",2022-12-21,60,3,70,130
"31661","1800-1859",2022-12-22,61,4,67,128
"31662","1800-1859",2022-12-23,61,5,66,127
"31663","1800-1859",2022-12-24,26,6,40,66
"31664","1800-1859",2022-12-25,36,7,48,84
"31665","1800-1859",2022-12-26,60,1,64,124
"31666","1800-1859",2022-12-27,59,2,64,123
"31667","1800-1859",2022-12-28,59,3,68,127
"31668","1800-1859",2022-12-29,61,4,64,125
"31669","1800-1859",2022-12-30,62,5,65,127
"31670","1800-1859",2022-12-31,27,6,39,66
"31671","1900-1959",2022-12-01,63,4,51,114
"31672","1900-1959",2022-12-02,64,5,51,115
"31673","1900-1959",2022-12-03,54,6,44,98
"31674","1900-1959",2022-12-04,64,7,47,111
"31675","1900-1959",2022-12-05,59,1,53,112
"31676","1900-1959",2022-12-06,54,2,43,97
"31677","1900-1959",2022-12-07,55,3,42,97
"31678","1900-1959",2022-12-08,62,4,49,111
"31679","1900-1959",2022-12-09,63,5,47,110
"31680","1900-1959",2022-12-10,52,6,40,92
"31681","1900-1959",2022-12-11,64,7,46,110
"31682","1900-1959",2022-12-12,61,1,49,110
"31683","1900-1959",2022-12-13,55,2,44,99
"31684","1900-1959",2022-12-14,54,3,42,96
"31685","1900-1959",2022-12-15,69,4,54,123
"31686","1900-1959",2022-12-16,67,5,54,121
"31687","1900-1959",2022-12-17,60,6,44,104
"31688","1900-1959",2022-12-18,69,7,50,119
"31689","1900-1959",2022-12-19,69,1,47,116
"31690","1900-1959",2022-12-20,65,2,47,112
"31691","1900-1959",2022-12-21,67,3,47,114
"31692","1900-1959",2022-12-22,71,4,48,119
"31693","1900-1959",2022-12-23,70,5,47,117
"31694","1900-1959",2022-12-24,32,6,37,69
"31695","1900-1959",2022-12-25,45,7,41,86
"31696","1900-1959",2022-12-26,73,1,46,119
"31697","1900-1959",2022-12-27,69,2,46,115
"31698","1900-1959",2022-12-28,69,3,46,115
"31699","1900-1959",2022-12-29,72,4,47,119
"31700","1900-1959",2022-12-30,72,5,46,118
"31701","1900-1959",2022-12-31,32,6,37,69
"31702","2000-2059",2022-12-01,42,4,72,114
"31703","2000-2059",2022-12-02,43,5,71,114
"31704","2000-2059",2022-12-03,34,6,61,95
"31705","2000-2059",2022-12-04,42,7,72,114
"31706","2000-2059",2022-12-05,42,1,68,110
"31707","2000-2059",2022-12-06,39,2,63,102
"31708","2000-2059",2022-12-07,39,3,67,106
"31709","2000-2059",2022-12-08,43,4,72,115
"31710","2000-2059",2022-12-09,42,5,73,115
"31711","2000-2059",2022-12-10,34,6,64,98
"31712","2000-2059",2022-12-11,44,7,73,117
"31713","2000-2059",2022-12-12,40,1,70,110
"31714","2000-2059",2022-12-13,40,2,64,104
"31715","2000-2059",2022-12-14,37,3,67,104
"31716","2000-2059",2022-12-15,50,4,77,127
"31717","2000-2059",2022-12-16,53,5,73,126
"31718","2000-2059",2022-12-17,41,6,70,111
"31719","2000-2059",2022-12-18,47,7,78,125
"31720","2000-2059",2022-12-19,41,1,75,116
"31721","2000-2059",2022-12-20,43,2,73,116
"31722","2000-2059",2022-12-21,42,3,73,115
"31723","2000-2059",2022-12-22,42,4,77,119
"31724","2000-2059",2022-12-23,42,5,74,116
"31725","2000-2059",2022-12-24,22,6,54,76
"31726","2000-2059",2022-12-25,31,7,61,92
"31727","2000-2059",2022-12-26,41,1,70,111
"31728","2000-2059",2022-12-27,42,2,70,112
"31729","2000-2059",2022-12-28,43,3,68,111
"31730","2000-2059",2022-12-29,43,4,72,115
"31731","2000-2059",2022-12-30,40,5,69,109
"31732","2000-2059",2022-12-31,22,6,55,77
"31733","2100-2159",2022-12-01,46,4,70,116
"31734","2100-2159",2022-12-02,45,5,72,117
"31735","2100-2159",2022-12-03,27,6,71,98
"31736","2100-2159",2022-12-04,43,7,69,112
"31737","2100-2159",2022-12-05,44,1,68,112
"31738","2100-2159",2022-12-06,37,2,66,103
"31739","2100-2159",2022-12-07,40,3,65,105
"31740","2100-2159",2022-12-08,45,4,70,115
"31741","2100-2159",2022-12-09,45,5,70,115
"31742","2100-2159",2022-12-10,29,6,69,98
"31743","2100-2159",2022-12-11,41,7,71,112
"31744","2100-2159",2022-12-12,44,1,68,112
"31745","2100-2159",2022-12-13,38,2,68,106
"31746","2100-2159",2022-12-14,42,3,65,107
"31747","2100-2159",2022-12-15,44,4,76,120
"31748","2100-2159",2022-12-16,41,5,77,118
"31749","2100-2159",2022-12-17,34,6,72,106
"31750","2100-2159",2022-12-18,42,7,73,115
"31751","2100-2159",2022-12-19,43,1,73,116
"31752","2100-2159",2022-12-20,41,2,72,113
"31753","2100-2159",2022-12-21,45,3,70,115
"31754","2100-2159",2022-12-22,45,4,76,121
"31755","2100-2159",2022-12-23,45,5,76,121
"31756","2100-2159",2022-12-24,21,6,41,62
"31757","2100-2159",2022-12-25,31,7,48,79
"31758","2100-2159",2022-12-26,42,1,73,115
"31759","2100-2159",2022-12-27,42,2,74,116
"31760","2100-2159",2022-12-28,41,3,71,112
"31761","2100-2159",2022-12-29,42,4,76,118
"31762","2100-2159",2022-12-30,40,5,75,115
"31763","2100-2159",2022-12-31,21,6,45,66
"31764","2200-2259",2022-12-01,35,4,64,99
"31765","2200-2259",2022-12-02,35,5,69,104
"31766","2200-2259",2022-12-03,31,6,53,84
"31767","2200-2259",2022-12-04,39,7,69,108
"31768","2200-2259",2022-12-05,33,1,69,102
"31769","2200-2259",2022-12-06,30,2,60,90
"31770","2200-2259",2022-12-07,33,3,58,91
"31771","2200-2259",2022-12-08,36,4,67,103
"31772","2200-2259",2022-12-09,35,5,69,104
"31773","2200-2259",2022-12-10,30,6,57,87
"31774","2200-2259",2022-12-11,39,7,69,108
"31775","2200-2259",2022-12-12,34,1,67,101
"31776","2200-2259",2022-12-13,30,2,60,90
"31777","2200-2259",2022-12-14,34,3,58,92
"31778","2200-2259",2022-12-15,46,4,70,116
"31779","2200-2259",2022-12-16,45,5,74,119
"31780","2200-2259",2022-12-17,37,6,62,99
"31781","2200-2259",2022-12-18,47,7,72,119
"31782","2200-2259",2022-12-19,45,1,69,114
"31783","2200-2259",2022-12-20,39,2,68,107
"31784","2200-2259",2022-12-21,46,3,69,115
"31785","2200-2259",2022-12-22,51,4,70,121
"31786","2200-2259",2022-12-23,49,5,70,119
"31787","2200-2259",2022-12-24,24,6,37,61
"31788","2200-2259",2022-12-25,30,7,49,79
"31789","2200-2259",2022-12-26,49,1,72,121
"31790","2200-2259",2022-12-27,45,2,70,115
"31791","2200-2259",2022-12-28,46,3,70,116
"31792","2200-2259",2022-12-29,50,4,72,122
"31793","2200-2259",2022-12-30,48,5,70,118
"31794","2200-2259",2022-12-31,28,6,36,64
"31795","2300-2359",2022-12-01,26,4,56,82
"31796","2300-2359",2022-12-02,25,5,53,78
"31797","2300-2359",2022-12-03,25,6,42,67
"31798","2300-2359",2022-12-04,26,7,56,82
"31799","2300-2359",2022-12-05,26,1,52,78
"31800","2300-2359",2022-12-06,24,2,47,71
"31801","2300-2359",2022-12-07,20,3,50,70
"31802","2300-2359",2022-12-08,25,4,53,78
"31803","2300-2359",2022-12-09,24,5,53,77
"31804","2300-2359",2022-12-10,23,6,40,63
"31805","2300-2359",2022-12-11,25,7,53,78
"31806","2300-2359",2022-12-12,24,1,52,76
"31807","2300-2359",2022-12-13,22,2,49,71
"31808","2300-2359",2022-12-14,20,3,50,70
"31809","2300-2359",2022-12-15,27,4,61,88
"31810","2300-2359",2022-12-16,28,5,59,87
"31811","2300-2359",2022-12-17,26,6,53,79
"31812","2300-2359",2022-12-18,26,7,66,92
"31813","2300-2359",2022-12-19,25,1,65,90
"31814","2300-2359",2022-12-20,26,2,65,91
"31815","2300-2359",2022-12-21,26,3,65,91
"31816","2300-2359",2022-12-22,27,4,67,94
"31817","2300-2359",2022-12-23,25,5,67,92
"31818","2300-2359",2022-12-24,18,6,34,52
"31819","2300-2359",2022-12-25,22,7,44,66
"31820","2300-2359",2022-12-26,26,1,67,93
"31821","2300-2359",2022-12-27,25,2,67,92
"31822","2300-2359",2022-12-28,26,3,64,90
"31823","2300-2359",2022-12-29,25,4,65,90
"31824","2300-2359",2022-12-30,25,5,65,90
"31825","2300-2359",2022-12-31,18,6,36,54
"31826","0001-0559",2023-01-01,22,7,42,64
"31827","0001-0559",2023-01-02,23,1,49,72
"31828","0001-0559",2023-01-03,28,2,39,67
"31829","0001-0559",2023-01-04,30,3,40,70
"31830","0001-0559",2023-01-05,29,4,45,74
"31831","0001-0559",2023-01-06,29,5,44,73
"31832","0001-0559",2023-01-07,23,6,32,55
"31833","0001-0559",2023-01-08,19,7,44,63
"31834","0001-0559",2023-01-09,29,1,41,70
"31835","0001-0559",2023-01-10,27,2,38,65
"31836","0001-0559",2023-01-11,27,3,39,66
"31837","0001-0559",2023-01-12,29,4,45,74
"31838","0001-0559",2023-01-13,30,5,44,74
"31839","0001-0559",2023-01-14,23,6,29,52
"31840","0001-0559",2023-01-15,21,7,40,61
"31841","0001-0559",2023-01-16,30,1,43,73
"31842","0001-0559",2023-01-17,27,2,37,64
"31843","0001-0559",2023-01-18,27,3,40,67
"31844","0001-0559",2023-01-19,29,4,46,75
"31845","0001-0559",2023-01-20,30,5,44,74
"31846","0001-0559",2023-01-21,23,6,30,53
"31847","0001-0559",2023-01-22,21,7,46,67
"31848","0001-0559",2023-01-23,30,1,42,72
"31849","0001-0559",2023-01-24,27,2,37,64
"31850","0001-0559",2023-01-25,27,3,40,67
"31851","0001-0559",2023-01-26,29,4,46,75
"31852","0001-0559",2023-01-27,30,5,44,74
"31853","0001-0559",2023-01-28,23,6,30,53
"31854","0001-0559",2023-01-29,21,7,46,67
"31855","0001-0559",2023-01-30,30,1,42,72
"31856","0001-0559",2023-01-31,27,2,37,64
"31857","0600-0659",2023-01-01,54,7,26,80
"31858","0600-0659",2023-01-02,78,1,27,105
"31859","0600-0659",2023-01-03,70,2,29,99
"31860","0600-0659",2023-01-04,62,3,30,92
"31861","0600-0659",2023-01-05,64,4,26,90
"31862","0600-0659",2023-01-06,69,5,26,95
"31863","0600-0659",2023-01-07,68,6,26,94
"31864","0600-0659",2023-01-08,65,7,21,86
"31865","0600-0659",2023-01-09,69,1,26,95
"31866","0600-0659",2023-01-10,65,2,21,86
"31867","0600-0659",2023-01-11,64,3,22,86
"31868","0600-0659",2023-01-12,65,4,24,89
"31869","0600-0659",2023-01-13,68,5,25,93
"31870","0600-0659",2023-01-14,65,6,21,86
"31871","0600-0659",2023-01-15,56,7,22,78
"31872","0600-0659",2023-01-16,68,1,25,93
"31873","0600-0659",2023-01-17,65,2,20,85
"31874","0600-0659",2023-01-18,64,3,21,85
"31875","0600-0659",2023-01-19,65,4,23,88
"31876","0600-0659",2023-01-20,68,5,24,92
"31877","0600-0659",2023-01-21,65,6,22,87
"31878","0600-0659",2023-01-22,60,7,22,82
"31879","0600-0659",2023-01-23,68,1,24,92
"31880","0600-0659",2023-01-24,65,2,20,85
"31881","0600-0659",2023-01-25,64,3,21,85
"31882","0600-0659",2023-01-26,65,4,23,88
"31883","0600-0659",2023-01-27,68,5,24,92
"31884","0600-0659",2023-01-28,65,6,22,87
"31885","0600-0659",2023-01-29,60,7,22,82
"31886","0600-0659",2023-01-30,68,1,24,92
"31887","0600-0659",2023-01-31,65,2,20,85
"31888","0700-0759",2023-01-01,67,7,44,111
"31889","0700-0759",2023-01-02,76,1,48,124
"31890","0700-0759",2023-01-03,79,2,50,129
"31891","0700-0759",2023-01-04,82,3,44,126
"31892","0700-0759",2023-01-05,73,4,48,121
"31893","0700-0759",2023-01-06,74,5,50,124
"31894","0700-0759",2023-01-07,70,6,42,112
"31895","0700-0759",2023-01-08,77,7,39,116
"31896","0700-0759",2023-01-09,68,1,51,119
"31897","0700-0759",2023-01-10,71,2,49,120
"31898","0700-0759",2023-01-11,67,3,49,116
"31899","0700-0759",2023-01-12,72,4,53,125
"31900","0700-0759",2023-01-13,72,5,53,125
"31901","0700-0759",2023-01-14,68,6,44,112
"31902","0700-0759",2023-01-15,75,7,41,116
"31903","0700-0759",2023-01-16,70,1,52,122
"31904","0700-0759",2023-01-17,70,2,49,119
"31905","0700-0759",2023-01-18,66,3,50,116
"31906","0700-0759",2023-01-19,72,4,54,126
"31907","0700-0759",2023-01-20,72,5,54,126
"31908","0700-0759",2023-01-21,69,6,44,113
"31909","0700-0759",2023-01-22,76,7,45,121
"31910","0700-0759",2023-01-23,71,1,53,124
"31911","0700-0759",2023-01-24,70,2,49,119
"31912","0700-0759",2023-01-25,66,3,50,116
"31913","0700-0759",2023-01-26,72,4,54,126
"31914","0700-0759",2023-01-27,72,5,54,126
"31915","0700-0759",2023-01-28,69,6,44,113
"31916","0700-0759",2023-01-29,76,7,45,121
"31917","0700-0759",2023-01-30,71,1,53,124
"31918","0700-0759",2023-01-31,69,2,49,118
"31919","0800-0859",2023-01-01,76,7,29,105
"31920","0800-0859",2023-01-02,77,1,41,118
"31921","0800-0859",2023-01-03,79,2,36,115
"31922","0800-0859",2023-01-04,75,3,40,115
"31923","0800-0859",2023-01-05,81,4,40,121
"31924","0800-0859",2023-01-06,79,5,40,119
"31925","0800-0859",2023-01-07,67,6,39,106
"31926","0800-0859",2023-01-08,71,7,40,111
"31927","0800-0859",2023-01-09,86,1,39,125
"31928","0800-0859",2023-01-10,88,2,38,126
"31929","0800-0859",2023-01-11,87,3,37,124
"31930","0800-0859",2023-01-12,92,4,41,133
"31931","0800-0859",2023-01-13,91,5,42,133
"31932","0800-0859",2023-01-14,79,6,38,117
"31933","0800-0859",2023-01-15,78,7,37,115
"31934","0800-0859",2023-01-16,91,1,41,132
"31935","0800-0859",2023-01-17,87,2,39,126
"31936","0800-0859",2023-01-18,87,3,37,124
"31937","0800-0859",2023-01-19,91,4,41,132
"31938","0800-0859",2023-01-20,91,5,42,133
"31939","0800-0859",2023-01-21,79,6,38,117
"31940","0800-0859",2023-01-22,79,7,39,118
"31941","0800-0859",2023-01-23,90,1,42,132
"31942","0800-0859",2023-01-24,87,2,39,126
"31943","0800-0859",2023-01-25,87,3,37,124
"31944","0800-0859",2023-01-26,93,4,41,134
"31945","0800-0859",2023-01-27,91,5,42,133
"31946","0800-0859",2023-01-28,79,6,38,117
"31947","0800-0859",2023-01-29,79,7,39,118
"31948","0800-0859",2023-01-30,92,1,42,134
"31949","0800-0859",2023-01-31,88,2,39,127
"31950","0900-0959",2023-01-01,57,7,43,100
"31951","0900-0959",2023-01-02,62,1,48,110
"31952","0900-0959",2023-01-03,68,2,54,122
"31953","0900-0959",2023-01-04,66,3,57,123
"31954","0900-0959",2023-01-05,64,4,49,113
"31955","0900-0959",2023-01-06,64,5,53,117
"31956","0900-0959",2023-01-07,66,6,55,121
"31957","0900-0959",2023-01-08,63,7,47,110
"31958","0900-0959",2023-01-09,62,1,54,116
"31959","0900-0959",2023-01-10,58,2,54,112
"31960","0900-0959",2023-01-11,59,3,51,110
"31961","0900-0959",2023-01-12,60,4,51,111
"31962","0900-0959",2023-01-13,60,5,52,112
"31963","0900-0959",2023-01-14,62,6,50,112
"31964","0900-0959",2023-01-15,61,7,45,106
"31965","0900-0959",2023-01-16,60,1,52,112
"31966","0900-0959",2023-01-17,59,2,52,111
"31967","0900-0959",2023-01-18,59,3,51,110
"31968","0900-0959",2023-01-19,61,4,51,112
"31969","0900-0959",2023-01-20,60,5,53,113
"31970","0900-0959",2023-01-21,61,6,50,111
"31971","0900-0959",2023-01-22,62,7,46,108
"31972","0900-0959",2023-01-23,61,1,52,113
"31973","0900-0959",2023-01-24,59,2,51,110
"31974","0900-0959",2023-01-25,59,3,50,109
"31975","0900-0959",2023-01-26,61,4,52,113
"31976","0900-0959",2023-01-27,60,5,52,112
"31977","0900-0959",2023-01-28,62,6,50,112
"31978","0900-0959",2023-01-29,62,7,47,109
"31979","0900-0959",2023-01-30,60,1,52,112
"31980","0900-0959",2023-01-31,59,2,51,110
"31981","1000-1059",2023-01-01,61,7,48,109
"31982","1000-1059",2023-01-02,60,1,54,114
"31983","1000-1059",2023-01-03,65,2,53,118
"31984","1000-1059",2023-01-04,65,3,50,115
"31985","1000-1059",2023-01-05,61,4,47,108
"31986","1000-1059",2023-01-06,62,5,46,108
"31987","1000-1059",2023-01-07,56,6,34,90
"31988","1000-1059",2023-01-08,63,7,40,103
"31989","1000-1059",2023-01-09,62,1,42,104
"31990","1000-1059",2023-01-10,62,2,35,97
"31991","1000-1059",2023-01-11,60,3,34,94
"31992","1000-1059",2023-01-12,60,4,38,98
"31993","1000-1059",2023-01-13,62,5,39,101
"31994","1000-1059",2023-01-14,52,6,33,85
"31995","1000-1059",2023-01-15,54,7,31,85
"31996","1000-1059",2023-01-16,63,1,39,102
"31997","1000-1059",2023-01-17,60,2,34,94
"31998","1000-1059",2023-01-18,60,3,33,93
"31999","1000-1059",2023-01-19,59,4,37,96
"32000","1000-1059",2023-01-20,62,5,38,100
"32001","1000-1059",2023-01-21,51,6,33,84
"32002","1000-1059",2023-01-22,54,7,33,87
"32003","1000-1059",2023-01-23,63,1,39,102
"32004","1000-1059",2023-01-24,60,2,35,95
"32005","1000-1059",2023-01-25,60,3,34,94
"32006","1000-1059",2023-01-26,60,4,38,98
"32007","1000-1059",2023-01-27,62,5,39,101
"32008","1000-1059",2023-01-28,51,6,33,84
"32009","1000-1059",2023-01-29,54,7,32,86
"32010","1000-1059",2023-01-30,63,1,40,103
"32011","1000-1059",2023-01-31,60,2,35,95
"32012","1100-1159",2023-01-01,53,7,45,98
"32013","1100-1159",2023-01-02,50,1,57,107
"32014","1100-1159",2023-01-03,57,2,56,113
"32015","1100-1159",2023-01-04,53,3,49,102
"32016","1100-1159",2023-01-05,50,4,55,105
"32017","1100-1159",2023-01-06,49,5,56,105
"32018","1100-1159",2023-01-07,44,6,56,100
"32019","1100-1159",2023-01-08,53,7,59,112
"32020","1100-1159",2023-01-09,50,1,58,108
"32021","1100-1159",2023-01-10,48,2,55,103
"32022","1100-1159",2023-01-11,46,3,57,103
"32023","1100-1159",2023-01-12,48,4,61,109
"32024","1100-1159",2023-01-13,46,5,60,106
"32025","1100-1159",2023-01-14,41,6,58,99
"32026","1100-1159",2023-01-15,43,7,59,102
"32027","1100-1159",2023-01-16,45,1,60,105
"32028","1100-1159",2023-01-17,47,2,56,103
"32029","1100-1159",2023-01-18,46,3,57,103
"32030","1100-1159",2023-01-19,48,4,60,108
"32031","1100-1159",2023-01-20,47,5,60,107
"32032","1100-1159",2023-01-21,41,6,58,99
"32033","1100-1159",2023-01-22,43,7,60,103
"32034","1100-1159",2023-01-23,47,1,60,107
"32035","1100-1159",2023-01-24,47,2,56,103
"32036","1100-1159",2023-01-25,46,3,57,103
"32037","1100-1159",2023-01-26,48,4,61,109
"32038","1100-1159",2023-01-27,47,5,60,107
"32039","1100-1159",2023-01-28,41,6,58,99
"32040","1100-1159",2023-01-29,43,7,60,103
"32041","1100-1159",2023-01-30,47,1,60,107
"32042","1100-1159",2023-01-31,47,2,56,103
"32043","1200-1259",2023-01-01,54,7,51,105
"32044","1200-1259",2023-01-02,60,1,47,107
"32045","1200-1259",2023-01-03,55,2,55,110
"32046","1200-1259",2023-01-04,56,3,58,114
"32047","1200-1259",2023-01-05,53,4,54,107
"32048","1200-1259",2023-01-06,54,5,52,106
"32049","1200-1259",2023-01-07,54,6,51,105
"32050","1200-1259",2023-01-08,52,7,54,106
"32051","1200-1259",2023-01-09,52,1,57,109
"32052","1200-1259",2023-01-10,52,2,56,108
"32053","1200-1259",2023-01-11,51,3,54,105
"32054","1200-1259",2023-01-12,54,4,56,110
"32055","1200-1259",2023-01-13,53,5,54,107
"32056","1200-1259",2023-01-14,52,6,50,102
"32057","1200-1259",2023-01-15,51,7,52,103
"32058","1200-1259",2023-01-16,55,1,54,109
"32059","1200-1259",2023-01-17,50,2,56,106
"32060","1200-1259",2023-01-18,51,3,54,105
"32061","1200-1259",2023-01-19,54,4,56,110
"32062","1200-1259",2023-01-20,53,5,55,108
"32063","1200-1259",2023-01-21,52,6,50,102
"32064","1200-1259",2023-01-22,53,7,53,106
"32065","1200-1259",2023-01-23,54,1,55,109
"32066","1200-1259",2023-01-24,50,2,56,106
"32067","1200-1259",2023-01-25,51,3,54,105
"32068","1200-1259",2023-01-26,54,4,56,110
"32069","1200-1259",2023-01-27,53,5,55,108
"32070","1200-1259",2023-01-28,52,6,50,102
"32071","1200-1259",2023-01-29,53,7,53,106
"32072","1200-1259",2023-01-30,54,1,55,109
"32073","1200-1259",2023-01-31,50,2,56,106
"32074","1300-1359",2023-01-01,57,7,51,108
"32075","1300-1359",2023-01-02,51,1,56,107
"32076","1300-1359",2023-01-03,54,2,55,109
"32077","1300-1359",2023-01-04,46,3,53,99
"32078","1300-1359",2023-01-05,52,4,50,102
"32079","1300-1359",2023-01-06,51,5,53,104
"32080","1300-1359",2023-01-07,44,6,54,98
"32081","1300-1359",2023-01-08,43,7,52,95
"32082","1300-1359",2023-01-09,57,1,52,109
"32083","1300-1359",2023-01-10,54,2,53,107
"32084","1300-1359",2023-01-11,53,3,53,106
"32085","1300-1359",2023-01-12,60,4,52,112
"32086","1300-1359",2023-01-13,58,5,53,111
"32087","1300-1359",2023-01-14,44,6,49,93
"32088","1300-1359",2023-01-15,48,7,47,95
"32089","1300-1359",2023-01-16,58,1,53,111
"32090","1300-1359",2023-01-17,53,2,52,105
"32091","1300-1359",2023-01-18,53,3,53,106
"32092","1300-1359",2023-01-19,62,4,52,114
"32093","1300-1359",2023-01-20,60,5,53,113
"32094","1300-1359",2023-01-21,45,6,48,93
"32095","1300-1359",2023-01-22,55,7,48,103
"32096","1300-1359",2023-01-23,58,1,53,111
"32097","1300-1359",2023-01-24,53,2,52,105
"32098","1300-1359",2023-01-25,53,3,53,106
"32099","1300-1359",2023-01-26,62,4,52,114
"32100","1300-1359",2023-01-27,60,5,53,113
"32101","1300-1359",2023-01-28,45,6,48,93
"32102","1300-1359",2023-01-29,55,7,48,103
"32103","1300-1359",2023-01-30,58,1,53,111
"32104","1300-1359",2023-01-31,53,2,52,105
"32105","1400-1459",2023-01-01,45,7,58,103
"32106","1400-1459",2023-01-02,51,1,60,111
"32107","1400-1459",2023-01-03,56,2,60,116
"32108","1400-1459",2023-01-04,60,3,62,122
"32109","1400-1459",2023-01-05,52,4,62,114
"32110","1400-1459",2023-01-06,54,5,64,118
"32111","1400-1459",2023-01-07,56,6,53,109
"32112","1400-1459",2023-01-08,57,7,59,116
"32113","1400-1459",2023-01-09,58,1,59,117
"32114","1400-1459",2023-01-10,51,2,58,109
"32115","1400-1459",2023-01-11,51,3,58,109
"32116","1400-1459",2023-01-12,51,4,59,110
"32117","1400-1459",2023-01-13,52,5,61,113
"32118","1400-1459",2023-01-14,46,6,55,101
"32119","1400-1459",2023-01-15,48,7,58,106
"32120","1400-1459",2023-01-16,51,1,62,113
"32121","1400-1459",2023-01-17,50,2,58,108
"32122","1400-1459",2023-01-18,51,3,58,109
"32123","1400-1459",2023-01-19,49,4,61,110
"32124","1400-1459",2023-01-20,50,5,62,112
"32125","1400-1459",2023-01-21,46,6,55,101
"32126","1400-1459",2023-01-22,46,7,58,104
"32127","1400-1459",2023-01-23,51,1,62,113
"32128","1400-1459",2023-01-24,50,2,58,108
"32129","1400-1459",2023-01-25,51,3,58,109
"32130","1400-1459",2023-01-26,49,4,61,110
"32131","1400-1459",2023-01-27,50,5,62,112
"32132","1400-1459",2023-01-28,46,6,55,101
"32133","1400-1459",2023-01-29,46,7,58,104
"32134","1400-1459",2023-01-30,51,1,62,113
"32135","1400-1459",2023-01-31,50,2,58,108
"32136","1500-1559",2023-01-01,48,7,60,108
"32137","1500-1559",2023-01-02,56,1,57,113
"32138","1500-1559",2023-01-03,51,2,59,110
"32139","1500-1559",2023-01-04,46,3,58,104
"32140","1500-1559",2023-01-05,50,4,49,99
"32141","1500-1559",2023-01-06,48,5,47,95
"32142","1500-1559",2023-01-07,45,6,53,98
"32143","1500-1559",2023-01-08,53,7,52,105
"32144","1500-1559",2023-01-09,49,1,59,108
"32145","1500-1559",2023-01-10,52,2,59,111
"32146","1500-1559",2023-01-11,53,3,58,111
"32147","1500-1559",2023-01-12,55,4,62,117
"32148","1500-1559",2023-01-13,54,5,59,113
"32149","1500-1559",2023-01-14,43,6,59,102
"32150","1500-1559",2023-01-15,52,7,57,109
"32151","1500-1559",2023-01-16,56,1,59,115
"32152","1500-1559",2023-01-17,53,2,58,111
"32153","1500-1559",2023-01-18,54,3,56,110
"32154","1500-1559",2023-01-19,57,4,60,117
"32155","1500-1559",2023-01-20,57,5,58,115
"32156","1500-1559",2023-01-21,47,6,58,105
"32157","1500-1559",2023-01-22,60,7,58,118
"32158","1500-1559",2023-01-23,57,1,60,117
"32159","1500-1559",2023-01-24,53,2,58,111
"32160","1500-1559",2023-01-25,54,3,56,110
"32161","1500-1559",2023-01-26,57,4,60,117
"32162","1500-1559",2023-01-27,57,5,58,115
"32163","1500-1559",2023-01-28,47,6,58,105
"32164","1500-1559",2023-01-29,60,7,58,118
"32165","1500-1559",2023-01-30,56,1,60,116
"32166","1500-1559",2023-01-31,53,2,58,111
"32167","1600-1659",2023-01-01,66,7,49,115
"32168","1600-1659",2023-01-02,62,1,52,114
"32169","1600-1659",2023-01-03,66,2,51,117
"32170","1600-1659",2023-01-04,62,3,46,108
"32171","1600-1659",2023-01-05,62,4,51,113
"32172","1600-1659",2023-01-06,60,5,50,110
"32173","1600-1659",2023-01-07,67,6,45,112
"32174","1600-1659",2023-01-08,57,7,49,106
"32175","1600-1659",2023-01-09,61,1,52,113
"32176","1600-1659",2023-01-10,54,2,52,106
"32177","1600-1659",2023-01-11,50,3,51,101
"32178","1600-1659",2023-01-12,56,4,52,108
"32179","1600-1659",2023-01-13,55,5,52,107
"32180","1600-1659",2023-01-14,57,6,44,101
"32181","1600-1659",2023-01-15,52,7,47,99
"32182","1600-1659",2023-01-16,55,1,53,108
"32183","1600-1659",2023-01-17,52,2,53,105
"32184","1600-1659",2023-01-18,50,3,53,103
"32185","1600-1659",2023-01-19,56,4,53,109
"32186","1600-1659",2023-01-20,55,5,53,108
"32187","1600-1659",2023-01-21,59,6,44,103
"32188","1600-1659",2023-01-22,52,7,49,101
"32189","1600-1659",2023-01-23,55,1,53,108
"32190","1600-1659",2023-01-24,53,2,53,106
"32191","1600-1659",2023-01-25,50,3,53,103
"32192","1600-1659",2023-01-26,56,4,53,109
"32193","1600-1659",2023-01-27,55,5,53,108
"32194","1600-1659",2023-01-28,59,6,45,104
"32195","1600-1659",2023-01-29,52,7,49,101
"32196","1600-1659",2023-01-30,55,1,53,108
"32197","1600-1659",2023-01-31,53,2,53,106
"32198","1700-1759",2023-01-01,47,7,53,100
"32199","1700-1759",2023-01-02,51,1,59,110
"32200","1700-1759",2023-01-03,51,2,60,111
"32201","1700-1759",2023-01-04,47,3,57,104
"32202","1700-1759",2023-01-05,51,4,57,108
"32203","1700-1759",2023-01-06,50,5,54,104
"32204","1700-1759",2023-01-07,42,6,51,93
"32205","1700-1759",2023-01-08,55,7,49,104
"32206","1700-1759",2023-01-09,64,1,47,111
"32207","1700-1759",2023-01-10,72,2,46,118
"32208","1700-1759",2023-01-11,73,3,45,118
"32209","1700-1759",2023-01-12,70,4,52,122
"32210","1700-1759",2023-01-13,70,5,50,120
"32211","1700-1759",2023-01-14,52,6,46,98
"32212","1700-1759",2023-01-15,66,7,42,108
"32213","1700-1759",2023-01-16,70,1,50,120
"32214","1700-1759",2023-01-17,74,2,46,120
"32215","1700-1759",2023-01-18,73,3,46,119
"32216","1700-1759",2023-01-19,69,4,54,123
"32217","1700-1759",2023-01-20,69,5,52,121
"32218","1700-1759",2023-01-21,58,6,43,101
"32219","1700-1759",2023-01-22,69,7,48,117
"32220","1700-1759",2023-01-23,70,1,50,120
"32221","1700-1759",2023-01-24,73,2,46,119
"32222","1700-1759",2023-01-25,73,3,46,119
"32223","1700-1759",2023-01-26,69,4,54,123
"32224","1700-1759",2023-01-27,69,5,52,121
"32225","1700-1759",2023-01-28,58,6,43,101
"32226","1700-1759",2023-01-29,69,7,48,117
"32227","1700-1759",2023-01-30,70,1,49,119
"32228","1700-1759",2023-01-31,73,2,46,119
"32229","1800-1859",2023-01-01,51,7,59,110
"32230","1800-1859",2023-01-02,60,1,65,125
"32231","1800-1859",2023-01-03,65,2,71,136
"32232","1800-1859",2023-01-04,60,3,62,122
"32233","1800-1859",2023-01-05,67,4,70,137
"32234","1800-1859",2023-01-06,63,5,69,132
"32235","1800-1859",2023-01-07,56,6,66,122
"32236","1800-1859",2023-01-08,62,7,73,135
"32237","1800-1859",2023-01-09,54,1,77,131
"32238","1800-1859",2023-01-10,40,2,75,115
"32239","1800-1859",2023-01-11,38,3,75,113
"32240","1800-1859",2023-01-12,51,4,78,129
"32241","1800-1859",2023-01-13,48,5,78,126
"32242","1800-1859",2023-01-14,35,6,64,99
"32243","1800-1859",2023-01-15,46,7,72,118
"32244","1800-1859",2023-01-16,47,1,77,124
"32245","1800-1859",2023-01-17,39,2,75,114
"32246","1800-1859",2023-01-18,38,3,75,113
"32247","1800-1859",2023-01-19,52,4,77,129
"32248","1800-1859",2023-01-20,49,5,77,126
"32249","1800-1859",2023-01-21,39,6,69,108
"32250","1800-1859",2023-01-22,48,7,76,124
"32251","1800-1859",2023-01-23,47,1,77,124
"32252","1800-1859",2023-01-24,39,2,75,114
"32253","1800-1859",2023-01-25,38,3,75,113
"32254","1800-1859",2023-01-26,52,4,77,129
"32255","1800-1859",2023-01-27,49,5,77,126
"32256","1800-1859",2023-01-28,39,6,69,108
"32257","1800-1859",2023-01-29,49,7,76,125
"32258","1800-1859",2023-01-30,47,1,77,124
"32259","1800-1859",2023-01-31,39,2,75,114
"32260","1900-1959",2023-01-01,58,7,50,108
"32261","1900-1959",2023-01-02,74,1,46,120
"32262","1900-1959",2023-01-03,67,2,48,115
"32263","1900-1959",2023-01-04,69,3,54,123
"32264","1900-1959",2023-01-05,69,4,50,119
"32265","1900-1959",2023-01-06,70,5,49,119
"32266","1900-1959",2023-01-07,61,6,48,109
"32267","1900-1959",2023-01-08,64,7,49,113
"32268","1900-1959",2023-01-09,76,1,52,128
"32269","1900-1959",2023-01-10,70,2,51,121
"32270","1900-1959",2023-01-11,72,3,46,118
"32271","1900-1959",2023-01-12,78,4,49,127
"32272","1900-1959",2023-01-13,77,5,48,125
"32273","1900-1959",2023-01-14,47,6,43,90
"32274","1900-1959",2023-01-15,60,7,47,107
"32275","1900-1959",2023-01-16,76,1,49,125
"32276","1900-1959",2023-01-17,70,2,46,116
"32277","1900-1959",2023-01-18,73,3,46,119
"32278","1900-1959",2023-01-19,79,4,50,129
"32279","1900-1959",2023-01-20,79,5,49,128
"32280","1900-1959",2023-01-21,56,6,46,102
"32281","1900-1959",2023-01-22,74,7,45,119
"32282","1900-1959",2023-01-23,77,1,49,126
"32283","1900-1959",2023-01-24,70,2,46,116
"32284","1900-1959",2023-01-25,73,3,46,119
"32285","1900-1959",2023-01-26,79,4,50,129
"32286","1900-1959",2023-01-27,79,5,49,128
"32287","1900-1959",2023-01-28,56,6,46,102
"32288","1900-1959",2023-01-29,74,7,45,119
"32289","1900-1959",2023-01-30,77,1,49,126
"32290","1900-1959",2023-01-31,70,2,46,116
"32291","2000-2059",2023-01-01,40,7,72,112
"32292","2000-2059",2023-01-02,39,1,70,109
"32293","2000-2059",2023-01-03,41,2,73,114
"32294","2000-2059",2023-01-04,36,3,69,105
"32295","2000-2059",2023-01-05,35,4,75,110
"32296","2000-2059",2023-01-06,36,5,72,108
"32297","2000-2059",2023-01-07,31,6,68,99
"32298","2000-2059",2023-01-08,35,7,80,115
"32299","2000-2059",2023-01-09,38,1,80,118
"32300","2000-2059",2023-01-10,30,2,73,103
"32301","2000-2059",2023-01-11,31,3,71,102
"32302","2000-2059",2023-01-12,35,4,78,113
"32303","2000-2059",2023-01-13,37,5,75,112
"32304","2000-2059",2023-01-14,21,6,57,78
"32305","2000-2059",2023-01-15,26,7,76,102
"32306","2000-2059",2023-01-16,37,1,77,114
"32307","2000-2059",2023-01-17,29,2,73,102
"32308","2000-2059",2023-01-18,31,3,71,102
"32309","2000-2059",2023-01-19,35,4,78,113
"32310","2000-2059",2023-01-20,36,5,76,112
"32311","2000-2059",2023-01-21,22,6,65,87
"32312","2000-2059",2023-01-22,29,7,80,109
"32313","2000-2059",2023-01-23,35,1,78,113
"32314","2000-2059",2023-01-24,29,2,73,102
"32315","2000-2059",2023-01-25,31,3,71,102
"32316","2000-2059",2023-01-26,35,4,78,113
"32317","2000-2059",2023-01-27,36,5,76,112
"32318","2000-2059",2023-01-28,23,6,65,88
"32319","2000-2059",2023-01-29,29,7,80,109
"32320","2000-2059",2023-01-30,35,1,79,114
"32321","2000-2059",2023-01-31,29,2,74,103
"32322","2100-2159",2023-01-01,36,7,64,100
"32323","2100-2159",2023-01-02,45,1,73,118
"32324","2100-2159",2023-01-03,44,2,74,118
"32325","2100-2159",2023-01-04,46,3,66,112
"32326","2100-2159",2023-01-05,41,4,68,109
"32327","2100-2159",2023-01-06,40,5,70,110
"32328","2100-2159",2023-01-07,25,6,64,89
"32329","2100-2159",2023-01-08,41,7,66,107
"32330","2100-2159",2023-01-09,41,1,69,110
"32331","2100-2159",2023-01-10,37,2,66,103
"32332","2100-2159",2023-01-11,34,3,67,101
"32333","2100-2159",2023-01-12,43,4,69,112
"32334","2100-2159",2023-01-13,43,5,72,115
"32335","2100-2159",2023-01-14,20,6,49,69
"32336","2100-2159",2023-01-15,39,7,62,101
"32337","2100-2159",2023-01-16,43,1,69,112
"32338","2100-2159",2023-01-17,35,2,66,101
"32339","2100-2159",2023-01-18,35,3,67,102
"32340","2100-2159",2023-01-19,44,4,69,113
"32341","2100-2159",2023-01-20,43,5,71,114
"32342","2100-2159",2023-01-21,24,6,57,81
"32343","2100-2159",2023-01-22,46,7,66,112
"32344","2100-2159",2023-01-23,43,1,68,111
"32345","2100-2159",2023-01-24,35,2,66,101
"32346","2100-2159",2023-01-25,35,3,67,102
"32347","2100-2159",2023-01-26,44,4,69,113
"32348","2100-2159",2023-01-27,43,5,71,114
"32349","2100-2159",2023-01-28,24,6,57,81
"32350","2100-2159",2023-01-29,46,7,66,112
"32351","2100-2159",2023-01-30,43,1,67,110
"32352","2100-2159",2023-01-31,35,2,65,100
"32353","2200-2259",2023-01-01,40,7,60,100
"32354","2200-2259",2023-01-02,49,1,73,122
"32355","2200-2259",2023-01-03,40,2,70,110
"32356","2200-2259",2023-01-04,38,3,64,102
"32357","2200-2259",2023-01-05,43,4,62,105
"32358","2200-2259",2023-01-06,43,5,64,107
"32359","2200-2259",2023-01-07,35,6,53,88
"32360","2200-2259",2023-01-08,46,7,62,108
"32361","2200-2259",2023-01-09,36,1,67,103
"32362","2200-2259",2023-01-10,31,2,55,86
"32363","2200-2259",2023-01-11,32,3,55,87
"32364","2200-2259",2023-01-12,38,4,64,102
"32365","2200-2259",2023-01-13,37,5,63,100
"32366","2200-2259",2023-01-14,29,6,40,69
"32367","2200-2259",2023-01-15,39,7,51,90
"32368","2200-2259",2023-01-16,33,1,62,95
"32369","2200-2259",2023-01-17,31,2,55,86
"32370","2200-2259",2023-01-18,32,3,56,88
"32371","2200-2259",2023-01-19,38,4,65,103
"32372","2200-2259",2023-01-20,37,5,64,101
"32373","2200-2259",2023-01-21,31,6,48,79
"32374","2200-2259",2023-01-22,42,7,62,104
"32375","2200-2259",2023-01-23,33,1,62,95
"32376","2200-2259",2023-01-24,31,2,55,86
"32377","2200-2259",2023-01-25,32,3,56,88
"32378","2200-2259",2023-01-26,38,4,65,103
"32379","2200-2259",2023-01-27,37,5,64,101
"32380","2200-2259",2023-01-28,31,6,49,80
"32381","2200-2259",2023-01-29,42,7,62,104
"32382","2200-2259",2023-01-30,33,1,62,95
"32383","2200-2259",2023-01-31,31,2,55,86
"32384","2300-2359",2023-01-01,24,7,52,76
"32385","2300-2359",2023-01-02,24,1,66,90
"32386","2300-2359",2023-01-03,22,2,65,87
"32387","2300-2359",2023-01-04,22,3,62,84
"32388","2300-2359",2023-01-05,24,4,63,87
"32389","2300-2359",2023-01-06,25,5,61,86
"32390","2300-2359",2023-01-07,25,6,45,70
"32391","2300-2359",2023-01-08,24,7,65,89
"32392","2300-2359",2023-01-09,27,1,57,84
"32393","2300-2359",2023-01-10,22,2,50,72
"32394","2300-2359",2023-01-11,23,3,49,72
"32395","2300-2359",2023-01-12,26,4,59,85
"32396","2300-2359",2023-01-13,26,5,59,85
"32397","2300-2359",2023-01-14,21,6,28,49
"32398","2300-2359",2023-01-15,24,7,53,77
"32399","2300-2359",2023-01-16,26,1,57,83
"32400","2300-2359",2023-01-17,22,2,48,70
"32401","2300-2359",2023-01-18,23,3,49,72
"32402","2300-2359",2023-01-19,26,4,59,85
"32403","2300-2359",2023-01-20,26,5,59,85
"32404","2300-2359",2023-01-21,22,6,32,54
"32405","2300-2359",2023-01-22,26,7,61,87
"32406","2300-2359",2023-01-23,26,1,57,83
"32407","2300-2359",2023-01-24,22,2,48,70
"32408","2300-2359",2023-01-25,23,3,49,72
"32409","2300-2359",2023-01-26,26,4,59,85
"32410","2300-2359",2023-01-27,26,5,59,85
"32411","2300-2359",2023-01-28,22,6,32,54
"32412","2300-2359",2023-01-29,26,7,62,88
"32413","2300-2359",2023-01-30,26,1,57,83
"32414","2300-2359",2023-01-31,22,2,48,70
"32415","0001-0559",2023-02-01,27,3,40,67
"32416","0001-0559",2023-02-02,29,4,47,76
"32417","0001-0559",2023-02-03,30,5,46,76
"32418","0001-0559",2023-02-04,23,6,30,53
"32419","0001-0559",2023-02-05,22,7,46,68
"32420","0001-0559",2023-02-06,31,1,44,75
"32421","0001-0559",2023-02-07,29,2,40,69
"32422","0001-0559",2023-02-08,28,3,40,68
"32423","0001-0559",2023-02-09,29,4,48,77
"32424","0001-0559",2023-02-10,30,5,46,76
"32425","0001-0559",2023-02-11,21,6,30,51
"32426","0001-0559",2023-02-12,19,7,38,57
"32427","0001-0559",2023-02-13,28,1,40,68
"32428","0001-0559",2023-02-14,28,2,38,66
"32429","0001-0559",2023-02-15,26,3,40,66
"32430","0001-0559",2023-02-16,29,4,47,76
"32431","0001-0559",2023-02-17,30,5,46,76
"32432","0001-0559",2023-02-18,20,6,31,51
"32433","0001-0559",2023-02-19,20,7,39,59
"32434","0001-0559",2023-02-20,30,1,39,69
"32435","0001-0559",2023-02-21,29,2,36,65
"32436","0001-0559",2023-02-22,28,3,39,67
"32437","0001-0559",2023-02-23,30,4,47,77
"32438","0001-0559",2023-02-24,30,5,46,76
"32439","0001-0559",2023-02-25,20,6,32,52
"32440","0001-0559",2023-02-26,20,7,48,68
"32441","0001-0559",2023-02-27,30,1,39,69
"32442","0001-0559",2023-02-28,29,2,36,65
"32443","0600-0659",2023-02-01,64,3,21,85
"32444","0600-0659",2023-02-02,66,4,24,90
"32445","0600-0659",2023-02-03,68,5,27,95
"32446","0600-0659",2023-02-04,66,6,26,92
"32447","0600-0659",2023-02-05,60,7,27,87
"32448","0600-0659",2023-02-06,68,1,27,95
"32449","0600-0659",2023-02-07,65,2,25,90
"32450","0600-0659",2023-02-08,66,3,25,91
"32451","0600-0659",2023-02-09,69,4,25,94
"32452","0600-0659",2023-02-10,72,5,26,98
"32453","0600-0659",2023-02-11,72,6,26,98
"32454","0600-0659",2023-02-12,66,7,24,90
"32455","0600-0659",2023-02-13,75,1,27,102
"32456","0600-0659",2023-02-14,68,2,25,93
"32457","0600-0659",2023-02-15,68,3,26,94
"32458","0600-0659",2023-02-16,69,4,28,97
"32459","0600-0659",2023-02-17,74,5,26,100
"32460","0600-0659",2023-02-18,70,6,28,98
"32461","0600-0659",2023-02-19,68,7,26,94
"32462","0600-0659",2023-02-20,74,1,29,103
"32463","0600-0659",2023-02-21,70,2,26,96
"32464","0600-0659",2023-02-22,68,3,27,95
"32465","0600-0659",2023-02-23,71,4,30,101
"32466","0600-0659",2023-02-24,74,5,28,102
"32467","0600-0659",2023-02-25,70,6,28,98
"32468","0600-0659",2023-02-26,68,7,28,96
"32469","0600-0659",2023-02-27,72,1,29,101
"32470","0600-0659",2023-02-28,69,2,26,95
"32471","0700-0759",2023-02-01,65,3,50,115
"32472","0700-0759",2023-02-02,71,4,53,124
"32473","0700-0759",2023-02-03,72,5,52,124
"32474","0700-0759",2023-02-04,70,6,42,112
"32475","0700-0759",2023-02-05,75,7,43,118
"32476","0700-0759",2023-02-06,70,1,52,122
"32477","0700-0759",2023-02-07,70,2,48,118
"32478","0700-0759",2023-02-08,65,3,48,113
"32479","0700-0759",2023-02-09,66,4,52,118
"32480","0700-0759",2023-02-10,69,5,51,120
"32481","0700-0759",2023-02-11,70,6,43,113
"32482","0700-0759",2023-02-12,74,7,41,115
"32483","0700-0759",2023-02-13,65,1,51,116
"32484","0700-0759",2023-02-14,70,2,48,118
"32485","0700-0759",2023-02-15,66,3,48,114
"32486","0700-0759",2023-02-16,70,4,50,120
"32487","0700-0759",2023-02-17,68,5,53,121
"32488","0700-0759",2023-02-18,71,6,39,110
"32489","0700-0759",2023-02-19,75,7,39,114
"32490","0700-0759",2023-02-20,69,1,53,122
"32491","0700-0759",2023-02-21,68,2,48,116
"32492","0700-0759",2023-02-22,65,3,47,112
"32493","0700-0759",2023-02-23,71,4,50,121
"32494","0700-0759",2023-02-24,70,5,52,122
"32495","0700-0759",2023-02-25,71,6,39,110
"32496","0700-0759",2023-02-26,75,7,41,116
"32497","0700-0759",2023-02-27,70,1,52,122
"32498","0700-0759",2023-02-28,68,2,47,115
"32499","0800-0859",2023-02-01,88,3,37,125
"32500","0800-0859",2023-02-02,93,4,42,135
"32501","0800-0859",2023-02-03,90,5,41,131
"32502","0800-0859",2023-02-04,77,6,37,114
"32503","0800-0859",2023-02-05,80,7,38,118
"32504","0800-0859",2023-02-06,92,1,39,131
"32505","0800-0859",2023-02-07,88,2,37,125
"32506","0800-0859",2023-02-08,88,3,36,124
"32507","0800-0859",2023-02-09,90,4,39,129
"32508","0800-0859",2023-02-10,92,5,41,133
"32509","0800-0859",2023-02-11,78,6,38,116
"32510","0800-0859",2023-02-12,76,7,38,114
"32511","0800-0859",2023-02-13,92,1,41,133
"32512","0800-0859",2023-02-14,88,2,38,126
"32513","0800-0859",2023-02-15,90,3,38,128
"32514","0800-0859",2023-02-16,95,4,41,136
"32515","0800-0859",2023-02-17,96,5,42,138
"32516","0800-0859",2023-02-18,81,6,41,122
"32517","0800-0859",2023-02-19,81,7,39,120
"32518","0800-0859",2023-02-20,95,1,41,136
"32519","0800-0859",2023-02-21,91,2,39,130
"32520","0800-0859",2023-02-22,93,3,39,132
"32521","0800-0859",2023-02-23,95,4,42,137
"32522","0800-0859",2023-02-24,94,5,42,136
"32523","0800-0859",2023-02-25,81,6,41,122
"32524","0800-0859",2023-02-26,83,7,40,123
"32525","0800-0859",2023-02-27,95,1,41,136
"32526","0800-0859",2023-02-28,92,2,39,131
"32527","0900-0959",2023-02-01,61,3,50,111
"32528","0900-0959",2023-02-02,61,4,51,112
"32529","0900-0959",2023-02-03,61,5,53,114
"32530","0900-0959",2023-02-04,63,6,51,114
"32531","0900-0959",2023-02-05,62,7,47,109
"32532","0900-0959",2023-02-06,61,1,54,115
"32533","0900-0959",2023-02-07,62,2,53,115
"32534","0900-0959",2023-02-08,64,3,52,116
"32535","0900-0959",2023-02-09,63,4,51,114
"32536","0900-0959",2023-02-10,59,5,56,115
"32537","0900-0959",2023-02-11,60,6,54,114
"32538","0900-0959",2023-02-12,63,7,49,112
"32539","0900-0959",2023-02-13,58,1,55,113
"32540","0900-0959",2023-02-14,61,2,55,116
"32541","0900-0959",2023-02-15,62,3,53,115
"32542","0900-0959",2023-02-16,62,4,57,119
"32543","0900-0959",2023-02-17,63,5,59,122
"32544","0900-0959",2023-02-18,63,6,54,117
"32545","0900-0959",2023-02-19,63,7,53,116
"32546","0900-0959",2023-02-20,62,1,59,121
"32547","0900-0959",2023-02-21,62,2,56,118
"32548","0900-0959",2023-02-22,61,3,56,117
"32549","0900-0959",2023-02-23,62,4,59,121
"32550","0900-0959",2023-02-24,63,5,59,122
"32551","0900-0959",2023-02-25,62,6,54,116
"32552","0900-0959",2023-02-26,61,7,52,113
"32553","0900-0959",2023-02-27,63,1,60,123
"32554","0900-0959",2023-02-28,60,2,58,118
"32555","1000-1059",2023-02-01,60,3,34,94
"32556","1000-1059",2023-02-02,60,4,38,98
"32557","1000-1059",2023-02-03,62,5,42,104
"32558","1000-1059",2023-02-04,52,6,37,89
"32559","1000-1059",2023-02-05,54,7,37,91
"32560","1000-1059",2023-02-06,61,1,43,104
"32561","1000-1059",2023-02-07,58,2,40,98
"32562","1000-1059",2023-02-08,55,3,38,93
"32563","1000-1059",2023-02-09,55,4,41,96
"32564","1000-1059",2023-02-10,57,5,43,100
"32565","1000-1059",2023-02-11,49,6,35,84
"32566","1000-1059",2023-02-12,50,7,33,83
"32567","1000-1059",2023-02-13,55,1,41,96
"32568","1000-1059",2023-02-14,56,2,39,95
"32569","1000-1059",2023-02-15,55,3,38,93
"32570","1000-1059",2023-02-16,61,4,40,101
"32571","1000-1059",2023-02-17,61,5,43,104
"32572","1000-1059",2023-02-18,50,6,35,85
"32573","1000-1059",2023-02-19,55,7,34,89
"32574","1000-1059",2023-02-20,61,1,42,103
"32575","1000-1059",2023-02-21,56,2,39,95
"32576","1000-1059",2023-02-22,53,3,37,90
"32577","1000-1059",2023-02-23,60,4,39,99
"32578","1000-1059",2023-02-24,61,5,42,103
"32579","1000-1059",2023-02-25,50,6,35,85
"32580","1000-1059",2023-02-26,56,7,35,91
"32581","1000-1059",2023-02-27,62,1,41,103
"32582","1000-1059",2023-02-28,57,2,38,95
"32583","1100-1159",2023-02-01,48,3,59,107
"32584","1100-1159",2023-02-02,48,4,61,109
"32585","1100-1159",2023-02-03,49,5,57,106
"32586","1100-1159",2023-02-04,42,6,54,96
"32587","1100-1159",2023-02-05,46,7,57,103
"32588","1100-1159",2023-02-06,51,1,58,109
"32589","1100-1159",2023-02-07,53,2,55,108
"32590","1100-1159",2023-02-08,51,3,53,104
"32591","1100-1159",2023-02-09,51,4,54,105
"32592","1100-1159",2023-02-10,54,5,54,108
"32593","1100-1159",2023-02-11,45,6,49,94
"32594","1100-1159",2023-02-12,50,7,56,106
"32595","1100-1159",2023-02-13,52,1,55,107
"32596","1100-1159",2023-02-14,54,2,52,106
"32597","1100-1159",2023-02-15,53,3,53,106
"32598","1100-1159",2023-02-16,51,4,55,106
"32599","1100-1159",2023-02-17,51,5,55,106
"32600","1100-1159",2023-02-18,49,6,50,99
"32601","1100-1159",2023-02-19,47,7,56,103
"32602","1100-1159",2023-02-20,50,1,54,104
"32603","1100-1159",2023-02-21,52,2,53,105
"32604","1100-1159",2023-02-22,52,3,52,104
"32605","1100-1159",2023-02-23,51,4,56,107
"32606","1100-1159",2023-02-24,51,5,56,107
"32607","1100-1159",2023-02-25,49,6,51,100
"32608","1100-1159",2023-02-26,45,7,56,101
"32609","1100-1159",2023-02-27,51,1,57,108
"32610","1100-1159",2023-02-28,52,2,53,105
"32611","1200-1259",2023-02-01,52,3,55,107
"32612","1200-1259",2023-02-02,54,4,56,110
"32613","1200-1259",2023-02-03,50,5,56,106
"32614","1200-1259",2023-02-04,48,6,52,100
"32615","1200-1259",2023-02-05,49,7,54,103
"32616","1200-1259",2023-02-06,51,1,57,108
"32617","1200-1259",2023-02-07,47,2,59,106
"32618","1200-1259",2023-02-08,48,3,59,107
"32619","1200-1259",2023-02-09,50,4,58,108
"32620","1200-1259",2023-02-10,49,5,55,104
"32621","1200-1259",2023-02-11,48,6,56,104
"32622","1200-1259",2023-02-12,51,7,53,104
"32623","1200-1259",2023-02-13,53,1,55,108
"32624","1200-1259",2023-02-14,50,2,56,106
"32625","1200-1259",2023-02-15,52,3,57,109
"32626","1200-1259",2023-02-16,50,4,58,108
"32627","1200-1259",2023-02-17,50,5,57,107
"32628","1200-1259",2023-02-18,46,6,58,104
"32629","1200-1259",2023-02-19,49,7,56,105
"32630","1200-1259",2023-02-20,52,1,59,111
"32631","1200-1259",2023-02-21,52,2,57,109
"32632","1200-1259",2023-02-22,52,3,55,107
"32633","1200-1259",2023-02-23,51,4,56,107
"32634","1200-1259",2023-02-24,51,5,56,107
"32635","1200-1259",2023-02-25,46,6,56,102
"32636","1200-1259",2023-02-26,50,7,57,107
"32637","1200-1259",2023-02-27,52,1,56,108
"32638","1200-1259",2023-02-28,52,2,57,109
"32639","1300-1359",2023-02-01,53,3,54,107
"32640","1300-1359",2023-02-02,62,4,52,114
"32641","1300-1359",2023-02-03,60,5,49,109
"32642","1300-1359",2023-02-04,45,6,43,88
"32643","1300-1359",2023-02-05,55,7,44,99
"32644","1300-1359",2023-02-06,59,1,48,107
"32645","1300-1359",2023-02-07,54,2,48,102
"32646","1300-1359",2023-02-08,56,3,50,106
"32647","1300-1359",2023-02-09,62,4,47,109
"32648","1300-1359",2023-02-10,55,5,50,105
"32649","1300-1359",2023-02-11,44,6,44,88
"32650","1300-1359",2023-02-12,50,7,46,96
"32651","1300-1359",2023-02-13,53,1,49,102
"32652","1300-1359",2023-02-14,52,2,53,105
"32653","1300-1359",2023-02-15,53,3,53,106
"32654","1300-1359",2023-02-16,58,4,50,108
"32655","1300-1359",2023-02-17,56,5,50,106
"32656","1300-1359",2023-02-18,43,6,43,86
"32657","1300-1359",2023-02-19,50,7,48,98
"32658","1300-1359",2023-02-20,59,1,49,108
"32659","1300-1359",2023-02-21,52,2,52,104
"32660","1300-1359",2023-02-22,53,3,54,107
"32661","1300-1359",2023-02-23,57,4,52,109
"32662","1300-1359",2023-02-24,57,5,52,109
"32663","1300-1359",2023-02-25,43,6,43,86
"32664","1300-1359",2023-02-26,54,7,48,102
"32665","1300-1359",2023-02-27,57,1,51,108
"32666","1300-1359",2023-02-28,52,2,51,103
"32667","1400-1459",2023-02-01,53,3,58,111
"32668","1400-1459",2023-02-02,49,4,61,110
"32669","1400-1459",2023-02-03,48,5,63,111
"32670","1400-1459",2023-02-04,43,6,58,101
"32671","1400-1459",2023-02-05,44,7,59,103
"32672","1400-1459",2023-02-06,50,1,63,113
"32673","1400-1459",2023-02-07,51,2,59,110
"32674","1400-1459",2023-02-08,51,3,60,111
"32675","1400-1459",2023-02-09,49,4,63,112
"32676","1400-1459",2023-02-10,49,5,61,110
"32677","1400-1459",2023-02-11,42,6,59,101
"32678","1400-1459",2023-02-12,45,7,59,104
"32679","1400-1459",2023-02-13,51,1,60,111
"32680","1400-1459",2023-02-14,49,2,59,108
"32681","1400-1459",2023-02-15,51,3,59,110
"32682","1400-1459",2023-02-16,50,4,63,113
"32683","1400-1459",2023-02-17,49,5,62,111
"32684","1400-1459",2023-02-18,44,6,58,102
"32685","1400-1459",2023-02-19,45,7,57,102
"32686","1400-1459",2023-02-20,47,1,60,107
"32687","1400-1459",2023-02-21,49,2,58,107
"32688","1400-1459",2023-02-22,50,3,58,108
"32689","1400-1459",2023-02-23,51,4,62,113
"32690","1400-1459",2023-02-24,49,5,62,111
"32691","1400-1459",2023-02-25,44,6,58,102
"32692","1400-1459",2023-02-26,48,7,56,104
"32693","1400-1459",2023-02-27,49,1,62,111
"32694","1400-1459",2023-02-28,49,2,58,107
"32695","1500-1559",2023-02-01,54,3,59,113
"32696","1500-1559",2023-02-02,57,4,60,117
"32697","1500-1559",2023-02-03,50,5,58,108
"32698","1500-1559",2023-02-04,44,6,57,101
"32699","1500-1559",2023-02-05,54,7,58,112
"32700","1500-1559",2023-02-06,49,1,59,108
"32701","1500-1559",2023-02-07,47,2,59,106
"32702","1500-1559",2023-02-08,48,3,58,106
"32703","1500-1559",2023-02-09,50,4,59,109
"32704","1500-1559",2023-02-10,48,5,58,106
"32705","1500-1559",2023-02-11,47,6,57,104
"32706","1500-1559",2023-02-12,50,7,60,110
"32707","1500-1559",2023-02-13,46,1,57,103
"32708","1500-1559",2023-02-14,49,2,58,107
"32709","1500-1559",2023-02-15,49,3,57,106
"32710","1500-1559",2023-02-16,54,4,56,110
"32711","1500-1559",2023-02-17,51,5,55,106
"32712","1500-1559",2023-02-18,49,6,58,107
"32713","1500-1559",2023-02-19,52,7,60,112
"32714","1500-1559",2023-02-20,53,1,59,112
"32715","1500-1559",2023-02-21,50,2,56,106
"32716","1500-1559",2023-02-22,49,3,52,101
"32717","1500-1559",2023-02-23,52,4,56,108
"32718","1500-1559",2023-02-24,52,5,55,107
"32719","1500-1559",2023-02-25,47,6,58,105
"32720","1500-1559",2023-02-26,53,7,61,114
"32721","1500-1559",2023-02-27,52,1,57,109
"32722","1500-1559",2023-02-28,47,2,56,103
"32723","1600-1659",2023-02-01,50,3,53,103
"32724","1600-1659",2023-02-02,56,4,53,109
"32725","1600-1659",2023-02-03,60,5,53,113
"32726","1600-1659",2023-02-04,62,6,44,106
"32727","1600-1659",2023-02-05,55,7,47,102
"32728","1600-1659",2023-02-06,61,1,55,116
"32729","1600-1659",2023-02-07,57,2,55,112
"32730","1600-1659",2023-02-08,55,3,54,109
"32731","1600-1659",2023-02-09,58,4,53,111
"32732","1600-1659",2023-02-10,63,5,53,116
"32733","1600-1659",2023-02-11,60,6,43,103
"32734","1600-1659",2023-02-12,58,7,47,105
"32735","1600-1659",2023-02-13,64,1,56,120
"32736","1600-1659",2023-02-14,59,2,57,116
"32737","1600-1659",2023-02-15,59,3,57,116
"32738","1600-1659",2023-02-16,56,4,58,114
"32739","1600-1659",2023-02-17,57,5,56,113
"32740","1600-1659",2023-02-18,59,6,45,104
"32741","1600-1659",2023-02-19,53,7,49,102
"32742","1600-1659",2023-02-20,59,1,58,117
"32743","1600-1659",2023-02-21,55,2,62,117
"32744","1600-1659",2023-02-22,55,3,59,114
"32745","1600-1659",2023-02-23,57,4,58,115
"32746","1600-1659",2023-02-24,58,5,58,116
"32747","1600-1659",2023-02-25,61,6,45,106
"32748","1600-1659",2023-02-26,57,7,53,110
"32749","1600-1659",2023-02-27,59,1,59,118
"32750","1600-1659",2023-02-28,57,2,62,119
"32751","1700-1759",2023-02-01,73,3,46,119
"32752","1700-1759",2023-02-02,69,4,54,123
"32753","1700-1759",2023-02-03,67,5,52,119
"32754","1700-1759",2023-02-04,57,6,45,102
"32755","1700-1759",2023-02-05,66,7,48,114
"32756","1700-1759",2023-02-06,69,1,50,119
"32757","1700-1759",2023-02-07,71,2,47,118
"32758","1700-1759",2023-02-08,72,3,48,120
"32759","1700-1759",2023-02-09,68,4,54,122
"32760","1700-1759",2023-02-10,68,5,49,117
"32761","1700-1759",2023-02-11,58,6,44,102
"32762","1700-1759",2023-02-12,61,7,44,105
"32763","1700-1759",2023-02-13,71,1,47,118
"32764","1700-1759",2023-02-14,68,2,48,116
"32765","1700-1759",2023-02-15,72,3,48,120
"32766","1700-1759",2023-02-16,75,4,54,129
"32767","1700-1759",2023-02-17,74,5,52,126
"32768","1700-1759",2023-02-18,59,6,45,104
"32769","1700-1759",2023-02-19,66,7,44,110
"32770","1700-1759",2023-02-20,76,1,53,129
"32771","1700-1759",2023-02-21,78,2,45,123
"32772","1700-1759",2023-02-22,76,3,49,125
"32773","1700-1759",2023-02-23,75,4,54,129
"32774","1700-1759",2023-02-24,74,5,53,127
"32775","1700-1759",2023-02-25,60,6,45,105
"32776","1700-1759",2023-02-26,72,7,48,120
"32777","1700-1759",2023-02-27,76,1,52,128
"32778","1700-1759",2023-02-28,78,2,44,122
"32779","1800-1859",2023-02-01,39,3,75,114
"32780","1800-1859",2023-02-02,53,4,77,130
"32781","1800-1859",2023-02-03,60,5,74,134
"32782","1800-1859",2023-02-04,49,6,64,113
"32783","1800-1859",2023-02-05,60,7,73,133
"32784","1800-1859",2023-02-06,57,1,74,131
"32785","1800-1859",2023-02-07,52,2,71,123
"32786","1800-1859",2023-02-08,50,3,72,122
"32787","1800-1859",2023-02-09,57,4,73,130
"32788","1800-1859",2023-02-10,47,5,76,123
"32789","1800-1859",2023-02-11,45,6,67,112
"32790","1800-1859",2023-02-12,52,7,73,125
"32791","1800-1859",2023-02-13,45,1,74,119
"32792","1800-1859",2023-02-14,50,2,71,121
"32793","1800-1859",2023-02-15,45,3,76,121
"32794","1800-1859",2023-02-16,52,4,76,128
"32795","1800-1859",2023-02-17,49,5,76,125
"32796","1800-1859",2023-02-18,47,6,66,113
"32797","1800-1859",2023-02-19,51,7,70,121
"32798","1800-1859",2023-02-20,50,1,75,125
"32799","1800-1859",2023-02-21,46,2,75,121
"32800","1800-1859",2023-02-22,44,3,74,118
"32801","1800-1859",2023-02-23,53,4,76,129
"32802","1800-1859",2023-02-24,51,5,76,127
"32803","1800-1859",2023-02-25,46,6,65,111
"32804","1800-1859",2023-02-26,50,7,74,124
"32805","1800-1859",2023-02-27,48,1,75,123
"32806","1800-1859",2023-02-28,45,2,75,120
"32807","1900-1959",2023-02-01,75,3,47,122
"32808","1900-1959",2023-02-02,77,4,48,125
"32809","1900-1959",2023-02-03,74,5,53,127
"32810","1900-1959",2023-02-04,51,6,51,102
"32811","1900-1959",2023-02-05,66,7,49,115
"32812","1900-1959",2023-02-06,73,1,52,125
"32813","1900-1959",2023-02-07,69,2,51,120
"32814","1900-1959",2023-02-08,71,3,51,122
"32815","1900-1959",2023-02-09,76,4,50,126
"32816","1900-1959",2023-02-10,81,5,52,133
"32817","1900-1959",2023-02-11,53,6,48,101
"32818","1900-1959",2023-02-12,60,7,51,111
"32819","1900-1959",2023-02-13,72,1,54,126
"32820","1900-1959",2023-02-14,61,2,54,115
"32821","1900-1959",2023-02-15,69,3,51,120
"32822","1900-1959",2023-02-16,75,4,55,130
"32823","1900-1959",2023-02-17,77,5,56,133
"32824","1900-1959",2023-02-18,50,6,51,101
"32825","1900-1959",2023-02-19,56,7,55,111
"32826","1900-1959",2023-02-20,77,1,55,132
"32827","1900-1959",2023-02-21,71,2,54,125
"32828","1900-1959",2023-02-22,72,3,54,126
"32829","1900-1959",2023-02-23,76,4,56,132
"32830","1900-1959",2023-02-24,77,5,56,133
"32831","1900-1959",2023-02-25,51,6,51,102
"32832","1900-1959",2023-02-26,71,7,51,122
"32833","1900-1959",2023-02-27,77,1,55,132
"32834","1900-1959",2023-02-28,71,2,53,124
"32835","2000-2059",2023-02-01,32,3,72,104
"32836","2000-2059",2023-02-02,35,4,79,114
"32837","2000-2059",2023-02-03,38,5,72,110
"32838","2000-2059",2023-02-04,30,6,61,91
"32839","2000-2059",2023-02-05,32,7,76,108
"32840","2000-2059",2023-02-06,38,1,75,113
"32841","2000-2059",2023-02-07,32,2,71,103
"32842","2000-2059",2023-02-08,36,3,67,103
"32843","2000-2059",2023-02-09,39,4,73,112
"32844","2000-2059",2023-02-10,42,5,69,111
"32845","2000-2059",2023-02-11,28,6,57,85
"32846","2000-2059",2023-02-12,31,7,66,97
"32847","2000-2059",2023-02-13,40,1,68,108
"32848","2000-2059",2023-02-14,33,2,61,94
"32849","2000-2059",2023-02-15,36,3,64,100
"32850","2000-2059",2023-02-16,41,4,68,109
"32851","2000-2059",2023-02-17,43,5,66,109
"32852","2000-2059",2023-02-18,32,6,58,90
"32853","2000-2059",2023-02-19,33,7,63,96
"32854","2000-2059",2023-02-20,40,1,73,113
"32855","2000-2059",2023-02-21,35,2,67,102
"32856","2000-2059",2023-02-22,37,3,67,104
"32857","2000-2059",2023-02-23,40,4,69,109
"32858","2000-2059",2023-02-24,42,5,68,110
"32859","2000-2059",2023-02-25,32,6,58,90
"32860","2000-2059",2023-02-26,34,7,68,102
"32861","2000-2059",2023-02-27,39,1,73,112
"32862","2000-2059",2023-02-28,34,2,67,101
"32863","2100-2159",2023-02-01,35,3,67,102
"32864","2100-2159",2023-02-02,45,4,68,113
"32865","2100-2159",2023-02-03,43,5,74,117
"32866","2100-2159",2023-02-04,22,6,60,82
"32867","2100-2159",2023-02-05,45,7,69,114
"32868","2100-2159",2023-02-06,41,1,71,112
"32869","2100-2159",2023-02-07,36,2,68,104
"32870","2100-2159",2023-02-08,36,3,72,108
"32871","2100-2159",2023-02-09,42,4,70,112
"32872","2100-2159",2023-02-10,41,5,73,114
"32873","2100-2159",2023-02-11,24,6,59,83
"32874","2100-2159",2023-02-12,37,7,66,103
"32875","2100-2159",2023-02-13,38,1,68,106
"32876","2100-2159",2023-02-14,33,2,65,98
"32877","2100-2159",2023-02-15,38,3,68,106
"32878","2100-2159",2023-02-16,44,4,70,114
"32879","2100-2159",2023-02-17,43,5,73,116
"32880","2100-2159",2023-02-18,21,6,60,81
"32881","2100-2159",2023-02-19,38,7,64,102
"32882","2100-2159",2023-02-20,42,1,71,113
"32883","2100-2159",2023-02-21,34,2,69,103
"32884","2100-2159",2023-02-22,33,3,67,100
"32885","2100-2159",2023-02-23,44,4,70,114
"32886","2100-2159",2023-02-24,43,5,71,114
"32887","2100-2159",2023-02-25,22,6,60,82
"32888","2100-2159",2023-02-26,43,7,65,108
"32889","2100-2159",2023-02-27,41,1,69,110
"32890","2100-2159",2023-02-28,33,2,68,101
"32891","2200-2259",2023-02-01,32,3,57,89
"32892","2200-2259",2023-02-02,38,4,66,104
"32893","2200-2259",2023-02-03,38,5,64,102
"32894","2200-2259",2023-02-04,32,6,49,81
"32895","2200-2259",2023-02-05,42,7,60,102
"32896","2200-2259",2023-02-06,38,1,65,103
"32897","2200-2259",2023-02-07,33,2,61,94
"32898","2200-2259",2023-02-08,32,3,58,90
"32899","2200-2259",2023-02-09,37,4,65,102
"32900","2200-2259",2023-02-10,38,5,65,103
"32901","2200-2259",2023-02-11,31,6,50,81
"32902","2200-2259",2023-02-12,38,7,54,92
"32903","2200-2259",2023-02-13,34,1,59,93
"32904","2200-2259",2023-02-14,29,2,55,84
"32905","2200-2259",2023-02-15,31,3,61,92
"32906","2200-2259",2023-02-16,37,4,67,104
"32907","2200-2259",2023-02-17,34,5,63,97
"32908","2200-2259",2023-02-18,29,6,47,76
"32909","2200-2259",2023-02-19,35,7,52,87
"32910","2200-2259",2023-02-20,34,1,64,98
"32911","2200-2259",2023-02-21,31,2,58,89
"32912","2200-2259",2023-02-22,32,3,58,90
"32913","2200-2259",2023-02-23,37,4,64,101
"32914","2200-2259",2023-02-24,34,5,63,97
"32915","2200-2259",2023-02-25,31,6,50,81
"32916","2200-2259",2023-02-26,40,7,65,105
"32917","2200-2259",2023-02-27,34,1,63,97
"32918","2200-2259",2023-02-28,31,2,57,88
"32919","2300-2359",2023-02-01,23,3,50,73
"32920","2300-2359",2023-02-02,26,4,59,85
"32921","2300-2359",2023-02-03,27,5,61,88
"32922","2300-2359",2023-02-04,23,6,38,61
"32923","2300-2359",2023-02-05,27,7,62,89
"32924","2300-2359",2023-02-06,26,1,60,86
"32925","2300-2359",2023-02-07,23,2,50,73
"32926","2300-2359",2023-02-08,22,3,53,75
"32927","2300-2359",2023-02-09,25,4,61,86
"32928","2300-2359",2023-02-10,24,5,60,84
"32929","2300-2359",2023-02-11,22,6,38,60
"32930","2300-2359",2023-02-12,24,7,57,81
"32931","2300-2359",2023-02-13,25,1,60,85
"32932","2300-2359",2023-02-14,22,2,48,70
"32933","2300-2359",2023-02-15,23,3,51,74
"32934","2300-2359",2023-02-16,26,4,62,88
"32935","2300-2359",2023-02-17,28,5,64,92
"32936","2300-2359",2023-02-18,22,6,38,60
"32937","2300-2359",2023-02-19,25,7,58,83
"32938","2300-2359",2023-02-20,29,1,66,95
"32939","2300-2359",2023-02-21,24,2,55,79
"32940","2300-2359",2023-02-22,25,3,54,79
"32941","2300-2359",2023-02-23,27,4,64,91
"32942","2300-2359",2023-02-24,29,5,65,94
"32943","2300-2359",2023-02-25,23,6,40,63
"32944","2300-2359",2023-02-26,30,7,64,94
"32945","2300-2359",2023-02-27,29,1,65,94
"32946","2300-2359",2023-02-28,24,2,55,79
"32947","0001-0559",2023-03-01,26,3,41,67
"32948","0001-0559",2023-03-02,29,4,48,77
"32949","0001-0559",2023-03-03,31,5,44,75
"32950","0001-0559",2023-03-04,22,6,32,54
"32951","0001-0559",2023-03-05,21,7,47,68
"32952","0001-0559",2023-03-06,31,1,39,70
"32953","0001-0559",2023-03-07,30,2,36,66
"32954","0001-0559",2023-03-08,27,3,44,71
"32955","0001-0559",2023-03-09,28,4,54,82
"32956","0001-0559",2023-03-10,30,5,52,82
"32957","0001-0559",2023-03-11,27,6,35,62
"32958","0001-0559",2023-03-12,17,7,54,71
"32959","0001-0559",2023-03-13,32,1,46,78
"32960","0001-0559",2023-03-14,29,2,43,72
"32961","0001-0559",2023-03-15,27,3,46,73
"32962","0001-0559",2023-03-16,29,4,52,81
"32963","0001-0559",2023-03-17,32,5,50,82
"32964","0001-0559",2023-03-18,27,6,40,67
"32965","0001-0559",2023-03-19,20,7,56,76
"32966","0001-0559",2023-03-20,32,1,46,78
"32967","0001-0559",2023-03-21,29,2,44,73
"32968","0001-0559",2023-03-22,27,3,47,74
"32969","0001-0559",2023-03-23,29,4,52,81
"32970","0001-0559",2023-03-24,32,5,50,82
"32971","0001-0559",2023-03-25,27,6,42,69
"32972","0001-0559",2023-03-26,19,7,57,76
"32973","0001-0559",2023-03-27,30,1,47,77
"32974","0001-0559",2023-03-28,27,2,45,72
"32975","0001-0559",2023-03-29,25,3,48,73
"32976","0001-0559",2023-03-30,27,4,53,80
"32977","0001-0559",2023-03-31,30,5,52,82
"32978","0600-0659",2023-03-01,64,3,25,89
"32979","0600-0659",2023-03-02,70,4,30,100
"32980","0600-0659",2023-03-03,73,5,29,102
"32981","0600-0659",2023-03-04,67,6,28,95
"32982","0600-0659",2023-03-05,67,7,28,95
"32983","0600-0659",2023-03-06,72,1,29,101
"32984","0600-0659",2023-03-07,68,2,26,94
"32985","0600-0659",2023-03-08,66,3,26,92
"32986","0600-0659",2023-03-09,74,4,30,104
"32987","0600-0659",2023-03-10,75,5,31,106
"32988","0600-0659",2023-03-11,67,6,23,90
"32989","0600-0659",2023-03-12,75,7,23,98
"32990","0600-0659",2023-03-13,74,1,33,107
"32991","0600-0659",2023-03-14,71,2,30,101
"32992","0600-0659",2023-03-15,72,3,29,101
"32993","0600-0659",2023-03-16,73,4,32,105
"32994","0600-0659",2023-03-17,74,5,35,109
"32995","0600-0659",2023-03-18,70,6,26,96
"32996","0600-0659",2023-03-19,74,7,27,101
"32997","0600-0659",2023-03-20,74,1,35,109
"32998","0600-0659",2023-03-21,71,2,30,101
"32999","0600-0659",2023-03-22,72,3,30,102
"33000","0600-0659",2023-03-23,75,4,32,107
"33001","0600-0659",2023-03-24,73,5,35,108
"33002","0600-0659",2023-03-25,72,6,27,99
"33003","0600-0659",2023-03-26,78,7,23,101
"33004","0600-0659",2023-03-27,74,1,32,106
"33005","0600-0659",2023-03-28,72,2,27,99
"33006","0600-0659",2023-03-29,73,3,26,99
"33007","0600-0659",2023-03-30,75,4,29,104
"33008","0600-0659",2023-03-31,74,5,33,107
"33009","0700-0759",2023-03-01,69,3,48,117
"33010","0700-0759",2023-03-02,72,4,49,121
"33011","0700-0759",2023-03-03,71,5,51,122
"33012","0700-0759",2023-03-04,75,6,37,112
"33013","0700-0759",2023-03-05,76,7,39,115
"33014","0700-0759",2023-03-06,68,1,50,118
"33015","0700-0759",2023-03-07,67,2,45,112
"33016","0700-0759",2023-03-08,67,3,44,111
"33017","0700-0759",2023-03-09,74,4,47,121
"33018","0700-0759",2023-03-10,78,5,49,127
"33019","0700-0759",2023-03-11,74,6,49,123
"33020","0700-0759",2023-03-12,78,7,46,124
"33021","0700-0759",2023-03-13,75,1,49,124
"33022","0700-0759",2023-03-14,73,2,49,122
"33023","0700-0759",2023-03-15,71,3,48,119
"33024","0700-0759",2023-03-16,77,4,45,122
"33025","0700-0759",2023-03-17,80,5,48,128
"33026","0700-0759",2023-03-18,74,6,45,119
"33027","0700-0759",2023-03-19,81,7,42,123
"33028","0700-0759",2023-03-20,78,1,47,125
"33029","0700-0759",2023-03-21,74,2,48,122
"33030","0700-0759",2023-03-22,73,3,47,120
"33031","0700-0759",2023-03-23,78,4,46,124
"33032","0700-0759",2023-03-24,81,5,47,128
"33033","0700-0759",2023-03-25,74,6,44,118
"33034","0700-0759",2023-03-26,78,7,46,124
"33035","0700-0759",2023-03-27,75,1,50,125
"33036","0700-0759",2023-03-28,74,2,51,125
"33037","0700-0759",2023-03-29,71,3,51,122
"33038","0700-0759",2023-03-30,75,4,49,124
"33039","0700-0759",2023-03-31,76,5,49,125
"33040","0800-0859",2023-03-01,93,3,40,133
"33041","0800-0859",2023-03-02,96,4,44,140
"33042","0800-0859",2023-03-03,97,5,45,142
"33043","0800-0859",2023-03-04,84,6,45,129
"33044","0800-0859",2023-03-05,85,7,42,127
"33045","0800-0859",2023-03-06,99,1,45,144
"33046","0800-0859",2023-03-07,95,2,42,137
"33047","0800-0859",2023-03-08,94,3,42,136
"33048","0800-0859",2023-03-09,94,4,41,135
"33049","0800-0859",2023-03-10,94,5,44,138
"33050","0800-0859",2023-03-11,89,6,45,134
"33051","0800-0859",2023-03-12,87,7,35,122
"33052","0800-0859",2023-03-13,97,1,43,140
"33053","0800-0859",2023-03-14,98,2,39,137
"33054","0800-0859",2023-03-15,96,3,40,136
"33055","0800-0859",2023-03-16,94,4,44,138
"33056","0800-0859",2023-03-17,96,5,44,140
"33057","0800-0859",2023-03-18,88,6,40,128
"33058","0800-0859",2023-03-19,86,7,40,126
"33059","0800-0859",2023-03-20,99,1,45,144
"33060","0800-0859",2023-03-21,98,2,40,138
"33061","0800-0859",2023-03-22,96,3,41,137
"33062","0800-0859",2023-03-23,94,4,44,138
"33063","0800-0859",2023-03-24,96,5,45,141
"33064","0800-0859",2023-03-25,86,6,41,127
"33065","0800-0859",2023-03-26,82,7,45,127
"33066","0800-0859",2023-03-27,97,1,48,145
"33067","0800-0859",2023-03-28,94,2,44,138
"33068","0800-0859",2023-03-29,94,3,45,139
"33069","0800-0859",2023-03-30,94,4,48,142
"33070","0800-0859",2023-03-31,95,5,49,144
"33071","0900-0959",2023-03-01,59,3,51,110
"33072","0900-0959",2023-03-02,62,4,53,115
"33073","0900-0959",2023-03-03,65,5,56,121
"33074","0900-0959",2023-03-04,63,6,52,115
"33075","0900-0959",2023-03-05,62,7,48,110
"33076","0900-0959",2023-03-06,65,1,55,120
"33077","0900-0959",2023-03-07,62,2,53,115
"33078","0900-0959",2023-03-08,59,3,53,112
"33079","0900-0959",2023-03-09,57,4,57,114
"33080","0900-0959",2023-03-10,58,5,58,116
"33081","0900-0959",2023-03-11,54,6,52,106
"33082","0900-0959",2023-03-12,54,7,57,111
"33083","0900-0959",2023-03-13,56,1,59,115
"33084","0900-0959",2023-03-14,54,2,59,113
"33085","0900-0959",2023-03-15,52,3,57,109
"33086","0900-0959",2023-03-16,55,4,58,113
"33087","0900-0959",2023-03-17,52,5,58,110
"33088","0900-0959",2023-03-18,49,6,53,102
"33089","0900-0959",2023-03-19,54,7,56,110
"33090","0900-0959",2023-03-20,52,1,58,110
"33091","0900-0959",2023-03-21,52,2,56,108
"33092","0900-0959",2023-03-22,50,3,56,106
"33093","0900-0959",2023-03-23,54,4,59,113
"33094","0900-0959",2023-03-24,52,5,58,110
"33095","0900-0959",2023-03-25,47,6,53,100
"33096","0900-0959",2023-03-26,52,7,55,107
"33097","0900-0959",2023-03-27,48,1,55,103
"33098","0900-0959",2023-03-28,47,2,54,101
"33099","0900-0959",2023-03-29,46,3,53,99
"33100","0900-0959",2023-03-30,49,4,56,105
"33101","0900-0959",2023-03-31,48,5,55,103
"33102","1000-1059",2023-03-01,54,3,38,92
"33103","1000-1059",2023-03-02,58,4,42,100
"33104","1000-1059",2023-03-03,60,5,45,105
"33105","1000-1059",2023-03-04,48,6,39,87
"33106","1000-1059",2023-03-05,52,7,40,92
"33107","1000-1059",2023-03-06,61,1,45,106
"33108","1000-1059",2023-03-07,56,2,42,98
"33109","1000-1059",2023-03-08,58,3,39,97
"33110","1000-1059",2023-03-09,69,4,43,112
"33111","1000-1059",2023-03-10,69,5,46,115
"33112","1000-1059",2023-03-11,55,6,40,95
"33113","1000-1059",2023-03-12,64,7,43,107
"33114","1000-1059",2023-03-13,73,1,47,120
"33115","1000-1059",2023-03-14,70,2,45,115
"33116","1000-1059",2023-03-15,70,3,44,114
"33117","1000-1059",2023-03-16,71,4,44,115
"33118","1000-1059",2023-03-17,71,5,48,119
"33119","1000-1059",2023-03-18,59,6,40,99
"33120","1000-1059",2023-03-19,62,7,44,106
"33121","1000-1059",2023-03-20,72,1,47,119
"33122","1000-1059",2023-03-21,68,2,45,113
"33123","1000-1059",2023-03-22,70,3,43,113
"33124","1000-1059",2023-03-23,71,4,44,115
"33125","1000-1059",2023-03-24,71,5,48,119
"33126","1000-1059",2023-03-25,58,6,40,98
"33127","1000-1059",2023-03-26,61,7,39,100
"33128","1000-1059",2023-03-27,69,1,44,113
"33129","1000-1059",2023-03-28,65,2,42,107
"33130","1000-1059",2023-03-29,66,3,41,107
"33131","1000-1059",2023-03-30,69,4,42,111
"33132","1000-1059",2023-03-31,68,5,44,112
"33133","1100-1159",2023-03-01,51,3,53,104
"33134","1100-1159",2023-03-02,51,4,57,108
"33135","1100-1159",2023-03-03,51,5,56,107
"33136","1100-1159",2023-03-04,48,6,52,100
"33137","1100-1159",2023-03-05,45,7,56,101
"33138","1100-1159",2023-03-06,49,1,57,106
"33139","1100-1159",2023-03-07,51,2,53,104
"33140","1100-1159",2023-03-08,51,3,53,104
"33141","1100-1159",2023-03-09,53,4,61,114
"33142","1100-1159",2023-03-10,54,5,59,113
"33143","1100-1159",2023-03-11,48,6,54,102
"33144","1100-1159",2023-03-12,44,7,62,106
"33145","1100-1159",2023-03-13,51,1,66,117
"33146","1100-1159",2023-03-14,51,2,62,113
"33147","1100-1159",2023-03-15,52,3,61,113
"33148","1100-1159",2023-03-16,54,4,69,123
"33149","1100-1159",2023-03-17,55,5,67,122
"33150","1100-1159",2023-03-18,43,6,65,108
"33151","1100-1159",2023-03-19,47,7,63,110
"33152","1100-1159",2023-03-20,54,1,67,121
"33153","1100-1159",2023-03-21,52,2,65,117
"33154","1100-1159",2023-03-22,53,3,65,118
"33155","1100-1159",2023-03-23,54,4,69,123
"33156","1100-1159",2023-03-24,55,5,67,122
"33157","1100-1159",2023-03-25,43,6,64,107
"33158","1100-1159",2023-03-26,48,7,65,113
"33159","1100-1159",2023-03-27,58,1,69,127
"33160","1100-1159",2023-03-28,56,2,66,122
"33161","1100-1159",2023-03-29,55,3,65,120
"33162","1100-1159",2023-03-30,56,4,70,126
"33163","1100-1159",2023-03-31,54,5,68,122
"33164","1200-1259",2023-03-01,51,3,55,106
"33165","1200-1259",2023-03-02,52,4,56,108
"33166","1200-1259",2023-03-03,51,5,58,109
"33167","1200-1259",2023-03-04,48,6,58,106
"33168","1200-1259",2023-03-05,53,7,56,109
"33169","1200-1259",2023-03-06,53,1,58,111
"33170","1200-1259",2023-03-07,51,2,59,110
"33171","1200-1259",2023-03-08,47,3,57,104
"33172","1200-1259",2023-03-09,51,4,57,108
"33173","1200-1259",2023-03-10,50,5,57,107
"33174","1200-1259",2023-03-11,44,6,57,101
"33175","1200-1259",2023-03-12,57,7,53,110
"33176","1200-1259",2023-03-13,60,1,52,112
"33177","1200-1259",2023-03-14,57,2,53,110
"33178","1200-1259",2023-03-15,56,3,51,107
"33179","1200-1259",2023-03-16,62,4,53,115
"33180","1200-1259",2023-03-17,59,5,53,112
"33181","1200-1259",2023-03-18,55,6,48,103
"33182","1200-1259",2023-03-19,58,7,53,111
"33183","1200-1259",2023-03-20,61,1,54,115
"33184","1200-1259",2023-03-21,59,2,53,112
"33185","1200-1259",2023-03-22,59,3,52,111
"33186","1200-1259",2023-03-23,62,4,53,115
"33187","1200-1259",2023-03-24,59,5,53,112
"33188","1200-1259",2023-03-25,53,6,48,101
"33189","1200-1259",2023-03-26,54,7,52,106
"33190","1200-1259",2023-03-27,56,1,51,107
"33191","1200-1259",2023-03-28,55,2,52,107
"33192","1200-1259",2023-03-29,56,3,50,106
"33193","1200-1259",2023-03-30,58,4,50,108
"33194","1200-1259",2023-03-31,56,5,51,107
"33195","1300-1359",2023-03-01,56,3,51,107
"33196","1300-1359",2023-03-02,61,4,52,113
"33197","1300-1359",2023-03-03,61,5,50,111
"33198","1300-1359",2023-03-04,45,6,42,87
"33199","1300-1359",2023-03-05,56,7,45,101
"33200","1300-1359",2023-03-06,61,1,48,109
"33201","1300-1359",2023-03-07,57,2,49,106
"33202","1300-1359",2023-03-08,58,3,46,104
"33203","1300-1359",2023-03-09,69,4,52,121
"33204","1300-1359",2023-03-10,68,5,52,120
"33205","1300-1359",2023-03-11,50,6,40,90
"33206","1300-1359",2023-03-12,58,7,40,98
"33207","1300-1359",2023-03-13,63,1,48,111
"33208","1300-1359",2023-03-14,62,2,48,110
"33209","1300-1359",2023-03-15,62,3,48,110
"33210","1300-1359",2023-03-16,64,4,47,111
"33211","1300-1359",2023-03-17,63,5,46,109
"33212","1300-1359",2023-03-18,48,6,40,88
"33213","1300-1359",2023-03-19,59,7,38,97
"33214","1300-1359",2023-03-20,62,1,45,107
"33215","1300-1359",2023-03-21,61,2,44,105
"33216","1300-1359",2023-03-22,61,3,44,105
"33217","1300-1359",2023-03-23,64,4,47,111
"33218","1300-1359",2023-03-24,63,5,46,109
"33219","1300-1359",2023-03-25,48,6,40,88
"33220","1300-1359",2023-03-26,62,7,39,101
"33221","1300-1359",2023-03-27,65,1,44,109
"33222","1300-1359",2023-03-28,62,2,42,104
"33223","1300-1359",2023-03-29,63,3,42,105
"33224","1300-1359",2023-03-30,64,4,45,109
"33225","1300-1359",2023-03-31,66,5,42,108
"33226","1400-1459",2023-03-01,45,3,59,104
"33227","1400-1459",2023-03-02,47,4,62,109
"33228","1400-1459",2023-03-03,46,5,59,105
"33229","1400-1459",2023-03-04,41,6,52,93
"33230","1400-1459",2023-03-05,46,7,56,102
"33231","1400-1459",2023-03-06,45,1,61,106
"33232","1400-1459",2023-03-07,46,2,56,102
"33233","1400-1459",2023-03-08,44,3,57,101
"33234","1400-1459",2023-03-09,46,4,60,106
"33235","1400-1459",2023-03-10,45,5,59,104
"33236","1400-1459",2023-03-11,37,6,53,90
"33237","1400-1459",2023-03-12,40,7,58,98
"33238","1400-1459",2023-03-13,44,1,63,107
"33239","1400-1459",2023-03-14,41,2,60,101
"33240","1400-1459",2023-03-15,42,3,60,102
"33241","1400-1459",2023-03-16,44,4,65,109
"33242","1400-1459",2023-03-17,42,5,63,105
"33243","1400-1459",2023-03-18,38,6,53,91
"33244","1400-1459",2023-03-19,41,7,58,99
"33245","1400-1459",2023-03-20,43,1,66,109
"33246","1400-1459",2023-03-21,43,2,63,106
"33247","1400-1459",2023-03-22,44,3,63,107
"33248","1400-1459",2023-03-23,45,4,66,111
"33249","1400-1459",2023-03-24,43,5,63,106
"33250","1400-1459",2023-03-25,38,6,54,92
"33251","1400-1459",2023-03-26,41,7,57,98
"33252","1400-1459",2023-03-27,44,1,61,105
"33253","1400-1459",2023-03-28,42,2,58,100
"33254","1400-1459",2023-03-29,44,3,58,102
"33255","1400-1459",2023-03-30,46,4,60,106
"33256","1400-1459",2023-03-31,42,5,59,101
"33257","1500-1559",2023-03-01,49,3,50,99
"33258","1500-1559",2023-03-02,54,4,54,108
"33259","1500-1559",2023-03-03,56,5,55,111
"33260","1500-1559",2023-03-04,49,6,56,105
"33261","1500-1559",2023-03-05,55,7,58,113
"33262","1500-1559",2023-03-06,56,1,56,112
"33263","1500-1559",2023-03-07,50,2,54,104
"33264","1500-1559",2023-03-08,50,3,50,100
"33265","1500-1559",2023-03-09,52,4,56,108
"33266","1500-1559",2023-03-10,56,5,57,113
"33267","1500-1559",2023-03-11,48,6,53,101
"33268","1500-1559",2023-03-12,52,7,56,108
"33269","1500-1559",2023-03-13,60,1,55,115
"33270","1500-1559",2023-03-14,58,2,56,114
"33271","1500-1559",2023-03-15,57,3,55,112
"33272","1500-1559",2023-03-16,58,4,54,112
"33273","1500-1559",2023-03-17,60,5,53,113
"33274","1500-1559",2023-03-18,50,6,52,102
"33275","1500-1559",2023-03-19,53,7,56,109
"33276","1500-1559",2023-03-20,61,1,55,116
"33277","1500-1559",2023-03-21,58,2,59,117
"33278","1500-1559",2023-03-22,58,3,59,117
"33279","1500-1559",2023-03-23,58,4,55,113
"33280","1500-1559",2023-03-24,60,5,54,114
"33281","1500-1559",2023-03-25,47,6,52,99
"33282","1500-1559",2023-03-26,51,7,55,106
"33283","1500-1559",2023-03-27,57,1,60,117
"33284","1500-1559",2023-03-28,55,2,62,117
"33285","1500-1559",2023-03-29,55,3,63,118
"33286","1500-1559",2023-03-30,54,4,60,114
"33287","1500-1559",2023-03-31,57,5,57,114
"33288","1600-1659",2023-03-01,57,3,61,118
"33289","1600-1659",2023-03-02,57,4,60,117
"33290","1600-1659",2023-03-03,55,5,62,117
"33291","1600-1659",2023-03-04,60,6,49,109
"33292","1600-1659",2023-03-05,54,7,56,110
"33293","1600-1659",2023-03-06,58,1,62,120
"33294","1600-1659",2023-03-07,56,2,67,123
"33295","1600-1659",2023-03-08,57,3,64,121
"33296","1600-1659",2023-03-09,59,4,61,120
"33297","1600-1659",2023-03-10,57,5,60,117
"33298","1600-1659",2023-03-11,61,6,49,110
"33299","1600-1659",2023-03-12,55,7,53,108
"33300","1600-1659",2023-03-13,55,1,65,120
"33301","1600-1659",2023-03-14,52,2,63,115
"33302","1600-1659",2023-03-15,52,3,64,116
"33303","1600-1659",2023-03-16,53,4,62,115
"33304","1600-1659",2023-03-17,53,5,62,115
"33305","1600-1659",2023-03-18,53,6,53,106
"33306","1600-1659",2023-03-19,55,7,57,112
"33307","1600-1659",2023-03-20,55,1,62,117
"33308","1600-1659",2023-03-21,55,2,58,113
"33309","1600-1659",2023-03-22,54,3,59,113
"33310","1600-1659",2023-03-23,55,4,61,116
"33311","1600-1659",2023-03-24,55,5,62,117
"33312","1600-1659",2023-03-25,57,6,50,107
"33313","1600-1659",2023-03-26,58,7,53,111
"33314","1600-1659",2023-03-27,57,1,57,114
"33315","1600-1659",2023-03-28,56,2,53,109
"33316","1600-1659",2023-03-29,55,3,55,110
"33317","1600-1659",2023-03-30,57,4,57,114
"33318","1600-1659",2023-03-31,57,5,57,114
"33319","1700-1759",2023-03-01,75,3,45,120
"33320","1700-1759",2023-03-02,74,4,51,125
"33321","1700-1759",2023-03-03,74,5,49,123
"33322","1700-1759",2023-03-04,58,6,43,101
"33323","1700-1759",2023-03-05,70,7,47,117
"33324","1700-1759",2023-03-06,75,1,49,124
"33325","1700-1759",2023-03-07,77,2,39,116
"33326","1700-1759",2023-03-08,72,3,43,115
"33327","1700-1759",2023-03-09,61,4,44,105
"33328","1700-1759",2023-03-10,60,5,44,104
"33329","1700-1759",2023-03-11,58,6,36,94
"33330","1700-1759",2023-03-12,57,7,44,101
"33331","1700-1759",2023-03-13,64,1,44,108
"33332","1700-1759",2023-03-14,61,2,40,101
"33333","1700-1759",2023-03-15,59,3,41,100
"33334","1700-1759",2023-03-16,59,4,44,103
"33335","1700-1759",2023-03-17,60,5,43,103
"33336","1700-1759",2023-03-18,56,6,34,90
"33337","1700-1759",2023-03-19,53,7,43,96
"33338","1700-1759",2023-03-20,59,1,43,102
"33339","1700-1759",2023-03-21,56,2,42,98
"33340","1700-1759",2023-03-22,55,3,43,98
"33341","1700-1759",2023-03-23,58,4,43,101
"33342","1700-1759",2023-03-24,59,5,42,101
"33343","1700-1759",2023-03-25,54,6,33,87
"33344","1700-1759",2023-03-26,54,7,45,99
"33345","1700-1759",2023-03-27,60,1,47,107
"33346","1700-1759",2023-03-28,57,2,45,102
"33347","1700-1759",2023-03-29,57,3,46,103
"33348","1700-1759",2023-03-30,59,4,46,105
"33349","1700-1759",2023-03-31,61,5,47,108
"33350","1800-1859",2023-03-01,42,3,77,119
"33351","1800-1859",2023-03-02,52,4,79,131
"33352","1800-1859",2023-03-03,52,5,81,133
"33353","1800-1859",2023-03-04,49,6,68,117
"33354","1800-1859",2023-03-05,54,7,77,131
"33355","1800-1859",2023-03-06,51,1,80,131
"33356","1800-1859",2023-03-07,48,2,81,129
"33357","1800-1859",2023-03-08,50,3,82,132
"33358","1800-1859",2023-03-09,64,4,80,144
"33359","1800-1859",2023-03-10,63,5,80,143
"33360","1800-1859",2023-03-11,52,6,71,123
"33361","1800-1859",2023-03-12,63,7,75,138
"33362","1800-1859",2023-03-13,58,1,78,136
"33363","1800-1859",2023-03-14,56,2,76,132
"33364","1800-1859",2023-03-15,57,3,77,134
"33365","1800-1859",2023-03-16,63,4,78,141
"33366","1800-1859",2023-03-17,62,5,79,141
"33367","1800-1859",2023-03-18,51,6,68,119
"33368","1800-1859",2023-03-19,66,7,74,140
"33369","1800-1859",2023-03-20,62,1,80,142
"33370","1800-1859",2023-03-21,58,2,76,134
"33371","1800-1859",2023-03-22,60,3,77,137
"33372","1800-1859",2023-03-23,63,4,79,142
"33373","1800-1859",2023-03-24,62,5,80,142
"33374","1800-1859",2023-03-25,50,6,66,116
"33375","1800-1859",2023-03-26,65,7,74,139
"33376","1800-1859",2023-03-27,64,1,78,142
"33377","1800-1859",2023-03-28,58,2,75,133
"33378","1800-1859",2023-03-29,62,3,76,138
"33379","1800-1859",2023-03-30,66,4,78,144
"33380","1800-1859",2023-03-31,65,5,78,143
"33381","1900-1959",2023-03-01,75,3,53,128
"33382","1900-1959",2023-03-02,79,4,57,136
"33383","1900-1959",2023-03-03,75,5,53,128
"33384","1900-1959",2023-03-04,48,6,48,96
"33385","1900-1959",2023-03-05,68,7,47,115
"33386","1900-1959",2023-03-06,74,1,53,127
"33387","1900-1959",2023-03-07,66,2,50,116
"33388","1900-1959",2023-03-08,69,3,49,118
"33389","1900-1959",2023-03-09,62,4,56,118
"33390","1900-1959",2023-03-10,63,5,56,119
"33391","1900-1959",2023-03-11,51,6,52,103
"33392","1900-1959",2023-03-12,61,7,51,112
"33393","1900-1959",2023-03-13,62,1,56,118
"33394","1900-1959",2023-03-14,59,2,52,111
"33395","1900-1959",2023-03-15,60,3,51,111
"33396","1900-1959",2023-03-16,61,4,51,112
"33397","1900-1959",2023-03-17,60,5,52,112
"33398","1900-1959",2023-03-18,49,6,44,93
"33399","1900-1959",2023-03-19,57,7,45,102
"33400","1900-1959",2023-03-20,60,1,51,111
"33401","1900-1959",2023-03-21,56,2,49,105
"33402","1900-1959",2023-03-22,59,3,49,108
"33403","1900-1959",2023-03-23,61,4,52,113
"33404","1900-1959",2023-03-24,61,5,53,114
"33405","1900-1959",2023-03-25,50,6,46,96
"33406","1900-1959",2023-03-26,52,7,42,94
"33407","1900-1959",2023-03-27,56,1,47,103
"33408","1900-1959",2023-03-28,53,2,45,98
"33409","1900-1959",2023-03-29,55,3,45,100
"33410","1900-1959",2023-03-30,56,4,47,103
"33411","1900-1959",2023-03-31,55,5,48,103
"33412","2000-2059",2023-03-01,36,3,66,102
"33413","2000-2059",2023-03-02,42,4,71,113
"33414","2000-2059",2023-03-03,42,5,70,112
"33415","2000-2059",2023-03-04,31,6,59,90
"33416","2000-2059",2023-03-05,34,7,73,107
"33417","2000-2059",2023-03-06,41,1,76,117
"33418","2000-2059",2023-03-07,33,2,69,102
"33419","2000-2059",2023-03-08,34,3,71,105
"33420","2000-2059",2023-03-09,48,4,71,119
"33421","2000-2059",2023-03-10,45,5,69,114
"33422","2000-2059",2023-03-11,41,6,63,104
"33423","2000-2059",2023-03-12,49,7,74,123
"33424","2000-2059",2023-03-13,48,1,77,125
"33425","2000-2059",2023-03-14,44,2,75,119
"33426","2000-2059",2023-03-15,44,3,75,119
"33427","2000-2059",2023-03-16,50,4,77,127
"33428","2000-2059",2023-03-17,50,5,77,127
"33429","2000-2059",2023-03-18,42,6,71,113
"33430","2000-2059",2023-03-19,54,7,79,133
"33431","2000-2059",2023-03-20,48,1,79,127
"33432","2000-2059",2023-03-21,44,2,77,121
"33433","2000-2059",2023-03-22,43,3,76,119
"33434","2000-2059",2023-03-23,49,4,76,125
"33435","2000-2059",2023-03-24,47,5,76,123
"33436","2000-2059",2023-03-25,42,6,71,113
"33437","2000-2059",2023-03-26,55,7,80,135
"33438","2000-2059",2023-03-27,50,1,80,130
"33439","2000-2059",2023-03-28,44,2,79,123
"33440","2000-2059",2023-03-29,44,3,78,122
"33441","2000-2059",2023-03-30,51,4,79,130
"33442","2000-2059",2023-03-31,50,5,80,130
"33443","2100-2159",2023-03-01,35,3,68,103
"33444","2100-2159",2023-03-02,44,4,71,115
"33445","2100-2159",2023-03-03,44,5,76,120
"33446","2100-2159",2023-03-04,25,6,64,89
"33447","2100-2159",2023-03-05,48,7,67,115
"33448","2100-2159",2023-03-06,43,1,71,114
"33449","2100-2159",2023-03-07,38,2,71,109
"33450","2100-2159",2023-03-08,43,3,69,112
"33451","2100-2159",2023-03-09,47,4,69,116
"33452","2100-2159",2023-03-10,45,5,72,117
"33453","2100-2159",2023-03-11,43,6,68,111
"33454","2100-2159",2023-03-12,44,7,67,111
"33455","2100-2159",2023-03-13,45,1,65,110
"33456","2100-2159",2023-03-14,43,2,68,111
"33457","2100-2159",2023-03-15,43,3,64,107
"33458","2100-2159",2023-03-16,48,4,67,115
"33459","2100-2159",2023-03-17,44,5,67,111
"33460","2100-2159",2023-03-18,39,6,65,104
"33461","2100-2159",2023-03-19,43,7,66,109
"33462","2100-2159",2023-03-20,44,1,66,110
"33463","2100-2159",2023-03-21,41,2,66,107
"33464","2100-2159",2023-03-22,45,3,64,109
"33465","2100-2159",2023-03-23,49,4,68,117
"33466","2100-2159",2023-03-24,46,5,69,115
"33467","2100-2159",2023-03-25,40,6,60,100
"33468","2100-2159",2023-03-26,42,7,64,106
"33469","2100-2159",2023-03-27,42,1,66,108
"33470","2100-2159",2023-03-28,40,2,63,103
"33471","2100-2159",2023-03-29,44,3,63,107
"33472","2100-2159",2023-03-30,47,4,66,113
"33473","2100-2159",2023-03-31,45,5,67,112
"33474","2200-2259",2023-03-01,31,3,59,90
"33475","2200-2259",2023-03-02,39,4,64,103
"33476","2200-2259",2023-03-03,37,5,59,96
"33477","2200-2259",2023-03-04,33,6,46,79
"33478","2200-2259",2023-03-05,42,7,62,104
"33479","2200-2259",2023-03-06,36,1,62,98
"33480","2200-2259",2023-03-07,32,2,54,86
"33481","2200-2259",2023-03-08,35,3,56,91
"33482","2200-2259",2023-03-09,45,4,70,115
"33483","2200-2259",2023-03-10,44,5,66,110
"33484","2200-2259",2023-03-11,30,6,52,82
"33485","2200-2259",2023-03-12,44,7,62,106
"33486","2200-2259",2023-03-13,40,1,66,106
"33487","2200-2259",2023-03-14,36,2,55,91
"33488","2200-2259",2023-03-15,37,3,57,94
"33489","2200-2259",2023-03-16,43,4,66,109
"33490","2200-2259",2023-03-17,44,5,64,108
"33491","2200-2259",2023-03-18,30,6,49,79
"33492","2200-2259",2023-03-19,45,7,64,109
"33493","2200-2259",2023-03-20,42,1,63,105
"33494","2200-2259",2023-03-21,37,2,51,88
"33495","2200-2259",2023-03-22,37,3,56,93
"33496","2200-2259",2023-03-23,43,4,65,108
"33497","2200-2259",2023-03-24,44,5,62,106
"33498","2200-2259",2023-03-25,32,6,52,84
"33499","2200-2259",2023-03-26,44,7,66,110
"33500","2200-2259",2023-03-27,41,1,66,107
"33501","2200-2259",2023-03-28,36,2,55,91
"33502","2200-2259",2023-03-29,36,3,60,96
"33503","2200-2259",2023-03-30,42,4,67,109
"33504","2200-2259",2023-03-31,44,5,66,110
"33505","2300-2359",2023-03-01,23,3,51,74
"33506","2300-2359",2023-03-02,24,4,63,87
"33507","2300-2359",2023-03-03,25,5,68,93
"33508","2300-2359",2023-03-04,20,6,44,64
"33509","2300-2359",2023-03-05,24,7,68,92
"33510","2300-2359",2023-03-06,25,1,67,92
"33511","2300-2359",2023-03-07,20,2,57,77
"33512","2300-2359",2023-03-08,19,3,55,74
"33513","2300-2359",2023-03-09,22,4,66,88
"33514","2300-2359",2023-03-10,23,5,66,89
"33515","2300-2359",2023-03-11,14,6,51,65
"33516","2300-2359",2023-03-12,19,7,65,84
"33517","2300-2359",2023-03-13,20,1,65,85
"33518","2300-2359",2023-03-14,18,2,60,78
"33519","2300-2359",2023-03-15,17,3,58,75
"33520","2300-2359",2023-03-16,18,4,68,86
"33521","2300-2359",2023-03-17,18,5,66,84
"33522","2300-2359",2023-03-18,17,6,52,69
"33523","2300-2359",2023-03-19,18,7,65,83
"33524","2300-2359",2023-03-20,18,1,67,85
"33525","2300-2359",2023-03-21,17,2,63,80
"33526","2300-2359",2023-03-22,17,3,62,79
"33527","2300-2359",2023-03-23,18,4,69,87
"33528","2300-2359",2023-03-24,18,5,67,85
"33529","2300-2359",2023-03-25,17,6,52,69
"33530","2300-2359",2023-03-26,22,7,61,83
"33531","2300-2359",2023-03-27,23,1,64,87
"33532","2300-2359",2023-03-28,22,2,57,79
"33533","2300-2359",2023-03-29,22,3,58,80
"33534","2300-2359",2023-03-30,23,4,66,89
"33535","2300-2359",2023-03-31,22,5,63,85
"33536","0001-0559",2023-04-01,25,6,41,66
"33537","0001-0559",2023-04-02,18,7,55,73
"33538","0001-0559",2023-04-03,30,1,50,80
"33539","0001-0559",2023-04-04,26,2,42,68
"33540","0001-0559",2023-04-05,26,3,46,72
"33541","0001-0559",2023-04-06,28,4,52,80
"33542","0001-0559",2023-04-07,32,5,51,83
"33543","0001-0559",2023-04-08,27,6,38,65
"33544","0001-0559",2023-04-09,18,7,53,71
"33545","0001-0559",2023-04-10,31,1,47,78
"33546","0001-0559",2023-04-11,31,2,46,77
"33547","0001-0559",2023-04-12,30,3,48,78
"33548","0001-0559",2023-04-13,30,4,53,83
"33549","0001-0559",2023-04-14,32,5,52,84
"33550","0001-0559",2023-04-15,20,6,35,55
"33551","0001-0559",2023-04-16,25,7,53,78
"33552","0001-0559",2023-04-17,32,1,50,82
"33553","0001-0559",2023-04-18,31,2,45,76
"33554","0001-0559",2023-04-19,30,3,48,78
"33555","0001-0559",2023-04-20,30,4,53,83
"33556","0001-0559",2023-04-21,32,5,52,84
"33557","0001-0559",2023-04-22,20,6,35,55
"33558","0001-0559",2023-04-23,25,7,52,77
"33559","0001-0559",2023-04-24,32,1,51,83
"33560","0001-0559",2023-04-25,31,2,46,77
"33561","0001-0559",2023-04-26,30,3,49,79
"33562","0001-0559",2023-04-27,30,4,53,83
"33563","0001-0559",2023-04-28,32,5,52,84
"33564","0001-0559",2023-04-29,20,6,35,55
"33565","0001-0559",2023-04-30,25,7,53,78
"33566","0600-0659",2023-04-01,71,6,23,94
"33567","0600-0659",2023-04-02,75,7,25,100
"33568","0600-0659",2023-04-03,74,1,32,106
"33569","0600-0659",2023-04-04,72,2,25,97
"33570","0600-0659",2023-04-05,73,3,26,99
"33571","0600-0659",2023-04-06,75,4,29,104
"33572","0600-0659",2023-04-07,74,5,32,106
"33573","0600-0659",2023-04-08,70,6,23,93
"33574","0600-0659",2023-04-09,75,7,23,98
"33575","0600-0659",2023-04-10,76,1,33,109
"33576","0600-0659",2023-04-11,73,2,24,97
"33577","0600-0659",2023-04-12,74,3,28,102
"33578","0600-0659",2023-04-13,77,4,27,104
"33579","0600-0659",2023-04-14,76,5,29,105
"33580","0600-0659",2023-04-15,73,6,22,95
"33581","0600-0659",2023-04-16,72,7,27,99
"33582","0600-0659",2023-04-17,76,1,29,105
"33583","0600-0659",2023-04-18,73,2,24,97
"33584","0600-0659",2023-04-19,74,3,26,100
"33585","0600-0659",2023-04-20,77,4,27,104
"33586","0600-0659",2023-04-21,77,5,28,105
"33587","0600-0659",2023-04-22,75,6,22,97
"33588","0600-0659",2023-04-23,74,7,27,101
"33589","0600-0659",2023-04-24,77,1,28,105
"33590","0600-0659",2023-04-25,73,2,24,97
"33591","0600-0659",2023-04-26,74,3,26,100
"33592","0600-0659",2023-04-27,78,4,27,105
"33593","0600-0659",2023-04-28,77,5,28,105
"33594","0600-0659",2023-04-29,75,6,22,97
"33595","0600-0659",2023-04-30,74,7,27,101
"33596","0700-0759",2023-04-01,70,6,47,117
"33597","0700-0759",2023-04-02,79,7,45,124
"33598","0700-0759",2023-04-03,75,1,49,124
"33599","0700-0759",2023-04-04,75,2,49,124
"33600","0700-0759",2023-04-05,73,3,49,122
"33601","0700-0759",2023-04-06,78,4,48,126
"33602","0700-0759",2023-04-07,78,5,50,128
"33603","0700-0759",2023-04-08,70,6,46,116
"33604","0700-0759",2023-04-09,79,7,46,125
"33605","0700-0759",2023-04-10,79,1,49,128
"33606","0700-0759",2023-04-11,75,2,46,121
"33607","0700-0759",2023-04-12,73,3,46,119
"33608","0700-0759",2023-04-13,79,4,49,128
"33609","0700-0759",2023-04-14,78,5,49,127
"33610","0700-0759",2023-04-15,75,6,40,115
"33611","0700-0759",2023-04-16,76,7,45,121
"33612","0700-0759",2023-04-17,79,1,48,127
"33613","0700-0759",2023-04-18,75,2,45,120
"33614","0700-0759",2023-04-19,72,3,46,118
"33615","0700-0759",2023-04-20,77,4,50,127
"33616","0700-0759",2023-04-21,76,5,51,127
"33617","0700-0759",2023-04-22,72,6,41,113
"33618","0700-0759",2023-04-23,74,7,47,121
"33619","0700-0759",2023-04-24,77,1,51,128
"33620","0700-0759",2023-04-25,74,2,45,119
"33621","0700-0759",2023-04-26,72,3,46,118
"33622","0700-0759",2023-04-27,77,4,50,127
"33623","0700-0759",2023-04-28,76,5,51,127
"33624","0700-0759",2023-04-29,73,6,41,114
"33625","0700-0759",2023-04-30,74,7,46,120
"33626","0800-0859",2023-04-01,90,6,40,130
"33627","0800-0859",2023-04-02,86,7,43,129
"33628","0800-0859",2023-04-03,96,1,47,143
"33629","0800-0859",2023-04-04,94,2,42,136
"33630","0800-0859",2023-04-05,93,3,46,139
"33631","0800-0859",2023-04-06,97,4,50,147
"33632","0800-0859",2023-04-07,97,5,50,147
"33633","0800-0859",2023-04-08,91,6,42,133
"33634","0800-0859",2023-04-09,88,7,45,133
"33635","0800-0859",2023-04-10,96,1,51,147
"33636","0800-0859",2023-04-11,102,2,51,153
"33637","0800-0859",2023-04-12,99,3,50,149
"33638","0800-0859",2023-04-13,104,4,52,156
"33639","0800-0859",2023-04-14,104,5,53,157
"33640","0800-0859",2023-04-15,92,6,46,138
"33641","0800-0859",2023-04-16,92,7,46,138
"33642","0800-0859",2023-04-17,103,1,54,157
"33643","0800-0859",2023-04-18,101,2,52,153
"33644","0800-0859",2023-04-19,98,3,50,148
"33645","0800-0859",2023-04-20,104,4,51,155
"33646","0800-0859",2023-04-21,103,5,52,155
"33647","0800-0859",2023-04-22,92,6,46,138
"33648","0800-0859",2023-04-23,92,7,45,137
"33649","0800-0859",2023-04-24,102,1,53,155
"33650","0800-0859",2023-04-25,101,2,51,152
"33651","0800-0859",2023-04-26,99,3,50,149
"33652","0800-0859",2023-04-27,103,4,52,155
"33653","0800-0859",2023-04-28,103,5,52,155
"33654","0800-0859",2023-04-29,92,6,46,138
"33655","0800-0859",2023-04-30,92,7,46,138
"33656","0900-0959",2023-04-01,41,6,52,93
"33657","0900-0959",2023-04-02,50,7,55,105
"33658","0900-0959",2023-04-03,45,1,56,101
"33659","0900-0959",2023-04-04,46,2,56,102
"33660","0900-0959",2023-04-05,47,3,55,102
"33661","0900-0959",2023-04-06,50,4,56,106
"33662","0900-0959",2023-04-07,49,5,55,104
"33663","0900-0959",2023-04-08,43,6,52,95
"33664","0900-0959",2023-04-09,52,7,53,105
"33665","0900-0959",2023-04-10,50,1,57,107
"33666","0900-0959",2023-04-11,50,2,59,109
"33667","0900-0959",2023-04-12,50,3,59,109
"33668","0900-0959",2023-04-13,52,4,63,115
"33669","0900-0959",2023-04-14,52,5,61,113
"33670","0900-0959",2023-04-15,42,6,53,95
"33671","0900-0959",2023-04-16,50,7,56,106
"33672","0900-0959",2023-04-17,54,1,62,116
"33673","0900-0959",2023-04-18,50,2,60,110
"33674","0900-0959",2023-04-19,51,3,61,112
"33675","0900-0959",2023-04-20,52,4,63,115
"33676","0900-0959",2023-04-21,53,5,62,115
"33677","0900-0959",2023-04-22,43,6,55,98
"33678","0900-0959",2023-04-23,49,7,57,106
"33679","0900-0959",2023-04-24,54,1,63,117
"33680","0900-0959",2023-04-25,50,2,60,110
"33681","0900-0959",2023-04-26,50,3,60,110
"33682","0900-0959",2023-04-27,52,4,63,115
"33683","0900-0959",2023-04-28,52,5,62,114
"33684","0900-0959",2023-04-29,43,6,55,98
"33685","0900-0959",2023-04-30,49,7,56,105
"33686","1000-1059",2023-04-01,54,6,37,91
"33687","1000-1059",2023-04-02,62,7,40,102
"33688","1000-1059",2023-04-03,68,1,42,110
"33689","1000-1059",2023-04-04,63,2,43,106
"33690","1000-1059",2023-04-05,63,3,42,105
"33691","1000-1059",2023-04-06,64,4,44,108
"33692","1000-1059",2023-04-07,63,5,44,107
"33693","1000-1059",2023-04-08,52,6,36,88
"33694","1000-1059",2023-04-09,57,7,41,98
"33695","1000-1059",2023-04-10,62,1,45,107
"33696","1000-1059",2023-04-11,64,2,42,106
"33697","1000-1059",2023-04-12,66,3,42,108
"33698","1000-1059",2023-04-13,66,4,43,109
"33699","1000-1059",2023-04-14,67,5,45,112
"33700","1000-1059",2023-04-15,57,6,41,98
"33701","1000-1059",2023-04-16,61,7,40,101
"33702","1000-1059",2023-04-17,67,1,45,112
"33703","1000-1059",2023-04-18,67,2,42,109
"33704","1000-1059",2023-04-19,68,3,41,109
"33705","1000-1059",2023-04-20,68,4,42,110
"33706","1000-1059",2023-04-21,69,5,44,113
"33707","1000-1059",2023-04-22,58,6,39,97
"33708","1000-1059",2023-04-23,64,7,40,104
"33709","1000-1059",2023-04-24,70,1,44,114
"33710","1000-1059",2023-04-25,68,2,42,110
"33711","1000-1059",2023-04-26,70,3,42,112
"33712","1000-1059",2023-04-27,69,4,42,111
"33713","1000-1059",2023-04-28,70,5,44,114
"33714","1000-1059",2023-04-29,58,6,40,98
"33715","1000-1059",2023-04-30,66,7,40,106
"33716","1100-1159",2023-04-01,47,6,66,113
"33717","1100-1159",2023-04-02,47,7,65,112
"33718","1100-1159",2023-04-03,55,1,67,122
"33719","1100-1159",2023-04-04,56,2,65,121
"33720","1100-1159",2023-04-05,57,3,62,119
"33721","1100-1159",2023-04-06,56,4,69,125
"33722","1100-1159",2023-04-07,56,5,68,124
"33723","1100-1159",2023-04-08,48,6,67,115
"33724","1100-1159",2023-04-09,48,7,65,113
"33725","1100-1159",2023-04-10,57,1,65,122
"33726","1100-1159",2023-04-11,55,2,71,126
"33727","1100-1159",2023-04-12,55,3,68,123
"33728","1100-1159",2023-04-13,54,4,74,128
"33729","1100-1159",2023-04-14,54,5,74,128
"33730","1100-1159",2023-04-15,51,6,59,110
"33731","1100-1159",2023-04-16,51,7,66,117
"33732","1100-1159",2023-04-17,55,1,76,131
"33733","1100-1159",2023-04-18,54,2,69,123
"33734","1100-1159",2023-04-19,56,3,67,123
"33735","1100-1159",2023-04-20,54,4,74,128
"33736","1100-1159",2023-04-21,54,5,74,128
"33737","1100-1159",2023-04-22,49,6,57,106
"33738","1100-1159",2023-04-23,52,7,65,117
"33739","1100-1159",2023-04-24,54,1,75,129
"33740","1100-1159",2023-04-25,55,2,70,125
"33741","1100-1159",2023-04-26,55,3,68,123
"33742","1100-1159",2023-04-27,53,4,74,127
"33743","1100-1159",2023-04-28,54,5,73,127
"33744","1100-1159",2023-04-29,50,6,57,107
"33745","1100-1159",2023-04-30,51,7,65,116
"33746","1200-1259",2023-04-01,47,6,44,91
"33747","1200-1259",2023-04-02,55,7,53,108
"33748","1200-1259",2023-04-03,55,1,51,106
"33749","1200-1259",2023-04-04,52,2,49,101
"33750","1200-1259",2023-04-05,52,3,50,102
"33751","1200-1259",2023-04-06,57,4,50,107
"33752","1200-1259",2023-04-07,55,5,50,105
"33753","1200-1259",2023-04-08,46,6,46,92
"33754","1200-1259",2023-04-09,52,7,52,104
"33755","1200-1259",2023-04-10,56,1,50,106
"33756","1200-1259",2023-04-11,55,2,48,103
"33757","1200-1259",2023-04-12,54,3,48,102
"33758","1200-1259",2023-04-13,61,4,51,112
"33759","1200-1259",2023-04-14,59,5,49,108
"33760","1200-1259",2023-04-15,50,6,53,103
"33761","1200-1259",2023-04-16,54,7,48,102
"33762","1200-1259",2023-04-17,60,1,49,109
"33763","1200-1259",2023-04-18,55,2,46,101
"33764","1200-1259",2023-04-19,53,3,46,99
"33765","1200-1259",2023-04-20,60,4,49,109
"33766","1200-1259",2023-04-21,59,5,47,106
"33767","1200-1259",2023-04-22,48,6,52,100
"33768","1200-1259",2023-04-23,52,7,46,98
"33769","1200-1259",2023-04-24,60,1,47,107
"33770","1200-1259",2023-04-25,55,2,46,101
"33771","1200-1259",2023-04-26,54,3,46,100
"33772","1200-1259",2023-04-27,61,4,48,109
"33773","1200-1259",2023-04-28,60,5,48,108
"33774","1200-1259",2023-04-29,49,6,52,101
"33775","1200-1259",2023-04-30,54,7,47,101
"33776","1300-1359",2023-04-01,48,6,38,86
"33777","1300-1359",2023-04-02,61,7,39,100
"33778","1300-1359",2023-04-03,63,1,44,107
"33779","1300-1359",2023-04-04,64,2,48,112
"33780","1300-1359",2023-04-05,64,3,44,108
"33781","1300-1359",2023-04-06,66,4,45,111
"33782","1300-1359",2023-04-07,67,5,45,112
"33783","1300-1359",2023-04-08,51,6,35,86
"33784","1300-1359",2023-04-09,62,7,38,100
"33785","1300-1359",2023-04-10,65,1,47,112
"33786","1300-1359",2023-04-11,61,2,50,111
"33787","1300-1359",2023-04-12,62,3,50,112
"33788","1300-1359",2023-04-13,65,4,52,117
"33789","1300-1359",2023-04-14,66,5,52,118
"33790","1300-1359",2023-04-15,55,6,40,95
"33791","1300-1359",2023-04-16,61,7,43,104
"33792","1300-1359",2023-04-17,64,1,51,115
"33793","1300-1359",2023-04-18,62,2,56,118
"33794","1300-1359",2023-04-19,64,3,55,119
"33795","1300-1359",2023-04-20,64,4,56,120
"33796","1300-1359",2023-04-21,64,5,56,120
"33797","1300-1359",2023-04-22,54,6,41,95
"33798","1300-1359",2023-04-23,60,7,48,108
"33799","1300-1359",2023-04-24,63,1,56,119
"33800","1300-1359",2023-04-25,62,2,56,118
"33801","1300-1359",2023-04-26,63,3,56,119
"33802","1300-1359",2023-04-27,64,4,56,120
"33803","1300-1359",2023-04-28,64,5,56,120
"33804","1300-1359",2023-04-29,54,6,41,95
"33805","1300-1359",2023-04-30,59,7,48,107
"33806","1400-1459",2023-04-01,40,6,51,91
"33807","1400-1459",2023-04-02,43,7,53,96
"33808","1400-1459",2023-04-03,45,1,58,103
"33809","1400-1459",2023-04-04,41,2,54,95
"33810","1400-1459",2023-04-05,40,3,53,93
"33811","1400-1459",2023-04-06,43,4,59,102
"33812","1400-1459",2023-04-07,40,5,58,98
"33813","1400-1459",2023-04-08,36,6,49,85
"33814","1400-1459",2023-04-09,39,7,51,90
"33815","1400-1459",2023-04-10,41,1,58,99
"33816","1400-1459",2023-04-11,40,2,56,96
"33817","1400-1459",2023-04-12,41,3,56,97
"33818","1400-1459",2023-04-13,45,4,60,105
"33819","1400-1459",2023-04-14,41,5,59,100
"33820","1400-1459",2023-04-15,38,6,53,91
"33821","1400-1459",2023-04-16,44,7,55,99
"33822","1400-1459",2023-04-17,42,1,58,100
"33823","1400-1459",2023-04-18,44,2,52,96
"33824","1400-1459",2023-04-19,45,3,53,98
"33825","1400-1459",2023-04-20,50,4,56,106
"33826","1400-1459",2023-04-21,47,5,55,102
"33827","1400-1459",2023-04-22,41,6,48,89
"33828","1400-1459",2023-04-23,48,7,52,100
"33829","1400-1459",2023-04-24,47,1,54,101
"33830","1400-1459",2023-04-25,44,2,53,97
"33831","1400-1459",2023-04-26,45,3,53,98
"33832","1400-1459",2023-04-27,49,4,56,105
"33833","1400-1459",2023-04-28,47,5,55,102
"33834","1400-1459",2023-04-29,41,6,49,90
"33835","1400-1459",2023-04-30,48,7,52,100
"33836","1500-1559",2023-04-01,47,6,53,100
"33837","1500-1559",2023-04-02,50,7,61,111
"33838","1500-1559",2023-04-03,58,1,60,118
"33839","1500-1559",2023-04-04,56,2,62,118
"33840","1500-1559",2023-04-05,57,3,64,121
"33841","1500-1559",2023-04-06,57,4,59,116
"33842","1500-1559",2023-04-07,60,5,58,118
"33843","1500-1559",2023-04-08,49,6,55,104
"33844","1500-1559",2023-04-09,52,7,59,111
"33845","1500-1559",2023-04-10,62,1,60,122
"33846","1500-1559",2023-04-11,57,2,62,119
"33847","1500-1559",2023-04-12,58,3,63,121
"33848","1500-1559",2023-04-13,59,4,61,120
"33849","1500-1559",2023-04-14,61,5,60,121
"33850","1500-1559",2023-04-15,51,6,53,104
"33851","1500-1559",2023-04-16,52,7,58,110
"33852","1500-1559",2023-04-17,60,1,63,123
"33853","1500-1559",2023-04-18,57,2,64,121
"33854","1500-1559",2023-04-19,58,3,65,123
"33855","1500-1559",2023-04-20,57,4,64,121
"33856","1500-1559",2023-04-21,58,5,64,122
"33857","1500-1559",2023-04-22,50,6,56,106
"33858","1500-1559",2023-04-23,52,7,60,112
"33859","1500-1559",2023-04-24,61,1,66,127
"33860","1500-1559",2023-04-25,57,2,64,121
"33861","1500-1559",2023-04-26,58,3,65,123
"33862","1500-1559",2023-04-27,57,4,65,122
"33863","1500-1559",2023-04-28,59,5,64,123
"33864","1500-1559",2023-04-29,51,6,56,107
"33865","1500-1559",2023-04-30,52,7,60,112
"33866","1600-1659",2023-04-01,56,6,47,103
"33867","1600-1659",2023-04-02,60,7,53,113
"33868","1600-1659",2023-04-03,60,1,55,115
"33869","1600-1659",2023-04-04,59,2,53,112
"33870","1600-1659",2023-04-05,55,3,54,109
"33871","1600-1659",2023-04-06,61,4,59,120
"33872","1600-1659",2023-04-07,62,5,59,121
"33873","1600-1659",2023-04-08,57,6,49,106
"33874","1600-1659",2023-04-09,64,7,56,120
"33875","1600-1659",2023-04-10,64,1,55,119
"33876","1600-1659",2023-04-11,67,2,51,118
"33877","1600-1659",2023-04-12,67,3,51,118
"33878","1600-1659",2023-04-13,71,4,57,128
"33879","1600-1659",2023-04-14,71,5,56,127
"33880","1600-1659",2023-04-15,61,6,49,110
"33881","1600-1659",2023-04-16,66,7,60,126
"33882","1600-1659",2023-04-17,71,1,54,125
"33883","1600-1659",2023-04-18,66,2,53,119
"33884","1600-1659",2023-04-19,67,3,54,121
"33885","1600-1659",2023-04-20,71,4,57,128
"33886","1600-1659",2023-04-21,70,5,56,126
"33887","1600-1659",2023-04-22,63,6,50,113
"33888","1600-1659",2023-04-23,66,7,58,124
"33889","1600-1659",2023-04-24,71,1,54,125
"33890","1600-1659",2023-04-25,66,2,53,119
"33891","1600-1659",2023-04-26,67,3,53,120
"33892","1600-1659",2023-04-27,71,4,56,127
"33893","1600-1659",2023-04-28,70,5,56,126
"33894","1600-1659",2023-04-29,63,6,50,113
"33895","1600-1659",2023-04-30,66,7,58,124
"33896","1700-1759",2023-04-01,55,6,39,94
"33897","1700-1759",2023-04-02,55,7,46,101
"33898","1700-1759",2023-04-03,59,1,46,105
"33899","1700-1759",2023-04-04,54,2,47,101
"33900","1700-1759",2023-04-05,57,3,49,106
"33901","1700-1759",2023-04-06,61,4,50,111
"33902","1700-1759",2023-04-07,60,5,49,109
"33903","1700-1759",2023-04-08,54,6,41,95
"33904","1700-1759",2023-04-09,57,7,48,105
"33905","1700-1759",2023-04-10,62,1,55,117
"33906","1700-1759",2023-04-11,54,2,52,106
"33907","1700-1759",2023-04-12,55,3,53,108
"33908","1700-1759",2023-04-13,61,4,54,115
"33909","1700-1759",2023-04-14,59,5,54,113
"33910","1700-1759",2023-04-15,54,6,52,106
"33911","1700-1759",2023-04-16,58,7,50,108
"33912","1700-1759",2023-04-17,59,1,54,113
"33913","1700-1759",2023-04-18,52,2,54,106
"33914","1700-1759",2023-04-19,53,3,55,108
"33915","1700-1759",2023-04-20,59,4,56,115
"33916","1700-1759",2023-04-21,58,5,56,114
"33917","1700-1759",2023-04-22,54,6,55,109
"33918","1700-1759",2023-04-23,57,7,54,111
"33919","1700-1759",2023-04-24,56,1,57,113
"33920","1700-1759",2023-04-25,51,2,54,105
"33921","1700-1759",2023-04-26,53,3,55,108
"33922","1700-1759",2023-04-27,58,4,56,114
"33923","1700-1759",2023-04-28,58,5,57,115
"33924","1700-1759",2023-04-29,53,6,55,108
"33925","1700-1759",2023-04-30,57,7,54,111
"33926","1800-1859",2023-04-01,55,6,62,117
"33927","1800-1859",2023-04-02,68,7,73,141
"33928","1800-1859",2023-04-03,65,1,80,145
"33929","1800-1859",2023-04-04,53,2,74,127
"33930","1800-1859",2023-04-05,58,3,74,132
"33931","1800-1859",2023-04-06,65,4,80,145
"33932","1800-1859",2023-04-07,63,5,80,143
"33933","1800-1859",2023-04-08,50,6,64,114
"33934","1800-1859",2023-04-09,66,7,74,140
"33935","1800-1859",2023-04-10,61,1,78,139
"33936","1800-1859",2023-04-11,66,2,77,143
"33937","1800-1859",2023-04-12,68,3,79,147
"33938","1800-1859",2023-04-13,75,4,84,159
"33939","1800-1859",2023-04-14,71,5,83,154
"33940","1800-1859",2023-04-15,61,6,66,127
"33941","1800-1859",2023-04-16,64,7,75,139
"33942","1800-1859",2023-04-17,69,1,82,151
"33943","1800-1859",2023-04-18,69,2,77,146
"33944","1800-1859",2023-04-19,70,3,79,149
"33945","1800-1859",2023-04-20,75,4,83,158
"33946","1800-1859",2023-04-21,70,5,80,150
"33947","1800-1859",2023-04-22,63,6,70,133
"33948","1800-1859",2023-04-23,64,7,75,139
"33949","1800-1859",2023-04-24,71,1,80,151
"33950","1800-1859",2023-04-25,69,2,76,145
"33951","1800-1859",2023-04-26,70,3,79,149
"33952","1800-1859",2023-04-27,74,4,82,156
"33953","1800-1859",2023-04-28,71,5,80,151
"33954","1800-1859",2023-04-29,64,6,70,134
"33955","1800-1859",2023-04-30,63,7,75,138
"33956","1900-1959",2023-04-01,43,6,42,85
"33957","1900-1959",2023-04-02,53,7,45,98
"33958","1900-1959",2023-04-03,56,1,49,105
"33959","1900-1959",2023-04-04,55,2,47,102
"33960","1900-1959",2023-04-05,55,3,49,104
"33961","1900-1959",2023-04-06,62,4,54,116
"33962","1900-1959",2023-04-07,63,5,52,115
"33963","1900-1959",2023-04-08,46,6,43,89
"33964","1900-1959",2023-04-09,58,7,51,109
"33965","1900-1959",2023-04-10,62,1,54,116
"33966","1900-1959",2023-04-11,49,2,52,101
"33967","1900-1959",2023-04-12,51,3,52,103
"33968","1900-1959",2023-04-13,61,4,56,117
"33969","1900-1959",2023-04-14,62,5,55,117
"33970","1900-1959",2023-04-15,41,6,46,87
"33971","1900-1959",2023-04-16,58,7,53,111
"33972","1900-1959",2023-04-17,60,1,54,114
"33973","1900-1959",2023-04-18,50,2,52,102
"33974","1900-1959",2023-04-19,52,3,54,106
"33975","1900-1959",2023-04-20,61,4,55,116
"33976","1900-1959",2023-04-21,61,5,55,116
"33977","1900-1959",2023-04-22,43,6,46,89
"33978","1900-1959",2023-04-23,58,7,52,110
"33979","1900-1959",2023-04-24,60,1,55,115
"33980","1900-1959",2023-04-25,49,2,52,101
"33981","1900-1959",2023-04-26,52,3,53,105
"33982","1900-1959",2023-04-27,61,4,54,115
"33983","1900-1959",2023-04-28,61,5,55,116
"33984","1900-1959",2023-04-29,43,6,47,90
"33985","1900-1959",2023-04-30,59,7,51,110
"33986","2000-2059",2023-04-01,43,6,76,119
"33987","2000-2059",2023-04-02,54,7,82,136
"33988","2000-2059",2023-04-03,49,1,80,129
"33989","2000-2059",2023-04-04,40,2,71,111
"33990","2000-2059",2023-04-05,42,3,69,111
"33991","2000-2059",2023-04-06,50,4,75,125
"33992","2000-2059",2023-04-07,48,5,77,125
"33993","2000-2059",2023-04-08,38,6,71,109
"33994","2000-2059",2023-04-09,53,7,76,129
"33995","2000-2059",2023-04-10,45,1,77,122
"33996","2000-2059",2023-04-11,46,2,73,119
"33997","2000-2059",2023-04-12,48,3,74,122
"33998","2000-2059",2023-04-13,54,4,81,135
"33999","2000-2059",2023-04-14,51,5,83,134
"34000","2000-2059",2023-04-15,32,6,73,105
"34001","2000-2059",2023-04-16,46,7,73,119
"34002","2000-2059",2023-04-17,51,1,83,134
"34003","2000-2059",2023-04-18,44,2,73,117
"34004","2000-2059",2023-04-19,47,3,72,119
"34005","2000-2059",2023-04-20,52,4,80,132
"34006","2000-2059",2023-04-21,51,5,81,132
"34007","2000-2059",2023-04-22,33,6,70,103
"34008","2000-2059",2023-04-23,45,7,71,116
"34009","2000-2059",2023-04-24,50,1,81,131
"34010","2000-2059",2023-04-25,45,2,72,117
"34011","2000-2059",2023-04-26,47,3,72,119
"34012","2000-2059",2023-04-27,52,4,80,132
"34013","2000-2059",2023-04-28,52,5,82,134
"34014","2000-2059",2023-04-29,34,6,70,104
"34015","2000-2059",2023-04-30,46,7,73,119
"34016","2100-2159",2023-04-01,40,6,61,101
"34017","2100-2159",2023-04-02,42,7,63,105
"34018","2100-2159",2023-04-03,42,1,66,108
"34019","2100-2159",2023-04-04,36,2,59,95
"34020","2100-2159",2023-04-05,39,3,59,98
"34021","2100-2159",2023-04-06,48,4,64,112
"34022","2100-2159",2023-04-07,48,5,64,112
"34023","2100-2159",2023-04-08,39,6,56,95
"34024","2100-2159",2023-04-09,41,7,63,104
"34025","2100-2159",2023-04-10,49,1,65,114
"34026","2100-2159",2023-04-11,38,2,62,100
"34027","2100-2159",2023-04-12,40,3,64,104
"34028","2100-2159",2023-04-13,49,4,68,117
"34029","2100-2159",2023-04-14,50,5,66,116
"34030","2100-2159",2023-04-15,36,6,62,98
"34031","2100-2159",2023-04-16,51,7,62,113
"34032","2100-2159",2023-04-17,49,1,67,116
"34033","2100-2159",2023-04-18,41,2,66,107
"34034","2100-2159",2023-04-19,44,3,69,113
"34035","2100-2159",2023-04-20,52,4,72,124
"34036","2100-2159",2023-04-21,52,5,69,121
"34037","2100-2159",2023-04-22,37,6,68,105
"34038","2100-2159",2023-04-23,52,7,66,118
"34039","2100-2159",2023-04-24,51,1,71,122
"34040","2100-2159",2023-04-25,41,2,66,107
"34041","2100-2159",2023-04-26,44,3,68,112
"34042","2100-2159",2023-04-27,52,4,71,123
"34043","2100-2159",2023-04-28,50,5,70,120
"34044","2100-2159",2023-04-29,36,6,67,103
"34045","2100-2159",2023-04-30,52,7,66,118
"34046","2200-2259",2023-04-01,28,6,51,79
"34047","2200-2259",2023-04-02,45,7,66,111
"34048","2200-2259",2023-04-03,42,1,66,108
"34049","2200-2259",2023-04-04,36,2,57,93
"34050","2200-2259",2023-04-05,39,3,60,99
"34051","2200-2259",2023-04-06,43,4,70,113
"34052","2200-2259",2023-04-07,42,5,69,111
"34053","2200-2259",2023-04-08,27,6,51,78
"34054","2200-2259",2023-04-09,46,7,68,114
"34055","2200-2259",2023-04-10,39,1,69,108
"34056","2200-2259",2023-04-11,35,2,55,90
"34057","2200-2259",2023-04-12,40,3,57,97
"34058","2200-2259",2023-04-13,41,4,72,113
"34059","2200-2259",2023-04-14,41,5,71,112
"34060","2200-2259",2023-04-15,25,6,44,69
"34061","2200-2259",2023-04-16,44,7,72,116
"34062","2200-2259",2023-04-17,40,1,69,109
"34063","2200-2259",2023-04-18,33,2,54,87
"34064","2200-2259",2023-04-19,36,3,55,91
"34065","2200-2259",2023-04-20,40,4,69,109
"34066","2200-2259",2023-04-21,39,5,69,108
"34067","2200-2259",2023-04-22,26,6,44,70
"34068","2200-2259",2023-04-23,44,7,69,113
"34069","2200-2259",2023-04-24,38,1,68,106
"34070","2200-2259",2023-04-25,33,2,54,87
"34071","2200-2259",2023-04-26,36,3,56,92
"34072","2200-2259",2023-04-27,40,4,70,110
"34073","2200-2259",2023-04-28,39,5,69,108
"34074","2200-2259",2023-04-29,26,6,46,72
"34075","2200-2259",2023-04-30,44,7,69,113
"34076","2300-2359",2023-04-01,22,6,52,74
"34077","2300-2359",2023-04-02,23,7,64,87
"34078","2300-2359",2023-04-03,22,1,61,83
"34079","2300-2359",2023-04-04,22,2,57,79
"34080","2300-2359",2023-04-05,21,3,60,81
"34081","2300-2359",2023-04-06,22,4,70,92
"34082","2300-2359",2023-04-07,22,5,68,90
"34083","2300-2359",2023-04-08,21,6,51,72
"34084","2300-2359",2023-04-09,23,7,68,91
"34085","2300-2359",2023-04-10,22,1,64,86
"34086","2300-2359",2023-04-11,19,2,60,79
"34087","2300-2359",2023-04-12,19,3,62,81
"34088","2300-2359",2023-04-13,22,4,69,91
"34089","2300-2359",2023-04-14,22,5,66,88
"34090","2300-2359",2023-04-15,21,6,48,69
"34091","2300-2359",2023-04-16,23,7,66,89
"34092","2300-2359",2023-04-17,21,1,64,85
"34093","2300-2359",2023-04-18,18,2,58,76
"34094","2300-2359",2023-04-19,19,3,61,80
"34095","2300-2359",2023-04-20,21,4,67,88
"34096","2300-2359",2023-04-21,22,5,64,86
"34097","2300-2359",2023-04-22,20,6,46,66
"34098","2300-2359",2023-04-23,22,7,66,88
"34099","2300-2359",2023-04-24,22,1,62,84
"34100","2300-2359",2023-04-25,18,2,58,76
"34101","2300-2359",2023-04-26,19,3,61,80
"34102","2300-2359",2023-04-27,21,4,67,88
"34103","2300-2359",2023-04-28,22,5,63,85
"34104","2300-2359",2023-04-29,20,6,46,66
"34105","2300-2359",2023-04-30,21,7,66,87
"34106","0001-0559",2023-05-01,32,1,51,83
"34107","0001-0559",2023-05-02,31,2,46,77
"34108","0001-0559",2023-05-03,30,3,49,79
"34109","0001-0559",2023-05-04,30,4,58,88
"34110","0001-0559",2023-05-05,33,5,58,91
"34111","0001-0559",2023-05-06,18,6,42,60
"34112","0001-0559",2023-05-07,26,7,61,87
"34113","0001-0559",2023-05-08,31,1,55,86
"34114","0001-0559",2023-05-09,32,2,51,83
"34115","0001-0559",2023-05-10,31,3,55,86
"34116","0001-0559",2023-05-11,32,4,57,89
"34117","0001-0559",2023-05-12,32,5,56,88
"34118","0001-0559",2023-05-13,18,6,42,60
"34119","0001-0559",2023-05-14,27,7,58,85
"34120","0001-0559",2023-05-15,32,1,56,88
"34121","0001-0559",2023-05-16,32,2,51,83
"34122","0001-0559",2023-05-17,31,3,55,86
"34123","0001-0559",2023-05-18,31,4,58,89
"34124","0001-0559",2023-05-19,31,5,58,89
"34125","0001-0559",2023-05-20,17,6,42,59
"34126","0001-0559",2023-05-21,26,7,58,84
"34127","0001-0559",2023-05-22,31,1,58,89
"34128","0001-0559",2023-05-23,31,2,52,83
"34129","0001-0559",2023-05-24,29,3,56,85
"34130","0001-0559",2023-05-25,30,4,59,89
"34131","0001-0559",2023-05-26,31,5,58,89
"34132","0001-0559",2023-05-27,17,6,42,59
"34133","0001-0559",2023-05-28,19,7,50,69
"34134","0001-0559",2023-05-29,30,1,58,88
"34135","0001-0559",2023-05-30,31,2,53,84
"34136","0001-0559",2023-05-31,29,3,58,87
"34137","0600-0659",2023-05-01,77,1,28,105
"34138","0600-0659",2023-05-02,73,2,24,97
"34139","0600-0659",2023-05-03,74,3,26,100
"34140","0600-0659",2023-05-04,78,4,25,103
"34141","0600-0659",2023-05-05,80,5,27,107
"34142","0600-0659",2023-05-06,79,6,18,97
"34143","0600-0659",2023-05-07,75,7,24,99
"34144","0600-0659",2023-05-08,78,1,26,104
"34145","0600-0659",2023-05-09,73,2,21,94
"34146","0600-0659",2023-05-10,75,3,22,97
"34147","0600-0659",2023-05-11,77,4,27,104
"34148","0600-0659",2023-05-12,78,5,28,106
"34149","0600-0659",2023-05-13,78,6,17,95
"34150","0600-0659",2023-05-14,74,7,26,100
"34151","0600-0659",2023-05-15,78,1,27,105
"34152","0600-0659",2023-05-16,73,2,21,94
"34153","0600-0659",2023-05-17,75,3,21,96
"34154","0600-0659",2023-05-18,74,4,27,101
"34155","0600-0659",2023-05-19,75,5,28,103
"34156","0600-0659",2023-05-20,77,6,18,95
"34157","0600-0659",2023-05-21,71,7,26,97
"34158","0600-0659",2023-05-22,75,1,26,101
"34159","0600-0659",2023-05-23,73,2,21,94
"34160","0600-0659",2023-05-24,74,3,21,95
"34161","0600-0659",2023-05-25,74,4,27,101
"34162","0600-0659",2023-05-26,77,5,28,105
"34163","0600-0659",2023-05-27,77,6,17,94
"34164","0600-0659",2023-05-28,70,7,21,91
"34165","0600-0659",2023-05-29,77,1,26,103
"34166","0600-0659",2023-05-30,73,2,21,94
"34167","0600-0659",2023-05-31,74,3,20,94
"34168","0700-0759",2023-05-01,76,1,51,127
"34169","0700-0759",2023-05-02,74,2,45,119
"34170","0700-0759",2023-05-03,72,3,46,118
"34171","0700-0759",2023-05-04,76,4,49,125
"34172","0700-0759",2023-05-05,83,5,51,134
"34173","0700-0759",2023-05-06,78,6,42,120
"34174","0700-0759",2023-05-07,80,7,47,127
"34175","0700-0759",2023-05-08,84,1,54,138
"34176","0700-0759",2023-05-09,82,2,49,131
"34177","0700-0759",2023-05-10,81,3,48,129
"34178","0700-0759",2023-05-11,84,4,53,137
"34179","0700-0759",2023-05-12,83,5,52,135
"34180","0700-0759",2023-05-13,76,6,44,120
"34181","0700-0759",2023-05-14,80,7,48,128
"34182","0700-0759",2023-05-15,83,1,53,136
"34183","0700-0759",2023-05-16,82,2,49,131
"34184","0700-0759",2023-05-17,81,3,48,129
"34185","0700-0759",2023-05-18,87,4,52,139
"34186","0700-0759",2023-05-19,87,5,50,137
"34187","0700-0759",2023-05-20,79,6,43,122
"34188","0700-0759",2023-05-21,83,7,48,131
"34189","0700-0759",2023-05-22,86,1,51,137
"34190","0700-0759",2023-05-23,84,2,49,133
"34191","0700-0759",2023-05-24,83,3,48,131
"34192","0700-0759",2023-05-25,86,4,52,138
"34193","0700-0759",2023-05-26,86,5,51,137
"34194","0700-0759",2023-05-27,79,6,43,122
"34195","0700-0759",2023-05-28,77,7,42,119
"34196","0700-0759",2023-05-29,86,1,51,137
"34197","0700-0759",2023-05-30,84,2,49,133
"34198","0700-0759",2023-05-31,83,3,48,131
"34199","0800-0859",2023-05-01,103,1,53,156
"34200","0800-0859",2023-05-02,101,2,51,152
"34201","0800-0859",2023-05-03,99,3,50,149
"34202","0800-0859",2023-05-04,104,4,52,156
"34203","0800-0859",2023-05-05,99,5,51,150
"34204","0800-0859",2023-05-06,88,6,44,132
"34205","0800-0859",2023-05-07,90,7,46,136
"34206","0800-0859",2023-05-08,98,1,52,150
"34207","0800-0859",2023-05-09,94,2,50,144
"34208","0800-0859",2023-05-10,95,3,51,146
"34209","0800-0859",2023-05-11,99,4,50,149
"34210","0800-0859",2023-05-12,98,5,52,150
"34211","0800-0859",2023-05-13,84,6,43,127
"34212","0800-0859",2023-05-14,88,7,46,134
"34213","0800-0859",2023-05-15,99,1,52,151
"34214","0800-0859",2023-05-16,95,2,50,145
"34215","0800-0859",2023-05-17,96,3,52,148
"34216","0800-0859",2023-05-18,97,4,49,146
"34217","0800-0859",2023-05-19,96,5,51,147
"34218","0800-0859",2023-05-20,82,6,42,124
"34219","0800-0859",2023-05-21,86,7,44,130
"34220","0800-0859",2023-05-22,97,1,51,148
"34221","0800-0859",2023-05-23,92,2,49,141
"34222","0800-0859",2023-05-24,94,3,50,144
"34223","0800-0859",2023-05-25,99,4,49,148
"34224","0800-0859",2023-05-26,96,5,52,148
"34225","0800-0859",2023-05-27,82,6,42,124
"34226","0800-0859",2023-05-28,87,7,40,127
"34227","0800-0859",2023-05-29,96,1,52,148
"34228","0800-0859",2023-05-30,93,2,49,142
"34229","0800-0859",2023-05-31,95,3,49,144
"34230","0900-0959",2023-05-01,52,1,62,114
"34231","0900-0959",2023-05-02,50,2,61,111
"34232","0900-0959",2023-05-03,50,3,61,111
"34233","0900-0959",2023-05-04,51,4,64,115
"34234","0900-0959",2023-05-05,51,5,64,115
"34235","0900-0959",2023-05-06,44,6,59,103
"34236","0900-0959",2023-05-07,49,7,58,107
"34237","0900-0959",2023-05-08,54,1,58,112
"34238","0900-0959",2023-05-09,52,2,55,107
"34239","0900-0959",2023-05-10,52,3,55,107
"34240","0900-0959",2023-05-11,53,4,58,111
"34241","0900-0959",2023-05-12,54,5,58,112
"34242","0900-0959",2023-05-13,47,6,53,100
"34243","0900-0959",2023-05-14,52,7,53,105
"34244","0900-0959",2023-05-15,54,1,58,112
"34245","0900-0959",2023-05-16,52,2,55,107
"34246","0900-0959",2023-05-17,52,3,54,106
"34247","0900-0959",2023-05-18,53,4,59,112
"34248","0900-0959",2023-05-19,54,5,57,111
"34249","0900-0959",2023-05-20,46,6,55,101
"34250","0900-0959",2023-05-21,52,7,55,107
"34251","0900-0959",2023-05-22,52,1,57,109
"34252","0900-0959",2023-05-23,50,2,57,107
"34253","0900-0959",2023-05-24,51,3,56,107
"34254","0900-0959",2023-05-25,52,4,59,111
"34255","0900-0959",2023-05-26,55,5,57,112
"34256","0900-0959",2023-05-27,46,6,55,101
"34257","0900-0959",2023-05-28,53,7,51,104
"34258","0900-0959",2023-05-29,55,1,57,112
"34259","0900-0959",2023-05-30,50,2,57,107
"34260","0900-0959",2023-05-31,51,3,56,107
"34261","1000-1059",2023-05-01,70,1,43,113
"34262","1000-1059",2023-05-02,68,2,41,109
"34263","1000-1059",2023-05-03,70,3,41,111
"34264","1000-1059",2023-05-04,71,4,41,112
"34265","1000-1059",2023-05-05,78,5,49,127
"34266","1000-1059",2023-05-06,68,6,43,111
"34267","1000-1059",2023-05-07,75,7,45,120
"34268","1000-1059",2023-05-08,77,1,49,126
"34269","1000-1059",2023-05-09,75,2,49,124
"34270","1000-1059",2023-05-10,78,3,49,127
"34271","1000-1059",2023-05-11,76,4,49,125
"34272","1000-1059",2023-05-12,78,5,49,127
"34273","1000-1059",2023-05-13,68,6,45,113
"34274","1000-1059",2023-05-14,71,7,47,118
"34275","1000-1059",2023-05-15,78,1,50,128
"34276","1000-1059",2023-05-16,75,2,50,125
"34277","1000-1059",2023-05-17,77,3,50,127
"34278","1000-1059",2023-05-18,75,4,50,125
"34279","1000-1059",2023-05-19,76,5,53,129
"34280","1000-1059",2023-05-20,69,6,49,118
"34281","1000-1059",2023-05-21,72,7,47,119
"34282","1000-1059",2023-05-22,77,1,53,130
"34283","1000-1059",2023-05-23,75,2,52,127
"34284","1000-1059",2023-05-24,76,3,52,128
"34285","1000-1059",2023-05-25,75,4,52,127
"34286","1000-1059",2023-05-26,75,5,53,128
"34287","1000-1059",2023-05-27,69,6,49,118
"34288","1000-1059",2023-05-28,68,7,48,116
"34289","1000-1059",2023-05-29,75,1,53,128
"34290","1000-1059",2023-05-30,75,2,52,127
"34291","1000-1059",2023-05-31,77,3,52,129
"34292","1100-1159",2023-05-01,54,1,73,127
"34293","1100-1159",2023-05-02,55,2,70,125
"34294","1100-1159",2023-05-03,55,3,68,123
"34295","1100-1159",2023-05-04,52,4,73,125
"34296","1100-1159",2023-05-05,47,5,75,122
"34297","1100-1159",2023-05-06,43,6,59,102
"34298","1100-1159",2023-05-07,45,7,68,113
"34299","1100-1159",2023-05-08,49,1,76,125
"34300","1100-1159",2023-05-09,51,2,74,125
"34301","1100-1159",2023-05-10,51,3,73,124
"34302","1100-1159",2023-05-11,51,4,76,127
"34303","1100-1159",2023-05-12,49,5,76,125
"34304","1100-1159",2023-05-13,43,6,59,102
"34305","1100-1159",2023-05-14,48,7,67,115
"34306","1100-1159",2023-05-15,49,1,76,125
"34307","1100-1159",2023-05-16,51,2,74,125
"34308","1100-1159",2023-05-17,51,3,73,124
"34309","1100-1159",2023-05-18,51,4,72,123
"34310","1100-1159",2023-05-19,51,5,73,124
"34311","1100-1159",2023-05-20,42,6,55,97
"34312","1100-1159",2023-05-21,50,7,65,115
"34313","1100-1159",2023-05-22,51,1,73,124
"34314","1100-1159",2023-05-23,52,2,70,122
"34315","1100-1159",2023-05-24,52,3,70,122
"34316","1100-1159",2023-05-25,52,4,72,124
"34317","1100-1159",2023-05-26,53,5,75,128
"34318","1100-1159",2023-05-27,43,6,55,98
"34319","1100-1159",2023-05-28,55,7,64,119
"34320","1100-1159",2023-05-29,52,1,75,127
"34321","1100-1159",2023-05-30,52,2,70,122
"34322","1100-1159",2023-05-31,53,3,70,123
"34323","1200-1259",2023-05-01,60,1,49,109
"34324","1200-1259",2023-05-02,55,2,47,102
"34325","1200-1259",2023-05-03,54,3,47,101
"34326","1200-1259",2023-05-04,60,4,48,108
"34327","1200-1259",2023-05-05,68,5,48,116
"34328","1200-1259",2023-05-06,54,6,52,106
"34329","1200-1259",2023-05-07,61,7,46,107
"34330","1200-1259",2023-05-08,67,1,47,114
"34331","1200-1259",2023-05-09,66,2,46,112
"34332","1200-1259",2023-05-10,65,3,47,112
"34333","1200-1259",2023-05-11,68,4,49,117
"34334","1200-1259",2023-05-12,67,5,47,114
"34335","1200-1259",2023-05-13,53,6,51,104
"34336","1200-1259",2023-05-14,60,7,47,107
"34337","1200-1259",2023-05-15,68,1,47,115
"34338","1200-1259",2023-05-16,66,2,46,112
"34339","1200-1259",2023-05-17,65,3,48,113
"34340","1200-1259",2023-05-18,68,4,48,116
"34341","1200-1259",2023-05-19,67,5,49,116
"34342","1200-1259",2023-05-20,54,6,52,106
"34343","1200-1259",2023-05-21,60,7,47,107
"34344","1200-1259",2023-05-22,68,1,48,116
"34345","1200-1259",2023-05-23,65,2,46,111
"34346","1200-1259",2023-05-24,65,3,47,112
"34347","1200-1259",2023-05-25,68,4,48,116
"34348","1200-1259",2023-05-26,68,5,48,116
"34349","1200-1259",2023-05-27,55,6,53,108
"34350","1200-1259",2023-05-28,57,7,51,108
"34351","1200-1259",2023-05-29,69,1,48,117
"34352","1200-1259",2023-05-30,65,2,46,111
"34353","1200-1259",2023-05-31,65,3,47,112
"34354","1300-1359",2023-05-01,63,1,55,118
"34355","1300-1359",2023-05-02,61,2,55,116
"34356","1300-1359",2023-05-03,62,3,55,117
"34357","1300-1359",2023-05-04,62,4,55,117
"34358","1300-1359",2023-05-05,63,5,56,119
"34359","1300-1359",2023-05-06,54,6,45,99
"34360","1300-1359",2023-05-07,56,7,48,104
"34361","1300-1359",2023-05-08,61,1,61,122
"34362","1300-1359",2023-05-09,58,2,60,118
"34363","1300-1359",2023-05-10,58,3,61,119
"34364","1300-1359",2023-05-11,62,4,61,123
"34365","1300-1359",2023-05-12,61,5,62,123
"34366","1300-1359",2023-05-13,57,6,49,106
"34367","1300-1359",2023-05-14,57,7,52,109
"34368","1300-1359",2023-05-15,62,1,62,124
"34369","1300-1359",2023-05-16,59,2,60,119
"34370","1300-1359",2023-05-17,59,3,60,119
"34371","1300-1359",2023-05-18,64,4,59,123
"34372","1300-1359",2023-05-19,64,5,59,123
"34373","1300-1359",2023-05-20,58,6,47,105
"34374","1300-1359",2023-05-21,58,7,51,109
"34375","1300-1359",2023-05-22,63,1,60,123
"34376","1300-1359",2023-05-23,59,2,57,116
"34377","1300-1359",2023-05-24,60,3,58,118
"34378","1300-1359",2023-05-25,63,4,59,122
"34379","1300-1359",2023-05-26,63,5,61,124
"34380","1300-1359",2023-05-27,58,6,46,104
"34381","1300-1359",2023-05-28,59,7,52,111
"34382","1300-1359",2023-05-29,63,1,61,124
"34383","1300-1359",2023-05-30,59,2,58,117
"34384","1300-1359",2023-05-31,60,3,59,119
"34385","1400-1459",2023-05-01,47,1,55,102
"34386","1400-1459",2023-05-02,44,2,53,97
"34387","1400-1459",2023-05-03,45,3,53,98
"34388","1400-1459",2023-05-04,51,4,57,108
"34389","1400-1459",2023-05-05,51,5,60,111
"34390","1400-1459",2023-05-06,43,6,55,98
"34391","1400-1459",2023-05-07,52,7,58,110
"34392","1400-1459",2023-05-08,48,1,57,105
"34393","1400-1459",2023-05-09,48,2,56,104
"34394","1400-1459",2023-05-10,50,3,56,106
"34395","1400-1459",2023-05-11,53,4,60,113
"34396","1400-1459",2023-05-12,50,5,57,107
"34397","1400-1459",2023-05-13,40,6,50,90
"34398","1400-1459",2023-05-14,50,7,53,103
"34399","1400-1459",2023-05-15,49,1,57,106
"34400","1400-1459",2023-05-16,48,2,56,104
"34401","1400-1459",2023-05-17,50,3,56,106
"34402","1400-1459",2023-05-18,49,4,63,112
"34403","1400-1459",2023-05-19,46,5,58,104
"34404","1400-1459",2023-05-20,36,6,51,87
"34405","1400-1459",2023-05-21,47,7,58,105
"34406","1400-1459",2023-05-22,45,1,58,103
"34407","1400-1459",2023-05-23,43,2,57,100
"34408","1400-1459",2023-05-24,46,3,58,104
"34409","1400-1459",2023-05-25,49,4,62,111
"34410","1400-1459",2023-05-26,47,5,58,105
"34411","1400-1459",2023-05-27,35,6,51,86
"34412","1400-1459",2023-05-28,44,7,59,103
"34413","1400-1459",2023-05-29,46,1,58,104
"34414","1400-1459",2023-05-30,44,2,57,101
"34415","1400-1459",2023-05-31,47,3,58,105
"34416","1500-1559",2023-05-01,61,1,66,127
"34417","1500-1559",2023-05-02,57,2,63,120
"34418","1500-1559",2023-05-03,57,3,64,121
"34419","1500-1559",2023-05-04,58,4,64,122
"34420","1500-1559",2023-05-05,63,5,62,125
"34421","1500-1559",2023-05-06,58,6,53,111
"34422","1500-1559",2023-05-07,58,7,57,115
"34423","1500-1559",2023-05-08,67,1,64,131
"34424","1500-1559",2023-05-09,64,2,58,122
"34425","1500-1559",2023-05-10,66,3,60,126
"34426","1500-1559",2023-05-11,65,4,62,127
"34427","1500-1559",2023-05-12,67,5,62,129
"34428","1500-1559",2023-05-13,59,6,53,112
"34429","1500-1559",2023-05-14,59,7,58,117
"34430","1500-1559",2023-05-15,68,1,63,131
"34431","1500-1559",2023-05-16,64,2,58,122
"34432","1500-1559",2023-05-17,66,3,59,125
"34433","1500-1559",2023-05-18,68,4,64,132
"34434","1500-1559",2023-05-19,65,5,63,128
"34435","1500-1559",2023-05-20,60,6,52,112
"34436","1500-1559",2023-05-21,62,7,57,119
"34437","1500-1559",2023-05-22,67,1,63,130
"34438","1500-1559",2023-05-23,65,2,57,122
"34439","1500-1559",2023-05-24,67,3,58,125
"34440","1500-1559",2023-05-25,67,4,63,130
"34441","1500-1559",2023-05-26,66,5,62,128
"34442","1500-1559",2023-05-27,61,6,53,114
"34443","1500-1559",2023-05-28,60,7,55,115
"34444","1500-1559",2023-05-29,68,1,63,131
"34445","1500-1559",2023-05-30,65,2,58,123
"34446","1500-1559",2023-05-31,68,3,61,129
"34447","1600-1659",2023-05-01,71,1,54,125
"34448","1600-1659",2023-05-02,65,2,53,118
"34449","1600-1659",2023-05-03,67,3,54,121
"34450","1600-1659",2023-05-04,70,4,57,127
"34451","1600-1659",2023-05-05,66,5,55,121
"34452","1600-1659",2023-05-06,58,6,48,106
"34453","1600-1659",2023-05-07,60,7,57,117
"34454","1600-1659",2023-05-08,68,1,58,126
"34455","1600-1659",2023-05-09,64,2,56,120
"34456","1600-1659",2023-05-10,65,3,57,122
"34457","1600-1659",2023-05-11,67,4,60,127
"34458","1600-1659",2023-05-12,66,5,61,127
"34459","1600-1659",2023-05-13,58,6,52,110
"34460","1600-1659",2023-05-14,62,7,60,122
"34461","1600-1659",2023-05-15,67,1,60,127
"34462","1600-1659",2023-05-16,64,2,56,120
"34463","1600-1659",2023-05-17,64,3,58,122
"34464","1600-1659",2023-05-18,67,4,56,123
"34465","1600-1659",2023-05-19,69,5,56,125
"34466","1600-1659",2023-05-20,56,6,47,103
"34467","1600-1659",2023-05-21,62,7,59,121
"34468","1600-1659",2023-05-22,70,1,57,127
"34469","1600-1659",2023-05-23,66,2,52,118
"34470","1600-1659",2023-05-24,66,3,55,121
"34471","1600-1659",2023-05-25,67,4,56,123
"34472","1600-1659",2023-05-26,67,5,57,124
"34473","1600-1659",2023-05-27,56,6,47,103
"34474","1600-1659",2023-05-28,57,7,54,111
"34475","1600-1659",2023-05-29,68,1,56,124
"34476","1600-1659",2023-05-30,66,2,52,118
"34477","1600-1659",2023-05-31,67,3,56,123
"34478","1700-1759",2023-05-01,56,1,57,113
"34479","1700-1759",2023-05-02,52,2,54,106
"34480","1700-1759",2023-05-03,52,3,54,106
"34481","1700-1759",2023-05-04,58,4,55,113
"34482","1700-1759",2023-05-05,59,5,56,115
"34483","1700-1759",2023-05-06,57,6,53,110
"34484","1700-1759",2023-05-07,60,7,52,112
"34485","1700-1759",2023-05-08,62,1,53,115
"34486","1700-1759",2023-05-09,56,2,56,112
"34487","1700-1759",2023-05-10,58,3,58,116
"34488","1700-1759",2023-05-11,63,4,53,116
"34489","1700-1759",2023-05-12,62,5,54,116
"34490","1700-1759",2023-05-13,58,6,53,111
"34491","1700-1759",2023-05-14,60,7,52,112
"34492","1700-1759",2023-05-15,61,1,54,115
"34493","1700-1759",2023-05-16,56,2,56,112
"34494","1700-1759",2023-05-17,58,3,58,116
"34495","1700-1759",2023-05-18,64,4,58,122
"34496","1700-1759",2023-05-19,64,5,57,121
"34497","1700-1759",2023-05-20,57,6,55,112
"34498","1700-1759",2023-05-21,60,7,56,116
"34499","1700-1759",2023-05-22,63,1,55,118
"34500","1700-1759",2023-05-23,57,2,59,116
"34501","1700-1759",2023-05-24,59,3,60,119
"34502","1700-1759",2023-05-25,64,4,58,122
"34503","1700-1759",2023-05-26,65,5,57,122
"34504","1700-1759",2023-05-27,57,6,57,114
"34505","1700-1759",2023-05-28,58,7,53,111
"34506","1700-1759",2023-05-29,64,1,56,120
"34507","1700-1759",2023-05-30,57,2,59,116
"34508","1700-1759",2023-05-31,60,3,60,120
"34509","1800-1859",2023-05-01,72,1,81,153
"34510","1800-1859",2023-05-02,70,2,76,146
"34511","1800-1859",2023-05-03,70,3,78,148
"34512","1800-1859",2023-05-04,72,4,84,156
"34513","1800-1859",2023-05-05,71,5,82,153
"34514","1800-1859",2023-05-06,63,6,68,131
"34515","1800-1859",2023-05-07,61,7,80,141
"34516","1800-1859",2023-05-08,72,1,84,156
"34517","1800-1859",2023-05-09,69,2,80,149
"34518","1800-1859",2023-05-10,70,3,83,153
"34519","1800-1859",2023-05-11,72,4,86,158
"34520","1800-1859",2023-05-12,72,5,82,154
"34521","1800-1859",2023-05-13,60,6,65,125
"34522","1800-1859",2023-05-14,63,7,76,139
"34523","1800-1859",2023-05-15,73,1,84,157
"34524","1800-1859",2023-05-16,69,2,81,150
"34525","1800-1859",2023-05-17,69,3,83,152
"34526","1800-1859",2023-05-18,72,4,87,159
"34527","1800-1859",2023-05-19,72,5,86,158
"34528","1800-1859",2023-05-20,60,6,66,126
"34529","1800-1859",2023-05-21,62,7,78,140
"34530","1800-1859",2023-05-22,72,1,87,159
"34531","1800-1859",2023-05-23,69,2,82,151
"34532","1800-1859",2023-05-24,70,3,84,154
"34533","1800-1859",2023-05-25,72,4,86,158
"34534","1800-1859",2023-05-26,73,5,83,156
"34535","1800-1859",2023-05-27,59,6,65,124
"34536","1800-1859",2023-05-28,55,7,74,129
"34537","1800-1859",2023-05-29,73,1,85,158
"34538","1800-1859",2023-05-30,69,2,82,151
"34539","1800-1859",2023-05-31,70,3,85,155
"34540","1900-1959",2023-05-01,61,1,55,116
"34541","1900-1959",2023-05-02,51,2,53,104
"34542","1900-1959",2023-05-03,52,3,53,105
"34543","1900-1959",2023-05-04,63,4,54,117
"34544","1900-1959",2023-05-05,63,5,59,122
"34545","1900-1959",2023-05-06,40,6,55,95
"34546","1900-1959",2023-05-07,61,7,54,115
"34547","1900-1959",2023-05-08,64,1,62,126
"34548","1900-1959",2023-05-09,54,2,56,110
"34549","1900-1959",2023-05-10,57,3,55,112
"34550","1900-1959",2023-05-11,64,4,59,123
"34551","1900-1959",2023-05-12,63,5,60,123
"34552","1900-1959",2023-05-13,42,6,58,100
"34553","1900-1959",2023-05-14,61,7,55,116
"34554","1900-1959",2023-05-15,64,1,60,124
"34555","1900-1959",2023-05-16,54,2,56,110
"34556","1900-1959",2023-05-17,57,3,55,112
"34557","1900-1959",2023-05-18,67,4,60,127
"34558","1900-1959",2023-05-19,66,5,62,128
"34559","1900-1959",2023-05-20,42,6,60,102
"34560","1900-1959",2023-05-21,64,7,54,118
"34561","1900-1959",2023-05-22,66,1,62,128
"34562","1900-1959",2023-05-23,56,2,58,114
"34563","1900-1959",2023-05-24,59,3,57,116
"34564","1900-1959",2023-05-25,67,4,62,129
"34565","1900-1959",2023-05-26,66,5,67,133
"34566","1900-1959",2023-05-27,42,6,61,103
"34567","1900-1959",2023-05-28,56,7,61,117
"34568","1900-1959",2023-05-29,66,1,67,133
"34569","1900-1959",2023-05-30,56,2,60,116
"34570","1900-1959",2023-05-31,57,3,60,117
"34571","2000-2059",2023-05-01,51,1,82,133
"34572","2000-2059",2023-05-02,45,2,73,118
"34573","2000-2059",2023-05-03,48,3,72,120
"34574","2000-2059",2023-05-04,55,4,80,135
"34575","2000-2059",2023-05-05,55,5,81,136
"34576","2000-2059",2023-05-06,38,6,70,108
"34577","2000-2059",2023-05-07,51,7,73,124
"34578","2000-2059",2023-05-08,51,1,82,133
"34579","2000-2059",2023-05-09,45,2,79,124
"34580","2000-2059",2023-05-10,47,3,78,125
"34581","2000-2059",2023-05-11,53,4,82,135
"34582","2000-2059",2023-05-12,52,5,83,135
"34583","2000-2059",2023-05-13,35,6,72,107
"34584","2000-2059",2023-05-14,47,7,76,123
"34585","2000-2059",2023-05-15,52,1,83,135
"34586","2000-2059",2023-05-16,45,2,79,124
"34587","2000-2059",2023-05-17,46,3,78,124
"34588","2000-2059",2023-05-18,54,4,79,133
"34589","2000-2059",2023-05-19,53,5,82,135
"34590","2000-2059",2023-05-20,37,6,68,105
"34591","2000-2059",2023-05-21,48,7,74,122
"34592","2000-2059",2023-05-22,53,1,83,136
"34593","2000-2059",2023-05-23,46,2,78,124
"34594","2000-2059",2023-05-24,48,3,78,126
"34595","2000-2059",2023-05-25,53,4,79,132
"34596","2000-2059",2023-05-26,55,5,81,136
"34597","2000-2059",2023-05-27,37,6,67,104
"34598","2000-2059",2023-05-28,43,7,61,104
"34599","2000-2059",2023-05-29,55,1,81,136
"34600","2000-2059",2023-05-30,46,2,77,123
"34601","2000-2059",2023-05-31,48,3,76,124
"34602","2100-2159",2023-05-01,50,1,71,121
"34603","2100-2159",2023-05-02,41,2,67,108
"34604","2100-2159",2023-05-03,44,3,69,113
"34605","2100-2159",2023-05-04,51,4,72,123
"34606","2100-2159",2023-05-05,48,5,72,120
"34607","2100-2159",2023-05-06,37,6,67,104
"34608","2100-2159",2023-05-07,52,7,66,118
"34609","2100-2159",2023-05-08,47,1,70,117
"34610","2100-2159",2023-05-09,40,2,62,102
"34611","2100-2159",2023-05-10,43,3,64,107
"34612","2100-2159",2023-05-11,51,4,70,121
"34613","2100-2159",2023-05-12,48,5,69,117
"34614","2100-2159",2023-05-13,35,6,59,94
"34615","2100-2159",2023-05-14,52,7,65,117
"34616","2100-2159",2023-05-15,48,1,71,119
"34617","2100-2159",2023-05-16,40,2,62,102
"34618","2100-2159",2023-05-17,42,3,62,104
"34619","2100-2159",2023-05-18,49,4,70,119
"34620","2100-2159",2023-05-19,49,5,71,120
"34621","2100-2159",2023-05-20,34,6,58,92
"34622","2100-2159",2023-05-21,48,7,64,112
"34623","2100-2159",2023-05-22,48,1,70,118
"34624","2100-2159",2023-05-23,37,2,60,97
"34625","2100-2159",2023-05-24,40,3,62,102
"34626","2100-2159",2023-05-25,49,4,69,118
"34627","2100-2159",2023-05-26,49,5,71,120
"34628","2100-2159",2023-05-27,33,6,57,90
"34629","2100-2159",2023-05-28,40,7,63,103
"34630","2100-2159",2023-05-29,49,1,71,120
"34631","2100-2159",2023-05-30,37,2,60,97
"34632","2100-2159",2023-05-31,41,3,62,103
"34633","2200-2259",2023-05-01,38,1,68,106
"34634","2200-2259",2023-05-02,33,2,54,87
"34635","2200-2259",2023-05-03,36,3,55,91
"34636","2200-2259",2023-05-04,41,4,68,109
"34637","2200-2259",2023-05-05,37,5,67,104
"34638","2200-2259",2023-05-06,24,6,42,66
"34639","2200-2259",2023-05-07,42,7,68,110
"34640","2200-2259",2023-05-08,37,1,63,100
"34641","2200-2259",2023-05-09,31,2,58,89
"34642","2200-2259",2023-05-10,33,3,60,93
"34643","2200-2259",2023-05-11,37,4,64,101
"34644","2200-2259",2023-05-12,38,5,63,101
"34645","2200-2259",2023-05-13,26,6,41,67
"34646","2200-2259",2023-05-14,42,7,64,106
"34647","2200-2259",2023-05-15,37,1,63,100
"34648","2200-2259",2023-05-16,31,2,58,89
"34649","2200-2259",2023-05-17,32,3,59,91
"34650","2200-2259",2023-05-18,37,4,66,103
"34651","2200-2259",2023-05-19,38,5,63,101
"34652","2200-2259",2023-05-20,26,6,43,69
"34653","2200-2259",2023-05-21,41,7,66,107
"34654","2200-2259",2023-05-22,37,1,64,101
"34655","2200-2259",2023-05-23,31,2,60,91
"34656","2200-2259",2023-05-24,33,3,62,95
"34657","2200-2259",2023-05-25,37,4,65,102
"34658","2200-2259",2023-05-26,38,5,64,102
"34659","2200-2259",2023-05-27,25,6,43,68
"34660","2200-2259",2023-05-28,32,7,55,87
"34661","2200-2259",2023-05-29,37,1,65,102
"34662","2200-2259",2023-05-30,31,2,59,90
"34663","2200-2259",2023-05-31,33,3,60,93
"34664","2300-2359",2023-05-01,22,1,62,84
"34665","2300-2359",2023-05-02,18,2,58,76
"34666","2300-2359",2023-05-03,19,3,61,80
"34667","2300-2359",2023-05-04,20,4,67,87
"34668","2300-2359",2023-05-05,23,5,65,88
"34669","2300-2359",2023-05-06,20,6,49,69
"34670","2300-2359",2023-05-07,23,7,69,92
"34671","2300-2359",2023-05-08,24,1,68,92
"34672","2300-2359",2023-05-09,21,2,59,80
"34673","2300-2359",2023-05-10,21,3,64,85
"34674","2300-2359",2023-05-11,22,4,73,95
"34675","2300-2359",2023-05-12,23,5,70,93
"34676","2300-2359",2023-05-13,19,6,50,69
"34677","2300-2359",2023-05-14,22,7,72,94
"34678","2300-2359",2023-05-15,23,1,69,92
"34679","2300-2359",2023-05-16,21,2,59,80
"34680","2300-2359",2023-05-17,21,3,63,84
"34681","2300-2359",2023-05-18,23,4,73,96
"34682","2300-2359",2023-05-19,23,5,70,93
"34683","2300-2359",2023-05-20,19,6,48,67
"34684","2300-2359",2023-05-21,24,7,69,93
"34685","2300-2359",2023-05-22,23,1,68,91
"34686","2300-2359",2023-05-23,23,2,58,81
"34687","2300-2359",2023-05-24,23,3,63,86
"34688","2300-2359",2023-05-25,24,4,71,95
"34689","2300-2359",2023-05-26,24,5,71,95
"34690","2300-2359",2023-05-27,19,6,47,66
"34691","2300-2359",2023-05-28,22,7,58,80
"34692","2300-2359",2023-05-29,23,1,69,92
"34693","2300-2359",2023-05-30,23,2,57,80
"34694","2300-2359",2023-05-31,21,3,62,83
